"","county","date","unsen_male","unsen_female","sen_male","sen_female","total"
"1","Alameda County",1995-10-01,2522,198,1030,166,3916
"2","Alameda County",1995-11-01,2434,208,975,157,3774
"3","Alameda County",1995-12-01,2494,207,948,179,3828
"4","Alameda County",1996-01-01,2592,201,911,182,3886
"5","Alameda County",1996-02-01,2603,199,910,160,3872
"6","Alameda County",1996-03-01,2592,210,942,165,3909
"7","Alameda County",1996-04-01,2557,216,907,175,3855
"8","Alameda County",1996-05-01,2593,218,926,194,3931
"9","Alameda County",1996-06-01,2612,224,928,205,3969
"10","Alameda County",1996-07-01,2617,239,916,186,3958
"11","Alameda County",1996-08-01,2634,227,918,198,3977
"12","Alameda County",1996-09-01,2650,210,954,175,3989
"13","Alameda County",1996-10-01,2676,212,936,173,3997
"14","Alameda County",1996-11-01,2656,219,941,187,4003
"15","Alameda County",1996-12-01,2726,196,870,171,3963
"16","Alameda County",1997-01-01,2756,207,899,168,4030
"17","Alameda County",1997-02-01,2773,229,963,154,4119
"18","Alameda County",1997-03-01,2760,240,1051,182,4233
"19","Alameda County",1997-04-01,2723,241,1022,189,4175
"20","Alameda County",1997-05-01,2703,242,1045,216,4206
"21","Alameda County",1997-06-01,2698,230,1052,222,4202
"22","Alameda County",1997-07-01,2604,229,1033,210,4076
"23","Alameda County",1997-08-01,2595,220,1026,206,4047
"24","Alameda County",1997-09-01,2692,234,1011,213,4150
"25","Alameda County",1997-10-01,2639,252,1023,199,4113
"26","Alameda County",1997-11-01,2676,231,1015,198,4120
"27","Alameda County",1997-12-01,2639,252,1023,199,4113
"28","Alameda County",1998-01-01,2679,257,1023,211,4170
"29","Alameda County",1998-02-01,2709,270,1078,213,4270
"30","Alameda County",1998-03-01,2639,259,1120,247,4265
"31","Alameda County",1998-04-01,2603,263,1114,258,4238
"32","Alameda County",1998-05-01,2624,252,1076,264,4216
"33","Alameda County",1998-06-01,2620,255,1069,247,4191
"34","Alameda County",1998-07-01,2644,258,1030,239,4171
"35","Alameda County",1998-08-01,2636,246,929,243,4054
"36","Alameda County",1998-09-01,2657,251,913,242,4063
"37","Alameda County",1998-10-01,2711,245,963,227,4146
"38","Alameda County",1998-11-01,2771,235,967,203,4176
"39","Alameda County",1998-12-01,2800,256,918,185,4159
"40","Alameda County",1999-01-01,2812,264,909,182,4167
"41","Alameda County",1999-02-01,2812,264,909,182,4167
"42","Alameda County",1999-03-01,2798,257,1064,191,4310
"43","Alameda County",1999-04-01,2788,255,1049,190,4282
"44","Alameda County",1999-05-01,2788,255,1049,190,4282
"45","Alameda County",1999-06-01,2912,267,982,190,4351
"46","Alameda County",1999-07-01,2874,258,980,188,4300
"47","Alameda County",1999-08-01,2823,249,960,191,4223
"48","Alameda County",1999-09-01,2923,254,952,192,4321
"49","Alameda County",1999-10-01,3203,305,998,152,4658
"50","Alameda County",1999-11-01,3103,305,998,152,4558
"51","Alameda County",1999-12-01,3078,286,988,151,4503
"52","Alameda County",2000-01-01,3173,292,956,161,4582
"53","Alameda County",2000-02-01,3106,285,985,164,4540
"54","Alameda County",2000-03-01,3049,262,981,150,4442
"55","Alameda County",2000-04-01,2955,285,972,133,4345
"56","Alameda County",2000-05-01,2873,278,909,136,4196
"57","Alameda County",2000-06-01,2893,272,851,155,4171
"58","Alameda County",2000-07-01,2882,285,811,159,4137
"59","Alameda County",2000-08-01,2874,308,821,139,4142
"60","Alameda County",2000-09-01,2884,307,807,128,4126
"61","Alameda County",2000-10-01,2814,265,793,104,3976
"62","Alameda County",2000-11-01,2750,285,788,102,3925
"63","Alameda County",2000-12-01,2719,275,753,104,3851
"64","Alameda County",2001-01-01,2716,263,732,109,3820
"65","Alameda County",2001-02-01,2721,264,759,124,3868
"66","Alameda County",2001-03-01,2760,284,751,119,3914
"67","Alameda County",2001-04-01,2762,286,771,124,3943
"68","Alameda County",2001-05-01,2707,299,794,124,3924
"69","Alameda County",2001-06-01,2600,291,771,115,3777
"70","Alameda County",2001-07-01,2652,294,751,98,3795
"71","Alameda County",2001-08-01,2670,290,723,94,3777
"72","Alameda County",2001-09-01,2731,315,713,106,3865
"73","Alameda County",2001-10-01,2722,294,752,129,3897
"74","Alameda County",2001-11-01,2733,293,722,115,3863
"75","Alameda County",2001-12-01,2634,255,721,116,3726
"76","Alameda County",2002-01-01,2623,285,837,153,3898
"77","Alameda County",2002-02-01,2715,310,886,161,4072
"78","Alameda County",2002-03-01,2688,286,952,183,4109
"79","Alameda County",2002-04-01,2662,274,931,176,4043
"80","Alameda County",2002-05-01,2621,290,926,155,3992
"81","Alameda County",2002-06-01,2669,287,944,165,4065
"82","Alameda County",2002-07-01,2647,288,938,157,4030
"83","Alameda County",2002-08-01,2662,302,982,161,4107
"84","Alameda County",2002-09-01,2772,316,964,171,4223
"85","Alameda County",2002-10-01,2686,325,967,173,4151
"86","Alameda County",2002-11-01,2708,323,974,163,4168
"87","Alameda County",2002-12-01,2647,317,900,167,4031
"88","Alameda County",2003-01-01,2659,308,871,191,4029
"89","Alameda County",2003-02-01,2776,355,899,193,4223
"90","Alameda County",2003-03-01,2800,317,900,198,4215
"91","Alameda County",2003-04-01,2739,290,910,195,4134
"92","Alameda County",2003-05-01,2749,299,906,176,4130
"93","Alameda County",2003-06-01,2765,304,915,182,4166
"94","Alameda County",2003-07-01,2749,300,923,179,4151
"95","Alameda County",2003-08-01,2747,301,931,175,4154
"96","Alameda County",2003-09-01,2790,316,916,166,4188
"97","Alameda County",2003-10-01,2825,293,893,160,4171
"98","Alameda County",2003-11-01,2836,302,893,160,4191
"99","Alameda County",2003-12-01,2733,325,839,154,4051
"100","Alameda County",2004-01-01,2739,320,836,148,4043
"101","Alameda County",2004-02-01,2841,326,900,170,4237
"102","Alameda County",2004-03-01,2847,301,901,179,4228
"103","Alameda County",2004-04-01,2808,304,916,171,4199
"104","Alameda County",2004-05-01,2783,297,893,173,4146
"105","Alameda County",2004-06-01,2806,299,903,174,4182
"106","Alameda County",2004-07-01,2824,302,916,171,4213
"107","Alameda County",2004-08-01,2787,297,893,173,4150
"108","Alameda County",2004-09-01,2823,299,903,174,4199
"109","Alameda County",2004-10-01,2848,289,864,185,4186
"110","Alameda County",2004-11-01,2861,319,774,148,4102
"111","Alameda County",2004-12-01,2855,286,737,156,4034
"112","Alameda County",2005-01-01,2920,288,784,140,4132
"113","Alameda County",2005-02-01,2923,305,810,138,4176
"114","Alameda County",2005-03-01,2864,302,839,147,4152
"115","Alameda County",2005-04-01,2884,270,793,141,4088
"116","Alameda County",2005-05-01,2788,267,783,167,4005
"117","Alameda County",2005-06-01,2798,278,720,133,3929
"118","Alameda County",2005-07-01,2692,263,741,251,3947
"119","Alameda County",2005-08-01,2698,225,751,138,3812
"120","Alameda County",2005-09-01,2802,212,784,135,3933
"121","Alameda County",2005-10-01,2751,247,768,144,3910
"122","Alameda County",2005-11-01,2759,255,767,144,3925
"123","Alameda County",2005-12-01,2764,265,752,129,3910
"124","Alameda County",2006-01-01,2836,293,743,126,3998
"125","Alameda County",2006-02-01,2886,285,744,149,4064
"126","Alameda County",2006-03-01,2793,247,772,154,3966
"127","Alameda County",2006-04-01,2818,234,775,147,3974
"128","Alameda County",2006-05-01,2801,302,784,102,3989
"129","Alameda County",2006-06-01,2803,304,783,112,4002
"130","Alameda County",2006-07-01,2878,317,770,116,4081
"131","Alameda County",2006-08-01,2834,309,747,103,3993
"132","Alameda County",2006-09-01,2749,296,822,103,3970
"133","Alameda County",2006-10-01,2747,293,771,142,3953
"134","Alameda County",2006-11-01,2749,294,784,137,3964
"135","Alameda County",2006-12-01,2826,309,866,141,4142
"136","Alameda County",2007-01-01,2735,305,824,139,4003
"137","Alameda County",2007-02-01,3013,226,527,245,4011
"138","Alameda County",2007-03-01,3133,231,613,238,4215
"139","Alameda County",2007-04-01,3144,248,609,260,4261
"140","Alameda County",2007-05-01,3108,239,714,111,4172
"141","Alameda County",2007-06-01,3092,254,789,116,4251
"142","Alameda County",2007-07-01,3122,255,789,117,4283
"143","Alameda County",2007-08-01,3060,270,871,114,4315
"144","Alameda County",2007-09-01,2950,244,844,116,4154
"145","Alameda County",2007-10-01,2985,204,810,110,4109
"146","Alameda County",2007-11-01,2912,244,843,117,4116
"147","Alameda County",2007-12-01,3038,252,777,119,4186
"148","Alameda County",2008-01-01,3158,234,736,119,4247
"149","Alameda County",2008-02-01,3298,266,752,108,4424
"150","Alameda County",2008-03-01,3328,294,770,115,4507
"151","Alameda County",2008-04-01,3303,303,761,125,4492
"152","Alameda County",2008-05-01,3234,295,764,120,4413
"153","Alameda County",2008-06-01,3194,287,757,130,4368
"154","Alameda County",2008-07-01,3188,286,766,132,4372
"155","Alameda County",2008-08-01,3253,301,763,120,4437
"156","Alameda County",2008-09-01,3271,326,768,134,4499
"157","Alameda County",2008-10-01,3319,306,784,136,4545
"158","Alameda County",2008-11-01,3266,297,778,126,4467
"159","Alameda County",2008-12-01,3288,287,708,107,4390
"160","Alameda County",2009-01-01,3297,286,698,105,4386
"161","Alameda County",2009-02-01,3280,288,745,109,4422
"162","Alameda County",2009-03-01,3341,274,757,112,4484
"163","Alameda County",2009-04-01,3350,286,726,103,4465
"164","Alameda County",2009-05-01,3363,279,681,105,4428
"165","Alameda County",2009-06-01,3337,270,704,95,4406
"166","Alameda County",2009-07-01,3342,264,726,99,4431
"167","Alameda County",2009-08-01,3351,254,727,95,4427
"168","Alameda County",2009-09-01,3313,274,726,99,4412
"169","Alameda County",2009-10-01,3252,277,747,113,4389
"170","Alameda County",2009-11-01,3228,278,699,100,4305
"171","Alameda County",2009-12-01,3190,274,629,89,4182
"172","Alameda County",2010-01-01,3227,277,603,85,4192
"173","Alameda County",2010-02-01,3243,276,555,85,4159
"174","Alameda County",2010-03-01,3226,261,645,93,4225
"175","Alameda County",2010-04-01,3355,240,650,92,4337
"176","Alameda County",2010-05-01,3377,269,601,86,4333
"177","Alameda County",2010-06-01,3352,258,572,86,4268
"178","Alameda County",2010-07-01,3172,244,573,90,4079
"179","Alameda County",2010-08-01,3142,262,585,87,4076
"180","Alameda County",2010-09-01,3091,256,588,81,4016
"181","Alameda County",2010-10-01,3054,254,593,87,3988
"182","Alameda County",2010-11-01,3032,234,575,80,3921
"183","Alameda County",2010-12-01,2983,218,535,85,3821
"184","Alameda County",2011-01-01,3011,217,519,69,3816
"185","Alameda County",2011-02-01,3050,220,522,75,3867
"186","Alameda County",2011-03-01,3025,217,521,69,3832
"187","Alameda County",2011-04-01,2979,214,548,59,3800
"188","Alameda County",2011-05-01,2954,223,564,63,3804
"189","Alameda County",2011-06-01,2897,227,554,74,3752
"190","Alameda County",2011-07-01,2927,230,571,80,3808
"191","Alameda County",2011-08-01,2918,248,551,76,3793
"192","Alameda County",2011-09-01,2963,243,546,72,3824
"193","Alameda County",2011-10-01,2891,227,570,81,3769
"194","Alameda County",2011-11-01,2606,198,699,80,3583
"195","Alameda County",2011-12-01,2280,178,791,80,3329
"196","Alameda County",2012-01-01,2205,198,788,79,3270
"197","Alameda County",2012-02-01,2116,197,866,90,3269
"198","Alameda County",2012-03-01,2144,201,892,87,3324
"199","Alameda County",2012-04-01,2080,208,912,84,3284
"200","Alameda County",2012-05-01,2085,208,941,83,3317
"201","Alameda County",2012-06-01,2037,204,934,98,3273
"202","Alameda County",2012-07-01,2111,215,928,104,3358
"203","Alameda County",2012-08-01,2113,203,954,106,3376
"204","Alameda County",2012-09-01,2100,202,1019,112,3433
"205","Alameda County",2012-10-01,2071,208,1012,118,3409
"206","Alameda County",2012-11-01,2117,195,937,115,3364
"207","Alameda County",2012-12-01,2094,181,916,92,3283
"208","Alameda County",2013-01-01,2126,188,873,85,3272
"209","Alameda County",2013-02-01,2168,219,921,79,3387
"210","Alameda County",2013-03-01,2191,226,955,84,3456
"211","Alameda County",2013-04-01,2218,214,891,83,3406
"212","Alameda County",2013-05-01,2229,210,905,88,3432
"213","Alameda County",2013-06-01,2240,209,879,93,3421
"214","Alameda County",2013-07-01,2317,234,828,98,3477
"215","Alameda County",2013-08-01,2296,241,788,97,3422
"216","Alameda County",2013-09-01,2384,237,740,93,3454
"217","Alameda County",2013-10-01,2433,237,737,85,3492
"218","Alameda County",2013-11-01,2398,230,737,77,3442
"219","Alameda County",2013-12-01,2372,233,673,73,3351
"220","Alameda County",2014-01-01,2343,222,649,87,3301
"221","Alameda County",2014-02-01,2343,221,639,93,3296
"222","Alameda County",2014-03-01,2326,226,669,84,3305
"223","Alameda County",2014-04-01,2395,227,654,80,3356
"224","Alameda County",2014-05-01,2356,242,659,79,3336
"225","Alameda County",2014-06-01,2385,222,639,88,3334
"226","Alameda County",2014-07-01,2358,203,628,81,3270
"227","Alameda County",2014-08-01,2330,212,662,77,3281
"228","Alameda County",2014-09-01,2300,209,657,73,3239
"229","Alameda County",2014-10-01,2312,213,657,69,3251
"230","Alameda County",2014-11-01,2233,185,602,66,3086
"231","Alameda County",2014-12-01,2015,157,511,46,2729
"232","Alameda County",2015-01-01,2055,238,557,65,2915
"233","Alameda County",2015-02-01,2060,167,595,76,2898
"234","Alameda County",2015-03-01,1890,114,504,61,2569
"235","Alameda County",2015-04-01,2071,181,555,55,2862
"236","Alameda County",2015-05-01,2051,186,562,49,2848
"237","Alameda County",2015-06-01,2067,184,519,55,2825
"238","Alameda County",2015-07-01,2126,172,494,68,2860
"239","Alameda County",2015-08-01,2113,187,519,74,2893
"240","Alameda County",2015-09-01,2053,187,498,76,2814
"241","Alameda County",2015-10-01,2224,209,284,44,2761
"242","Alameda County",2015-11-01,2112,197,309,39,2657
"243","Alameda County",2015-12-01,1975,170,378,61,2584
"244","Alameda County",2016-01-01,2029,186,355,52,2622
"245","Alameda County",2016-02-01,1935,187,371,55,2548
"246","Alameda County",2016-03-01,1942,176,382,52,2552
"247","Alameda County",2016-04-01,1885,175,389,51,2500
"248","Alameda County",2016-05-01,1896,167,394,50,2507
"249","Alameda County",2016-06-01,1866,178,408,45,2497
"250","Alameda County",2016-07-01,1858,172,393,49,2472
"251","Alameda County",2016-08-01,1895,173,357,50,2475
"252","Alameda County",2016-09-01,1897,175,351,51,2474
"253","Alameda County",2016-10-01,1890,189,346,49,2474
"254","Alameda County",2016-11-01,1864,185,333,38,2420
"255","Alameda County",2016-12-01,1837,187,313,59,2396
"256","Alameda County",2017-01-01,1869,192,324,37,2422
"257","Alameda County",2017-02-01,1984,212,359,42,2597
"258","Alameda County",2017-03-01,1900,215,407,46,2568
"259","Alameda County",2017-04-01,1925,209,390,46,2570
"260","Alameda County",2017-05-01,1954,191,379,44,2568
"261","Alameda County",2017-06-01,1898,180,388,45,2511
"262","Alameda County",2017-07-01,1917,189,384,41,2531
"263","Alameda County",2017-08-01,1926,185,359,38,2508
"264","Alameda County",2017-09-01,1946,192,377,35,2550
"265","Alameda County",2017-10-01,1973,192,365,40,2570
"266","Alameda County",2017-11-01,1966,188,358,43,2555
"267","Alameda County",2017-12-01,1993,178,346,47,2564
"268","Alameda County",2018-01-01,1959,177,396,49,2581
"269","Alameda County",2018-02-01,1962,194,426,44,2626
"270","Alameda County",2018-03-01,1914,189,428,55,2586
"271","Alameda County",2018-04-01,1929,201,397,48,2575
"272","Alameda County",2018-05-01,1918,195,393,43,2549
"273","Alameda County",2018-06-01,1949,191,350,37,2527
"274","Alameda County",2018-07-01,2003,196,342,37,2578
"275","Alameda County",2018-08-01,1980,180,379,39,2578
"276","Alameda County",2018-09-01,1976,191,354,41,2562
"277","Alameda County",2018-10-01,1975,183,368,42,2568
"278","Alameda County",2018-11-01,2007,184,377,39,2607
"279","Alameda County",2018-12-01,1946,183,358,41,2528
"280","Alameda County",2019-01-01,1984,184,351,36,2555
"281","Alameda County",2019-02-01,1961,180,345,27,2513
"282","Alameda County",2019-03-01,1948,170,355,32,2505
"283","Alameda County",2019-04-01,1947,162,337,40,2486
"284","Alameda County",2019-05-01,1957,159,340,37,2493
"285","Alameda County",2019-06-01,1931,163,338,31,2463
"286","Alameda County",2019-07-01,1938,173,335,29,2475
"287","Alameda County",2019-08-01,1974,188,318,31,2511
"288","Alameda County",2019-09-01,2011,191,322,32,2556
"289","Alameda County",2019-10-01,2053,187,348,37,2625
"290","Alameda County",2019-11-01,1985,182,386,36,2589
"291","Alameda County",2019-12-01,1967,173,378,45,2563
"292","Alameda County",2020-01-01,2001,180,354,38,2573
"293","Alameda County",2020-02-01,2033,180,354,41,2608
"294","Alameda County",2020-03-01,1963,148,279,35,2425
"295","Amador County",1995-10-01,15.33,1.59,21.7,4.85,43.47
"296","Amador County",1995-11-01,16.63,1.87,28.7,4.07,51.27
"297","Amador County",1995-12-01,13.26,1.52,21.52,2.84,39.14
"298","Amador County",1996-01-01,9.62,0.41,22.48,3.79,36.3
"299","Amador County",1996-02-01,13.41,0.7,16.15,1.67,31.93
"300","Amador County",1996-03-01,12.1,0.87,21.55,3.16,37.68
"301","Amador County",1996-04-01,17.63,3.47,31.53,3.57,56.2
"302","Amador County",1996-05-01,17.71,5.06,26.75,3.13,52.65
"303","Amador County",1996-06-01,20.67,2.67,24.13,4.47,51.94
"304","Amador County",1996-07-01,23.17,2.53,14.7,6.13,46.53
"305","Amador County",1996-08-01,19.81,3.61,13.97,4.9,42.29
"306","Amador County",1996-09-01,22.63,2.73,14.77,5,45.13
"307","Amador County",1996-10-01,23.61,2.58,22.19,6.23,54.61
"308","Amador County",1996-11-01,16.6,2.8,22.53,3.37,45.3
"309","Amador County",1996-12-01,15.16,2,16.52,2.45,36.13
"310","Amador County",1997-01-01,18.1,1.84,22.9,3.26,46.1
"311","Amador County",1997-02-01,21.5,4.25,20.36,4.14,50.25
"312","Amador County",1997-03-01,17.82,2.51,24.38,5.6,50.31
"313","Amador County",1997-04-01,17.47,2.33,23.47,5.9,49.17
"314","Amador County",1997-05-01,21.32,3.32,32.35,5.29,62.28
"315","Amador County",1997-06-01,23.53,5.27,24.9,5.1,58.8
"316","Amador County",1997-07-01,23.84,4.55,25.74,5.77,59.9
"317","Amador County",1997-08-01,19.32,3.39,25.9,5.71,54.32
"318","Amador County",1997-09-01,11.93,4.56,33.96,3.53,53.98
"319","Amador County",1997-10-01,12.48,3.7,37.96,2.45,56.59
"320","Amador County",1997-11-01,17.13,4.93,35.41,4.37,61.84
"321","Amador County",1997-12-01,11.87,4.87,28.32,5.96,51.02
"322","Amador County",1998-01-01,14.7,3.83,24.7,3.74,46.97
"323","Amador County",1998-02-01,18.53,3.42,21.75,6.03,49.73
"324","Amador County",1998-03-01,20.7,3.03,26.7,7.8,58.23
"325","Amador County",1998-04-01,19.86,2.96,23.2,6.23,52.25
"326","Amador County",1998-05-01,16.41,1.35,25.16,5.77,48.69
"327","Amador County",1998-06-01,15.26,3.63,25.1,5.36,49.35
"328","Amador County",1998-07-01,15.61,3,21.67,2.25,42.53
"329","Amador County",1998-08-01,15.58,1.9,18.51,2.25,38.24
"330","Amador County",1998-09-01,18.97,2.77,10.94,2.47,35.15
"331","Amador County",1998-10-01,18.58,2.42,9.49,4.36,34.85
"332","Amador County",1998-11-01,22.04,2.64,11.9,5.6,42.18
"333","Amador County",1998-12-01,16.49,2.55,20.36,3.55,42.95
"334","Amador County",1999-01-01,18.1,2.78,29.1,2.58,52.56
"335","Amador County",1999-02-01,17.72,3.5,34.4,3.11,58.73
"336","Amador County",1999-03-01,21.49,3.26,26.71,1.04,52.5
"337","Amador County",1999-04-01,12.77,2.6,23.57,3.1,42.04
"338","Amador County",1999-05-01,13.04,1.81,20.17,5.46,40.48
"339","Amador County",1999-06-01,11.57,3.27,21.47,5.57,41.88
"340","Amador County",1999-07-01,17.42,4.07,24.97,6.13,52.59
"341","Amador County",1999-08-01,18.67,3.77,22.94,4.77,50.15
"342","Amador County",1999-09-01,18.84,5.84,22.27,4.14,51.09
"343","Amador County",1999-10-01,19.81,4.91,27.17,5.07,56.96
"344","Amador County",1999-11-01,20.1,3.5,22.9,3.84,50.34
"345","Amador County",1999-12-01,13.42,3.84,20.94,3.36,41.56
"346","Amador County",2000-01-01,11.39,4.48,22.42,4.71,43
"347","Amador County",2000-02-01,16.45,3.48,19,2.24,41.17
"348","Amador County",2000-03-01,16.84,4.55,20.29,3.1,44.78
"349","Amador County",2000-04-01,15.7,4.67,16.7,3.6,40.67
"350","Amador County",2000-05-01,19,5.1,16.74,6.97,47.81
"351","Amador County",2000-06-01,20.67,5.47,17.7,5.57,49.41
"352","Amador County",2000-07-01,19.61,3.23,16.19,5.39,44.42
"353","Amador County",2000-08-01,21.16,3.9,16.97,3.84,45.87
"354","Amador County",2000-09-01,13.9,3.33,18.03,4.27,39.53
"355","Amador County",2000-10-01,11.32,4.9,18.29,2.71,37.22
"356","Amador County",2000-11-01,14.73,2.93,14.33,2.9,34.89
"357","Amador County",2000-12-01,14.12,0.67,21.32,2.83,38.94
"358","Amador County",2001-01-01,18,3,23,4,48
"359","Amador County",2001-02-01,21,3,23,4,50
"360","Amador County",2001-03-01,19,0,22,2,43
"361","Amador County",2001-04-01,24,4,22,2,51
"362","Amador County",2001-05-01,23,8,23,2,56
"363","Amador County",2001-06-01,25,8,19,9,61
"364","Amador County",2001-07-01,25,8,14,10,57
"365","Amador County",2001-08-01,25,6,25,4,60
"366","Amador County",2001-09-01,29,7,31,3,70
"367","Amador County",2001-10-01,26,9,29,4,68
"368","Amador County",2001-11-01,26,5,28,5,64
"369","Amador County",2001-12-01,35,5,27,5,72
"370","Amador County",2002-01-01,29,3,27,5,64
"371","Amador County",2002-02-01,28,2,26,6,62
"372","Amador County",2002-03-01,29,2,29,8,68
"373","Amador County",2002-04-01,27,3,30,7,67
"374","Amador County",2002-05-01,48,8,15,3,74
"375","Amador County",2002-06-01,11,2,43,5,61
"376","Amador County",2002-07-01,25,3,33,9,70
"377","Amador County",2002-08-01,30,2,36,11,79
"378","Amador County",2002-09-01,34,2,41,11,88
"379","Amador County",2002-10-01,37,2,35,11,85
"380","Amador County",2002-11-01,30,2,37,7,76
"381","Amador County",2002-12-01,26,1,39,5,71
"382","Amador County",2003-01-01,27,3,41,7,78
"383","Amador County",2003-02-01,34,5,36,9,84
"384","Amador County",2003-03-01,31,4,36,9,80
"385","Amador County",2003-04-01,22,3,41,6,72
"386","Amador County",2003-05-01,25,4,37,5,71
"387","Amador County",2003-06-01,28,6,34,5,73
"388","Amador County",2003-07-01,20,3,44,8,75
"389","Amador County",2003-08-01,31,5,30,6,72
"390","Amador County",2003-09-01,31,4,38,10,83
"391","Amador County",2003-10-01,20,2,50,9,81
"392","Amador County",2003-11-01,23,4,46,8,81
"393","Amador County",2003-12-01,29,2,42,12,85
"394","Amador County",2004-01-01,25,4,49,11,89
"395","Amador County",2004-02-01,40,9,26,8,83
"396","Amador County",2004-03-01,41,9,27,9,86
"397","Amador County",2004-04-01,42,10,26,8,86
"398","Amador County",2004-05-01,41,8,28,7,84
"399","Amador County",2004-06-01,42,9,28,7,86
"400","Amador County",2004-07-01,41,9,27,7,84
"401","Amador County",2004-08-01,42,9,27,7,85
"402","Amador County",2004-09-01,46,8,33,7,94
"403","Amador County",2004-10-01,41,9,26,8,84
"404","Amador County",2004-11-01,40,8,26,9,83
"405","Amador County",2004-12-01,41,8,25,9,83
"406","Amador County",2005-01-01,42,9,26,9,86
"407","Amador County",2005-02-01,43,9,27,9,88
"408","Amador County",2005-03-01,43,9,28,10,90
"409","Amador County",2005-04-01,43,9,28,10,90
"410","Amador County",2005-05-01,43,10,29,10,92
"411","Amador County",2005-06-01,43,10,30,10,93
"412","Amador County",2005-07-01,44,11,30,10,95
"413","Amador County",2005-08-01,44,11,30,11,96
"414","Amador County",2005-09-01,44,11,30,11,96
"415","Amador County",2005-10-01,44,11,29,10,94
"416","Amador County",2005-11-01,45,12,30,10,97
"417","Amador County",2005-12-01,43,9,28,10,90
"418","Amador County",2006-01-01,42,10,26,9,87
"419","Amador County",2006-02-01,43,9,27,10,89
"420","Amador County",2006-03-01,40,8,26,8,82
"421","Amador County",2006-04-01,43,11,27,10,91
"422","Amador County",2006-05-01,44,11,27,10,92
"423","Amador County",2006-06-01,43,11,27,10,91
"424","Amador County",2006-07-01,44,12,27,11,94
"425","Amador County",2006-08-01,42,10,26,9,87
"426","Amador County",2006-09-01,44,11,26,10,91
"427","Amador County",2006-10-01,42,11,26,10,89
"428","Amador County",2006-11-01,43,11,25,10,89
"429","Amador County",2006-12-01,41,11,25,11,88
"430","Amador County",2007-01-01,40,10,25,10,85
"431","Amador County",2007-02-01,38,10,25,10,83
"432","Amador County",2007-03-01,38,10,24,10,82
"433","Amador County",2007-04-01,17,8,44,6,75
"434","Amador County",2007-05-01,33,10,28,8,79
"435","Amador County",2007-06-01,31,6,32,7,76
"436","Amador County",2007-07-01,33,5,37,11,86
"437","Amador County",2007-08-01,37,5,31,13,86
"438","Amador County",2007-09-01,52,12,18,5,87
"439","Amador County",2007-10-01,46,6,24,8,84
"440","Amador County",2007-11-01,41,6,24,6,77
"441","Amador County",2007-12-01,30,5,23,7,65
"442","Amador County",2008-01-01,31,10,58,9,108
"443","Amador County",2008-02-01,32,11,25,10,78
"444","Amador County",2008-03-01,29,12,28,13,82
"445","Amador County",2008-04-01,35,12,24,13,84
"446","Amador County",2008-05-01,33,10,27,12,82
"447","Amador County",2008-06-01,45,13,30,8,96
"448","Amador County",2008-07-01,38,9,34,12,93
"449","Amador County",2008-08-01,33,9,37,10,89
"450","Amador County",2008-09-01,29,12,38,10,89
"451","Amador County",2008-10-01,32,12,29,9,82
"452","Amador County",2008-11-01,34,15,26,10,85
"453","Amador County",2008-12-01,40,13,22,10,85
"454","Amador County",2009-01-01,37,15,23,9,84
"455","Amador County",2009-02-01,41,15,25,7,88
"456","Amador County",2009-03-01,44,12,27,8,91
"457","Amador County",2009-04-01,37,10,27,6,80
"458","Amador County",2009-05-01,36,9,30,6,81
"459","Amador County",2009-06-01,35,8,32,8,83
"460","Amador County",2009-07-01,39,9,34,9,91
"461","Amador County",2009-08-01,37,9,34,8,88
"462","Amador County",2009-09-01,31,8,37,9,85
"463","Amador County",2009-10-01,34,10,33,9,86
"464","Amador County",2009-11-01,37,12,30,7,86
"465","Amador County",2009-12-01,30,10,33,9,82
"466","Amador County",2010-01-01,33,12,33,14,92
"467","Amador County",2010-02-01,30,10,38,12,90
"468","Amador County",2010-03-01,39,13,30,12,94
"469","Amador County",2010-04-01,37,8,26,10,81
"470","Amador County",2010-05-01,36,9,29,5,79
"471","Amador County",2010-06-01,43,8,34,5,90
"472","Amador County",2010-07-01,45,8,27,7,87
"473","Amador County",2010-08-01,42,9,28,9,88
"474","Amador County",2010-09-01,51,11,28,6,96
"475","Amador County",2010-10-01,46,9,33,7,95
"476","Amador County",2010-11-01,45,7,27,9,88
"477","Amador County",2010-12-01,39,5,33,8,85
"478","Amador County",2011-01-01,39,7,30,4,80
"479","Amador County",2011-02-01,35,9,22,2,68
"480","Amador County",2011-03-01,33,7,25,8,73
"481","Amador County",2011-04-01,33,7,21,8,69
"482","Amador County",2011-05-01,36,7,14,6,63
"483","Amador County",2011-06-01,32,4,23,6,65
"484","Amador County",2011-07-01,28,6,22,6,62
"485","Amador County",2011-08-01,30,7,25,9,71
"486","Amador County",2011-09-01,44,13,26,7,90
"487","Amador County",2011-10-01,50,10,25,5,90
"488","Amador County",2011-11-01,52,11,26,5,94
"489","Amador County",2011-12-01,55,7,28,9,99
"490","Amador County",2012-01-01,54,9,33,9,105
"491","Amador County",2012-02-01,52,10,37,9,108
"492","Amador County",2012-03-01,48,10,40,7,105
"493","Amador County",2012-04-01,44,9,38,4,95
"494","Amador County",2012-05-01,46,8,38,6,98
"495","Amador County",2012-06-01,48,5,35,9,97
"496","Amador County",2012-07-01,50,7,38,10,105
"497","Amador County",2012-08-01,52,8,40,7,107
"498","Amador County",2012-09-01,49,9,46,6,110
"499","Amador County",2012-10-01,39,8,51,7,105
"500","Amador County",2012-11-01,38,7,42,4,91
"501","Amador County",2012-12-01,36,10,35,3,84
"502","Amador County",2013-01-01,43,10,37,8,98
"503","Amador County",2013-02-01,48,8,41,11,108
"504","Amador County",2013-03-01,47,11,37,8,103
"505","Amador County",2013-04-01,43,8,35,10,96
"506","Amador County",2013-05-01,47,7,36,9,99
"507","Amador County",2013-06-01,47,7,32,8,94
"508","Amador County",2013-07-01,46,9,29,8,92
"509","Amador County",2013-08-01,42,9,29,7,87
"510","Amador County",2013-09-01,42,10,26,9,87
"511","Amador County",2013-10-01,46,12,31,8,97
"512","Amador County",2013-11-01,39,10,36,10,95
"513","Amador County",2013-12-01,33,9,39,11,92
"514","Amador County",2014-01-01,35,10,35,13,93
"515","Amador County",2014-02-01,36,12,28,12,88
"516","Amador County",2014-03-01,36,12,32,12,92
"517","Amador County",2014-04-01,37,10,39,13,99
"518","Amador County",2014-05-01,28,9,54,12,103
"519","Amador County",2014-06-01,49,9,34,14,106
"520","Amador County",2014-07-01,50,12,32,15,110
"521","Amador County",2014-08-01,49,11,34,16,111
"522","Amador County",2014-09-01,41,5,37,15,97
"523","Amador County",2014-10-01,43,8,33,14,98
"524","Amador County",2014-11-01,43,6,31,10,90
"525","Amador County",2014-12-01,39,4,28,8,79
"526","Amador County",2015-01-01,39,6,26,10,81
"527","Amador County",2015-02-01,36,9,26,15,86
"528","Amador County",2015-03-01,35,8,25,13,81
"529","Amador County",2015-04-01,38,5,29,12,84
"530","Amador County",2015-05-01,34,6,36,11,86
"531","Amador County",2015-06-01,39,6,29,11,85
"532","Amador County",2015-07-01,39,6,29,9,83
"533","Amador County",2015-08-01,51,7,28,7,93
"534","Amador County",2015-09-01,47,6,35,9,97
"535","Amador County",2015-10-01,43,6,39,8,96
"536","Amador County",2015-11-01,44,10,29,6,89
"537","Amador County",2015-12-01,39,10,29,9,87
"538","Amador County",2016-01-01,43,9,30,9,91
"539","Amador County",2016-02-01,45,9,33,10,98
"540","Amador County",2016-03-01,48,11,27,6,92
"541","Amador County",2016-04-01,50,10,20,6,87
"542","Amador County",2016-05-01,43,9,23,6,81
"543","Amador County",2016-06-01,36,6,26,9,78
"544","Amador County",2016-07-01,46,8,23,9,86
"545","Amador County",2016-08-01,48,9,26,8,91
"546","Amador County",2016-09-01,49,9,29,5,92
"547","Amador County",2016-10-01,51,8,32,6,97
"548","Amador County",2016-11-01,40,8,41,9,98
"549","Amador County",2016-12-01,36,9,29,8,81
"550","Amador County",2017-01-01,34,10,29,7,80
"551","Amador County",2017-02-01,38,10,36,7,91
"552","Amador County",2017-03-01,36,9,31,7,83
"553","Amador County",2017-04-01,34,10,29,7,80
"554","Amador County",2017-05-01,39,10,30,8,87
"555","Amador County",2017-06-01,39,8,33,5,85
"556","Amador County",2017-07-01,40,10,32,7,89
"557","Amador County",2017-08-01,34,14,41,8,97
"558","Amador County",2017-09-01,34,14,34,8,90
"559","Amador County",2017-10-01,34,11,32,11,88
"560","Amador County",2017-11-01,30,10,38,9,87
"561","Amador County",2017-12-01,29,8,38,6,81
"562","Amador County",2018-01-01,30,7,38,6,81
"563","Amador County",2018-02-01,25,6,39,10,80
"564","Amador County",2018-03-01,31,9,42,9,91
"565","Amador County",2018-04-01,28,9,47,10,94
"566","Amador County",2018-05-01,36,7,50,11,104
"567","Amador County",2018-06-01,34,8,45,10,97
"568","Amador County",2018-07-01,29,8,45,11,93
"569","Amador County",2018-08-01,29,10,44,12,95
"570","Amador County",2018-09-01,27,11,42,11,91
"571","Amador County",2018-10-01,35,13,39,7,94
"572","Amador County",2018-11-01,33,13,46,9,101
"573","Amador County",2018-12-01,33,10,37,11,91
"574","Amador County",2019-01-01,28,10,33,9,80
"575","Amador County",2019-02-01,34,7,32,8,81
"576","Amador County",2019-03-01,28,7,31,11,77
"577","Amador County",2019-04-01,27,6,34,11,78
"578","Amador County",2019-05-01,28,8,33,11,80
"579","Amador County",2019-06-01,36,10,28,6,80
"580","Amador County",2019-07-01,34,7,32,9,82
"581","Amador County",2019-08-01,42,9,34,7,92
"582","Amador County",2019-09-01,48,10,31,7,96
"583","Amador County",2019-10-01,54,7,29,9,99
"584","Amador County",2019-11-01,60,9,28,9,106
"585","Amador County",2019-12-01,49,7,31,7,94
"586","Amador County",2020-01-01,41,5,29,8,83
"587","Amador County",2020-02-01,38,5,33,9,85
"588","Amador County",2020-03-01,36,4,31,6,77
"589","Butte County",1995-10-01,225,39,158,15,437
"590","Butte County",1995-11-01,203,35,154,16,408
"591","Butte County",1995-12-01,198,27,159,22,406
"592","Butte County",1996-01-01,211,25,138,18,392
"593","Butte County",1996-02-01,206,26,148,24,404
"594","Butte County",1996-03-01,207,28,159,24,418
"595","Butte County",1996-04-01,208,26,147,19,400
"596","Butte County",1996-05-01,215,32,147,24,418
"597","Butte County",1996-06-01,210,25,151,19,405
"598","Butte County",1996-07-01,204,27,166,23,420
"599","Butte County",1996-08-01,206,29,156,23,414
"600","Butte County",1996-09-01,222,35,135,18,410
"601","Butte County",1996-10-01,210,28,157,23,418
"602","Butte County",1996-11-01,195,19,163,31,408
"603","Butte County",1996-12-01,194,26,149,28,397
"604","Butte County",1997-01-01,217,25,157,21,420
"605","Butte County",1997-02-01,203,24,163,27,417
"606","Butte County",1997-03-01,198,34,144,34,410
"607","Butte County",1997-04-01,193,22,155,25,395
"608","Butte County",1997-05-01,205,29,143,25,402
"609","Butte County",1997-06-01,219,33,126,24,402
"610","Butte County",1997-07-01,225,43,118,17,403
"611","Butte County",1997-08-01,207,32,129,27,395
"612","Butte County",1997-09-01,237,24,146,13,420
"613","Butte County",1997-10-01,217,19,148,19,403
"614","Butte County",1997-11-01,222,33,132,10,397
"615","Butte County",1997-12-01,226,32,116,16,390
"616","Butte County",1998-01-01,198,33,152,27,410
"617","Butte County",1998-02-01,217,30,127,28,402
"618","Butte County",1998-03-01,240,35,139,27,441
"619","Butte County",1998-04-01,230,40,163,28,461
"620","Butte County",1998-05-01,225,34,146,32,437
"621","Butte County",1998-06-01,231,26,150,32,439
"622","Butte County",1998-07-01,204,30,147,28,409
"623","Butte County",1998-08-01,202,34,118,24,378
"624","Butte County",1998-09-01,225,36,110,21,392
"625","Butte County",1998-10-01,207,39,134,19,399
"626","Butte County",1998-11-01,212,43,121,16,392
"627","Butte County",1998-12-01,202,37,125,16,380
"628","Butte County",1999-01-01,241,36,109,26,412
"629","Butte County",1999-02-01,255,37,113,33,438
"630","Butte County",1999-03-01,245,36,123,27,431
"631","Butte County",1999-04-01,237,32,135,31,435
"632","Butte County",1999-05-01,242,40,125,23,430
"633","Butte County",1999-06-01,230,32,127,22,411
"634","Butte County",1999-07-01,222,34,146,24,426
"635","Butte County",1999-08-01,244,36,135,25,440
"636","Butte County",1999-09-01,241,43,148,32,464
"637","Butte County",1999-10-01,219,41,150,34,444
"638","Butte County",1999-11-01,223,44,129,33,429
"639","Butte County",1999-12-01,221,47,106,24,398
"640","Butte County",2000-01-01,263,39,88,17,407
"641","Butte County",2000-02-01,290,30,79,20,419
"642","Butte County",2000-03-01,290,32,98,34,454
"643","Butte County",2000-04-01,291,43,96,26,456
"644","Butte County",2000-05-01,272,35,132,25,464
"645","Butte County",2000-06-01,282,44,130,17,473
"646","Butte County",2000-07-01,321,41,117,19,498
"647","Butte County",2000-08-01,305,43,129,14,491
"648","Butte County",2000-09-01,327,40,123,11,501
"649","Butte County",2000-10-01,301,42,124,21,488
"650","Butte County",2000-11-01,284,39,146,23,492
"651","Butte County",2000-12-01,279,31,151,28,489
"652","Butte County",2001-01-01,293,42,136,24,495
"653","Butte County",2001-02-01,265,41,140,26,472
"654","Butte County",2001-03-01,274,40,148,27,489
"655","Butte County",2001-04-01,288,33,149,27,497
"656","Butte County",2001-05-01,281,36,160,22,499
"657","Butte County",2001-06-01,259,45,158,18,480
"658","Butte County",2001-07-01,245,41,139,20,445
"659","Butte County",2001-08-01,37,251,131,22,441
"660","Butte County",2001-09-01,260,38,143,20,461
"661","Butte County",2001-10-01,288,40,131,26,485
"662","Butte County",2001-11-01,296,45,152,22,515
"663","Butte County",2001-12-01,284,46,152,14,496
"664","Butte County",2002-01-01,282,40,153,15,490
"665","Butte County",2002-02-01,283,36,153,21,493
"666","Butte County",2002-03-01,257,31,166,25,479
"667","Butte County",2002-04-01,259,30,153,28,470
"668","Butte County",2002-05-01,269,34,145,26,474
"669","Butte County",2002-06-01,247,33,174,22,476
"670","Butte County",2002-07-01,250,32,174,30,486
"671","Butte County",2002-08-01,247,33,167,24,471
"672","Butte County",2002-09-01,259,36,170,26,491
"673","Butte County",2002-10-01,269,37,168,22,496
"674","Butte County",2002-11-01,269,41,169,19,498
"675","Butte County",2002-12-01,281,38,160,14,493
"676","Butte County",2003-01-01,291,42,161,18,512
"677","Butte County",2003-02-01,253,38,149,21,461
"678","Butte County",2003-03-01,285,33,157,34,509
"679","Butte County",2003-04-01,257,39,184,28,508
"680","Butte County",2003-05-01,273,46,188,24,531
"681","Butte County",2003-06-01,264,45,171,22,502
"682","Butte County",2003-07-01,276,48,169,27,520
"683","Butte County",2003-08-01,280,52,171,27,530
"684","Butte County",2003-09-01,274,53,174,25,526
"685","Butte County",2003-10-01,277,52,161,26,516
"686","Butte County",2003-11-01,272,46,140,28,486
"687","Butte County",2003-12-01,277,48,159,27,511
"688","Butte County",2004-01-01,263,42,174,29,508
"689","Butte County",2004-02-01,267,45,170,31,513
"690","Butte County",2004-03-01,270,51,157,24,502
"691","Butte County",2004-04-01,260,50,149,25,484
"692","Butte County",2004-05-01,264,47,165,29,505
"693","Butte County",2004-06-01,261,39,156,31,487
"694","Butte County",2004-07-01,279,47,159,27,512
"695","Butte County",2004-08-01,276,59,183,28,546
"696","Butte County",2004-09-01,272,52,184,35,543
"697","Butte County",2004-10-01,276,47,182,38,543
"698","Butte County",2004-11-01,249,43,177,37,506
"699","Butte County",2004-12-01,249,43,177,37,506
"700","Butte County",2005-01-01,243,41,160,45,489
"701","Butte County",2005-02-01,252,36,161,48,497
"702","Butte County",2005-03-01,268,43,160,41,512
"703","Butte County",2005-04-01,265,47,167,37,516
"704","Butte County",2005-05-01,249,42,155,42,488
"705","Butte County",2005-06-01,250,44,158,39,491
"706","Butte County",2005-07-01,253,48,149,39,489
"707","Butte County",2005-08-01,280,54,151,35,520
"708","Butte County",2005-09-01,278,52,164,36,530
"709","Butte County",2005-10-01,279,45,172,40,536
"710","Butte County",2005-11-01,273,47,196,42,558
"711","Butte County",2005-12-01,257,43,190,37,527
"712","Butte County",2006-01-01,274,51,197,36,558
"713","Butte County",2006-02-01,253,43,198,46,540
"714","Butte County",2006-03-01,237,43,186,40,506
"715","Butte County",2006-04-01,237,43,186,40,506
"716","Butte County",2006-05-01,222,43,169,47,481
"717","Butte County",2006-06-01,233,51,182,39,505
"718","Butte County",2006-07-01,235,40,191,44,510
"719","Butte County",2006-08-01,261,36,186,52,535
"720","Butte County",2006-09-01,251,44,195,40,530
"721","Butte County",2006-10-01,256,40,192,43,531
"722","Butte County",2006-11-01,242,33,178,47,500
"723","Butte County",2006-12-01,231,39,161,44,475
"724","Butte County",2007-01-01,237,36,166,42,481
"725","Butte County",2007-02-01,213,35,172,39,459
"726","Butte County",2007-03-01,206,40,168,39,453
"727","Butte County",2007-04-01,219,47,157,41,464
"728","Butte County",2007-05-01,239,42,154,44,479
"729","Butte County",2007-06-01,257,35,162,48,502
"730","Butte County",2007-07-01,284,34,165,40,523
"731","Butte County",2007-08-01,298,39,161,42,540
"732","Butte County",2007-09-01,297,44,155,43,539
"733","Butte County",2007-10-01,285,44,152,41,522
"734","Butte County",2007-11-01,277,47,136,40,500
"735","Butte County",2007-12-01,263,46,141,41,491
"736","Butte County",2008-01-01,263,49,136,37,485
"737","Butte County",2008-02-01,259,44,145,38,486
"738","Butte County",2008-03-01,254,37,138,38,467
"739","Butte County",2008-04-01,245,41,124,41,451
"740","Butte County",2008-05-01,248,46,147,43,484
"741","Butte County",2008-06-01,267,42,131,39,479
"742","Butte County",2008-07-01,269,54,135,32,490
"743","Butte County",2008-08-01,266,48,139,38,491
"744","Butte County",2008-09-01,268,45,144,42,499
"745","Butte County",2008-10-01,264,48,139,39,490
"746","Butte County",2008-11-01,249,39,156,37,481
"747","Butte County",2008-12-01,237,43,145,30,455
"748","Butte County",2009-01-01,219,40,150,41,450
"749","Butte County",2009-02-01,225,31,139,48,443
"750","Butte County",2009-03-01,230,35,141,44,450
"751","Butte County",2009-04-01,233,37,141,46,457
"752","Butte County",2009-05-01,304,47,127,38,516
"753","Butte County",2009-06-01,366,47,118,29,560
"754","Butte County",2009-07-01,369,43,112,29,553
"755","Butte County",2009-08-01,352,39,119,29,539
"756","Butte County",2009-09-01,360,47,113,26,546
"757","Butte County",2009-10-01,337,51,132,26,546
"758","Butte County",2009-11-01,337,51,132,26,546
"759","Butte County",2009-12-01,339,40,114,36,529
"760","Butte County",2010-01-01,366,39,106,35,546
"761","Butte County",2010-02-01,378,43,103,26,550
"762","Butte County",2010-03-01,360,50,111,26,547
"763","Butte County",2010-04-01,355,48,125,24,552
"764","Butte County",2010-05-01,357,49,110,26,542
"765","Butte County",2010-06-01,365,56,113,19,553
"766","Butte County",2010-07-01,360,54,111,22,547
"767","Butte County",2010-08-01,371,57,116,19,563
"768","Butte County",2010-09-01,373,48,104,26,551
"769","Butte County",2010-10-01,367,47,104,29,547
"770","Butte County",2010-11-01,350,45,120,24,539
"771","Butte County",2010-12-01,362,39,110,24,535
"772","Butte County",2011-01-01,369,37,116,21,543
"773","Butte County",2011-02-01,362,38,123,23,546
"774","Butte County",2011-03-01,365,38,118,23,544
"775","Butte County",2011-04-01,373,48,117,24,562
"776","Butte County",2011-05-01,382,50,114,25,571
"777","Butte County",2011-06-01,355,48,122,26,551
"778","Butte County",2011-07-01,377,53,116,22,568
"779","Butte County",2011-08-01,390,55,112,21,578
"780","Butte County",2011-09-01,394,51,105,23,573
"781","Butte County",2011-10-01,401,42,103,27,573
"782","Butte County",2011-11-01,401,37,115,28,581
"783","Butte County",2011-12-01,399,32,128,29,588
"784","Butte County",2012-01-01,394,37,133,25,589
"785","Butte County",2012-02-01,400,40,125,21,586
"786","Butte County",2012-03-01,387,47,137,15,586
"787","Butte County",2012-04-01,384,44,130,19,577
"788","Butte County",2012-05-01,382,44,135,20,581
"789","Butte County",2012-06-01,390,40,130,23,583
"790","Butte County",2012-07-01,407,44,115,18,584
"791","Butte County",2012-08-01,407,46,120,17,590
"792","Butte County",2012-09-01,416,40,118,23,597
"793","Butte County",2012-10-01,410,41,120,22,593
"794","Butte County",2012-11-01,398,46,127,19,590
"795","Butte County",2012-12-01,400,47,130,16,593
"796","Butte County",2013-01-01,397,47,136,17,597
"797","Butte County",2013-02-01,387,51,139,19,596
"798","Butte County",2013-03-01,382,57,130,22,591
"799","Butte County",2013-04-01,359,55,156,25,595
"800","Butte County",2013-05-01,342,56,176,25,599
"801","Butte County",2013-06-01,351,50,166,30,597
"802","Butte County",2013-07-01,358,48,152,32,590
"803","Butte County",2013-08-01,363,46,152,33,594
"804","Butte County",2013-09-01,346,45,171,33,595
"805","Butte County",2013-10-01,329,50,184,29,592
"806","Butte County",2013-11-01,332,48,185,30,595
"807","Butte County",2013-12-01,325,44,187,33,589
"808","Butte County",2014-01-01,332,49,175,31,587
"809","Butte County",2014-02-01,315,56,177,37,585
"810","Butte County",2014-03-01,304,64,190,31,589
"811","Butte County",2014-04-01,300,63,194,31,588
"812","Butte County",2014-05-01,312,60,185,34,591
"813","Butte County",2014-06-01,307,58,192,36,593
"814","Butte County",2014-07-01,306,57,188,38,589
"815","Butte County",2014-08-01,297,58,196,39,590
"816","Butte County",2014-09-01,299,55,205,38,597
"817","Butte County",2014-10-01,286,57,211,39,593
"818","Butte County",2014-11-01,271,54,214,40,579
"819","Butte County",2014-12-01,237,45,232,43,557
"820","Butte County",2015-01-01,251,48,225,43,567
"821","Butte County",2015-02-01,269,47,215,42,573
"822","Butte County",2015-03-01,277,45,200,46,568
"823","Butte County",2015-04-01,267,42,206,44,559
"824","Butte County",2015-05-01,283,43,208,42,576
"825","Butte County",2015-06-01,285,45,211,42,583
"826","Butte County",2015-07-01,291,49,201,42,583
"827","Butte County",2015-08-01,307,47,188,45,587
"828","Butte County",2015-09-01,307,44,189,49,589
"829","Butte County",2015-10-01,309,49,191,39,588
"830","Butte County",2015-11-01,291,51,210,33,585
"831","Butte County",2015-12-01,293,45,210,33,581
"832","Butte County",2016-01-01,294,45,204,33,576
"833","Butte County",2016-02-01,295,44,200,34,573
"834","Butte County",2016-03-01,288,43,216,35,582
"835","Butte County",2016-04-01,282,36,227,42,587
"836","Butte County",2016-05-01,291,44,212,35,582
"837","Butte County",2016-06-01,303,45,204,34,586
"838","Butte County",2016-07-01,321,47,196,32,596
"839","Butte County",2016-08-01,310,50,204,32,596
"840","Butte County",2016-09-01,305,46,214,33,598
"841","Butte County",2016-10-01,298,46,209,34,587
"842","Butte County",2016-11-01,280,44,212,35,571
"843","Butte County",2016-12-01,275,39,207,39,560
"844","Butte County",2017-01-01,287,44,200,32,563
"845","Butte County",2017-02-01,298,49,190,31,568
"846","Butte County",2017-03-01,319,54,188,25,586
"847","Butte County",2017-04-01,308,51,191,29,579
"848","Butte County",2017-05-01,299,51,198,29,577
"849","Butte County",2017-06-01,302,51,192,29,574
"850","Butte County",2017-07-01,299,49,201,30,579
"851","Butte County",2017-08-01,301,47,178,33,559
"852","Butte County",2017-09-01,309,50,172,30,561
"853","Butte County",2017-10-01,322,54,163,26,565
"854","Butte County",2017-11-01,312,50,182,29,573
"855","Butte County",2017-12-01,305,47,182,33,567
"856","Butte County",2018-01-01,302,47,168,32,549
"857","Butte County",2018-02-01,283,54,174,29,540
"858","Butte County",2018-03-01,274,50,183,31,538
"859","Butte County",2018-04-01,299,56,181,25,561
"860","Butte County",2018-05-01,303,57,181,23,564
"861","Butte County",2018-06-01,310,56,171,23,560
"862","Butte County",2018-07-01,324,50,171,31,576
"863","Butte County",2018-08-01,318,51,172,30,571
"864","Butte County",2018-09-01,297,50,163,31,541
"865","Butte County",2018-10-01,310,54,155,42,561
"866","Butte County",2018-11-01,307,62,158,40,567
"867","Butte County",2018-12-01,317,58,152,39,566
"868","Butte County",2019-01-01,308,61,164,39,572
"869","Butte County",2019-02-01,309,56,167,39,571
"870","Butte County",2019-03-01,306,55,165,32,558
"871","Butte County",2019-04-01,305,56,150,35,546
"872","Butte County",2019-05-01,321,56,144,37,558
"873","Butte County",2019-06-01,322,56,158,35,571
"874","Butte County",2019-07-01,314,58,163,41,576
"875","Butte County",2019-08-01,315,57,161,40,573
"876","Butte County",2019-09-01,321,49,154,42,566
"877","Butte County",2019-10-01,332,58,138,38,566
"878","Butte County",2019-11-01,322,52,144,42,560
"879","Butte County",2019-12-01,306,47,153,32,538
"880","Butte County",2020-01-01,317,53,146,28,544
"881","Butte County",2020-02-01,310,59,159,34,562
"882","Butte County",2020-03-01,290,57,161,36,544
"883","Calaveras County",1995-10-01,20.8,0.4,29.6,3.9,54.7
"884","Calaveras County",1995-11-01,18.5,1.3,30,4.5,54.3
"885","Calaveras County",1995-12-01,19.7,1.4,30.2,4.1,55.4
"886","Calaveras County",1996-01-01,27.4,1.7,23.1,3.2,55.4
"887","Calaveras County",1996-02-01,25,3.2,25.4,2.1,55.7
"888","Calaveras County",1996-03-01,20,4.5,25.9,3.3,53.7
"889","Calaveras County",1996-04-01,23.4,3.6,23.2,4.8,55
"890","Calaveras County",1996-05-01,16.9,2.7,29.7,6,55.3
"891","Calaveras County",1996-06-01,20.6,2.6,26.8,5.1,55.1
"892","Calaveras County",1996-07-01,18.6,2.6,26.7,5.4,53.3
"893","Calaveras County",1996-08-01,17.7,2.5,27.3,5.3,52.8
"894","Calaveras County",1996-09-01,20.6,2.6,26.8,5.1,55.1
"895","Calaveras County",1996-10-01,23.4,3.9,22.3,3.9,53.5
"896","Calaveras County",1996-11-01,23.9,2.1,23.3,3.8,53.1
"897","Calaveras County",1996-12-01,22,2,22.9,4.5,51.4
"898","Calaveras County",1997-01-01,20,1.9,24.3,6.1,52.3
"899","Calaveras County",1997-02-01,17.9,2.6,22.5,5.2,48.2
"900","Calaveras County",1997-03-01,15.9,3.5,24.5,4.5,48.4
"901","Calaveras County",1997-04-01,18.3,4.5,28.1,3.1,54
"902","Calaveras County",1997-05-01,17.5,5.8,24.3,2.7,50.3
"903","Calaveras County",1997-06-01,16.8,3.1,23.6,4.9,48.4
"904","Calaveras County",1997-07-01,16.4,2.2,29.8,5.9,54.3
"905","Calaveras County",1997-08-01,16.5,2.2,30.3,5.6,54.6
"906","Calaveras County",1997-09-01,20.1,1.3,24.7,7.2,53.3
"907","Calaveras County",1997-10-01,17.9,0.9,21.4,5.9,46.1
"908","Calaveras County",1997-11-01,17.6,0.8,28.6,6.5,53.5
"909","Calaveras County",1997-12-01,17.6,0.9,29.7,4.7,52.9
"910","Calaveras County",1998-01-01,16.5,1.9,32.3,4.2,54.9
"911","Calaveras County",1998-02-01,16.3,3.6,28.8,3,51.7
"912","Calaveras County",1998-03-01,18.9,3.2,29.6,3.3,55
"913","Calaveras County",1998-04-01,15.6,1.4,27.8,4.6,49.4
"914","Calaveras County",1998-05-01,15.3,0.9,28.7,5.4,50.3
"915","Calaveras County",1998-06-01,11.9,1.9,27.4,4.5,45.7
"916","Calaveras County",1998-07-01,11.6,1.7,25.7,4.3,43.3
"917","Calaveras County",1998-08-01,18.5,2.7,21,2.7,44.9
"918","Calaveras County",1998-09-01,17.8,3.7,21.7,4.9,48.1
"919","Calaveras County",1998-10-01,15,2.9,23.4,5.1,46.4
"920","Calaveras County",1998-11-01,13.5,1.8,21.7,4.2,41.2
"921","Calaveras County",1998-12-01,15.8,1.9,19.3,3.4,40.4
"922","Calaveras County",1999-01-01,16.6,2.5,30.5,4.8,54.4
"923","Calaveras County",1999-02-01,14.5,2.1,34.9,2.1,53.6
"924","Calaveras County",1999-03-01,13.8,1.2,33.5,3.8,52.3
"925","Calaveras County",1999-04-01,18.7,1.8,30.7,3.3,54.5
"926","Calaveras County",1999-05-01,19.5,2.8,25.6,3.5,51.4
"927","Calaveras County",1999-06-01,25.3,2.4,24,1.9,53.6
"928","Calaveras County",1999-07-01,18.7,1.2,27.5,5.1,52.5
"929","Calaveras County",1999-08-01,17.5,2.4,23.5,3.4,46.8
"930","Calaveras County",1999-09-01,17.8,3.1,28.4,3.5,52.8
"931","Calaveras County",1999-10-01,17.5,3.5,23.7,2.1,46.8
"932","Calaveras County",1999-11-01,16.6,2.1,22.3,1.6,42.6
"933","Calaveras County",1999-12-01,13.7,2.1,21.2,1.5,38.5
"934","Calaveras County",2000-01-01,13.1,2.4,22.4,0.2,38.1
"935","Calaveras County",2000-02-01,15.2,3.3,30.6,1.6,50.7
"936","Calaveras County",2000-03-01,14.5,3.6,29.5,1.5,49.1
"937","Calaveras County",2000-04-01,13.1,3.8,24,0.9,41.8
"938","Calaveras County",2000-05-01,19.7,2.5,15.2,1.3,38.7
"939","Calaveras County",2000-06-01,26.3,3.1,19.8,1.9,51.1
"940","Calaveras County",2000-07-01,16.6,5,16.6,1.5,39.7
"941","Calaveras County",2000-08-01,15.1,1.4,18.6,2.3,37.4
"942","Calaveras County",2000-09-01,15.6,1.4,19.7,3,39.7
"943","Calaveras County",2000-10-01,13.3,1.5,16.8,1.6,33.2
"944","Calaveras County",2000-11-01,20,1.5,17.3,0.5,39.3
"945","Calaveras County",2000-12-01,23.2,1.8,18.3,0.8,44.1
"946","Calaveras County",2001-01-01,17,1,22,4,45
"947","Calaveras County",2001-02-01,18,2,27,4,51
"948","Calaveras County",2001-03-01,22,3,20,4,49
"949","Calaveras County",2001-04-01,22,4,21,3,50
"950","Calaveras County",2001-05-01,25,2,23,3,52
"951","Calaveras County",2001-06-01,26,0,31,0,58
"952","Calaveras County",2001-07-01,25,1,30,1,57
"953","Calaveras County",2001-08-01,32,4,23,5,64
"954","Calaveras County",2001-09-01,33,2,19,4,58
"955","Calaveras County",2001-10-01,37,3,20,4,64
"956","Calaveras County",2001-11-01,34,4,18,1,57
"957","Calaveras County",2001-12-01,34,4,14,3,55
"958","Calaveras County",2002-01-01,32,4,27,3,66
"959","Calaveras County",2002-02-01,33,4,31,4,72
"960","Calaveras County",2002-03-01,33,7,29,5,74
"961","Calaveras County",2002-04-01,29,8,31,3,71
"962","Calaveras County",2002-05-01,31,5,30,4,70
"963","Calaveras County",2002-06-01,40,4,27,4,75
"964","Calaveras County",2002-07-01,43,4,26,2,75
"965","Calaveras County",2002-08-01,41,4,28,2,75
"966","Calaveras County",2002-09-01,40,6,26,3,75
"967","Calaveras County",2002-10-01,42,7,24,4,77
"968","Calaveras County",2002-11-01,42,9,22,2,75
"969","Calaveras County",2002-12-01,44,4,22,2,72
"970","Calaveras County",2003-01-01,38,6,31,2,77
"971","Calaveras County",2003-02-01,41,8,24,1,74
"972","Calaveras County",2003-03-01,46,8,19,2,75
"973","Calaveras County",2003-04-01,43,6,23,4,76
"974","Calaveras County",2003-05-01,39,6,29,5,79
"975","Calaveras County",2003-06-01,34,7,31,5,77
"976","Calaveras County",2003-07-01,42,7,24,4,77
"977","Calaveras County",2003-08-01,43,6,23,4,76
"978","Calaveras County",2003-09-01,44,7,22,4,77
"979","Calaveras County",2003-10-01,37,4,27,6,74
"980","Calaveras County",2003-11-01,32,5,31,6,74
"981","Calaveras County",2003-12-01,30,6,35,4,75
"982","Calaveras County",2004-01-01,39,6,25,5,75
"983","Calaveras County",2004-02-01,43,8,22,3,76
"984","Calaveras County",2004-03-01,42,8,24,3,77
"985","Calaveras County",2004-04-01,44,7,24,3,78
"986","Calaveras County",2004-05-01,41,7,27,2,77
"987","Calaveras County",2004-06-01,39,8,28,1,76
"988","Calaveras County",2004-07-01,39,8,28,2,77
"989","Calaveras County",2004-08-01,41,8,26,2,77
"990","Calaveras County",2004-09-01,46,8,20,2,76
"991","Calaveras County",2004-10-01,46,6,22,3,77
"992","Calaveras County",2004-11-01,43,7,25,3,78
"993","Calaveras County",2004-12-01,40,7,27,3,77
"994","Calaveras County",2005-01-01,40,6,30,2,78
"995","Calaveras County",2005-02-01,38,8,28,1,75
"996","Calaveras County",2005-03-01,42,5,25,4,76
"997","Calaveras County",2005-04-01,44,4,24,3,75
"998","Calaveras County",2005-05-01,42,6,27,3,78
"999","Calaveras County",2005-06-01,39,7,28,3,77
"1000","Calaveras County",2005-07-01,39,7,28,2,76
"1001","Calaveras County",2005-08-01,43,7,24,1,75
"1002","Calaveras County",2005-09-01,44,9,19,2,74
"1003","Calaveras County",2005-10-01,43,7,23,2,75
"1004","Calaveras County",2005-11-01,46,6,22,3,77
"1005","Calaveras County",2005-12-01,44,7,26,2,79
"1006","Calaveras County",2006-01-01,49,9,22,1,81
"1007","Calaveras County",2006-02-01,44,8,24,2,78
"1008","Calaveras County",2006-03-01,36,8,28,2,74
"1009","Calaveras County",2006-04-01,42,6,25,3,76
"1010","Calaveras County",2006-05-01,45,10,23,3,81
"1011","Calaveras County",2006-06-01,45,11,21,2,79
"1012","Calaveras County",2006-07-01,39,7,28,2,76
"1013","Calaveras County",2006-08-01,37,9,25,3,74
"1014","Calaveras County",2006-09-01,35,8,27,2,72
"1015","Calaveras County",2006-10-01,42,7,20,4,73
"1016","Calaveras County",2006-11-01,47,8,17,3,75
"1017","Calaveras County",2006-12-01,47,9,17,2,75
"1018","Calaveras County",2007-01-01,42,7,21,1,71
"1019","Calaveras County",2007-02-01,41,9,23,1,74
"1020","Calaveras County",2007-03-01,45,9,20,2,76
"1021","Calaveras County",2007-04-01,48,6,20,4,78
"1022","Calaveras County",2007-05-01,43,5,26,4,78
"1023","Calaveras County",2007-06-01,37,7,28,3,75
"1024","Calaveras County",2007-07-01,44,7,22,2,75
"1025","Calaveras County",2007-08-01,48,7,20,2,77
"1026","Calaveras County",2007-09-01,47,9,17,1,74
"1027","Calaveras County",2007-10-01,44,6,20,4,74
"1028","Calaveras County",2007-11-01,39,6,25,3,73
"1029","Calaveras County",2007-12-01,39,7,27,2,75
"1030","Calaveras County",2008-01-01,41,5,26,3,75
"1031","Calaveras County",2008-02-01,43,5,22,5,75
"1032","Calaveras County",2008-03-01,42,6,25,3,76
"1033","Calaveras County",2008-04-01,42,6,26,1,75
"1034","Calaveras County",2008-05-01,49,7,22,2,80
"1035","Calaveras County",2008-06-01,47,4,21,4,76
"1036","Calaveras County",2008-07-01,39,7,29,1,76
"1037","Calaveras County",2008-08-01,43,6,26,1,76
"1038","Calaveras County",2008-09-01,46,4,25,0,75
"1039","Calaveras County",2008-10-01,37,5,28,2,72
"1040","Calaveras County",2008-11-01,32,5,30,3,70
"1041","Calaveras County",2008-12-01,31,7,29,2,69
"1042","Calaveras County",2009-01-01,38,8,25,2,73
"1043","Calaveras County",2009-02-01,39,8,24,2,73
"1044","Calaveras County",2009-03-01,39,7,25,3,74
"1045","Calaveras County",2009-04-01,45,7,23,3,78
"1046","Calaveras County",2009-05-01,47,7,21,3,78
"1047","Calaveras County",2009-06-01,45,7,23,3,78
"1048","Calaveras County",2009-07-01,48,5,21,4,78
"1049","Calaveras County",2009-08-01,46,7,18,4,75
"1050","Calaveras County",2009-09-01,45,8,22,3,78
"1051","Calaveras County",2009-10-01,44,4,23,6,77
"1052","Calaveras County",2009-11-01,44,5,20,6,75
"1053","Calaveras County",2009-12-01,47,4,17,6,74
"1054","Calaveras County",2010-01-01,47,5,17,4,73
"1055","Calaveras County",2010-02-01,37,5,26,3,71
"1056","Calaveras County",2010-03-01,36,4,30,4,74
"1057","Calaveras County",2010-04-01,39,6,25,4,74
"1058","Calaveras County",2010-05-01,39,8,27,3,77
"1059","Calaveras County",2010-06-01,40,6,22,3,71
"1060","Calaveras County",2010-07-01,37,7,25,3,72
"1061","Calaveras County",2010-08-01,61,10,5,0,76
"1062","Calaveras County",2010-09-01,34,6,31,3,74
"1063","Calaveras County",2010-10-01,25,4,31,4,64
"1064","Calaveras County",2010-11-01,29,4,25,2,60
"1065","Calaveras County",2010-12-01,32,5,21,4,62
"1066","Calaveras County",2011-01-01,43,7,23,5,78
"1067","Calaveras County",2011-02-01,38,7,27,7,79
"1068","Calaveras County",2011-03-01,40,5,31,4,80
"1069","Calaveras County",2011-04-01,35,5,25,2,67
"1070","Calaveras County",2011-05-01,37,7,22,3,69
"1071","Calaveras County",2011-06-01,35,7,27,5,74
"1072","Calaveras County",2011-07-01,30,4,22,6,62
"1073","Calaveras County",2011-08-01,25,3,18,5,51
"1074","Calaveras County",2011-09-01,24,3,20,4,51
"1075","Calaveras County",2011-10-01,26,2,23,5,56
"1076","Calaveras County",2011-11-01,29,3,27,9,68
"1077","Calaveras County",2011-12-01,26,7,31,7,71
"1078","Calaveras County",2012-01-01,34,11,18,0,63
"1079","Calaveras County",2012-02-01,48,10,7,2,67
"1080","Calaveras County",2012-03-01,49,2,9,10,70
"1081","Calaveras County",2012-04-01,48,8,14,2,72
"1082","Calaveras County",2012-05-01,46,9,15,1,71
"1083","Calaveras County",2012-06-01,37,9,24,1,71
"1084","Calaveras County",2012-07-01,35,2,28,6,71
"1085","Calaveras County",2012-08-01,36,3,28,4,71
"1086","Calaveras County",2012-09-01,36,4,23,7,70
"1087","Calaveras County",2012-10-01,36,4,24,6,70
"1088","Calaveras County",2012-11-01,32,5,26,5,68
"1089","Calaveras County",2012-12-01,32,5,27,5,69
"1090","Calaveras County",2013-01-01,32,5,30,2,69
"1091","Calaveras County",2013-02-01,34,8,26,3,71
"1092","Calaveras County",2013-03-01,29,7,31,3,70
"1093","Calaveras County",2013-04-01,34,7,26,2,69
"1094","Calaveras County",2013-05-01,34,7,28,2,71
"1095","Calaveras County",2013-06-01,32,4,31,3,70
"1096","Calaveras County",2013-07-01,31,4,29,5,69
"1097","Calaveras County",2013-08-01,39,6,24,2,71
"1098","Calaveras County",2013-09-01,33,9,29,2,73
"1099","Calaveras County",2013-10-01,33,6,29,4,72
"1100","Calaveras County",2013-11-01,36,4,28,4,72
"1101","Calaveras County",2013-12-01,34,5,29,4,72
"1102","Calaveras County",2014-01-01,32,6,29,3,70
"1103","Calaveras County",2014-02-01,28,7,33,3,71
"1104","Calaveras County",2014-03-01,30,6,32,3,71
"1105","Calaveras County",2014-04-01,32,5,27,2,66
"1106","Calaveras County",2014-05-01,34,6,26,2,68
"1107","Calaveras County",2014-06-01,35,8,28,3,74
"1108","Calaveras County",2014-07-01,43,7,29,5,84
"1109","Calaveras County",2014-08-01,40,7,31,8,86
"1110","Calaveras County",2014-09-01,38,5,31,9,83
"1111","Calaveras County",2014-10-01,40,7,31,6,84
"1112","Calaveras County",2014-11-01,37,9,32,4,82
"1113","Calaveras County",2014-12-01,37,6,32,8,83
"1114","Calaveras County",2015-01-01,40,6,30,6,82
"1115","Calaveras County",2015-02-01,43,7,27,5,82
"1116","Calaveras County",2015-03-01,45,7,28,8,88
"1117","Calaveras County",2015-04-01,45,7,28,7,87
"1118","Calaveras County",2015-05-01,42,9,32,10,93
"1119","Calaveras County",2015-06-01,42,7,33,12,94
"1120","Calaveras County",2015-07-01,50,8,37,13,108
"1121","Calaveras County",2015-08-01,45,9,31,13,98
"1122","Calaveras County",2015-09-01,46,11,23,11,91
"1123","Calaveras County",2015-10-01,43,12,27,11,93
"1124","Calaveras County",2015-11-01,40,10,33,12,95
"1125","Calaveras County",2015-12-01,37,9,32,12,90
"1126","Calaveras County",2016-01-01,38,9,32,11,90
"1127","Calaveras County",2016-02-01,35,10,34,12,91
"1128","Calaveras County",2016-03-01,34,12,37,12,95
"1129","Calaveras County",2016-04-01,29,9,34,11,83
"1130","Calaveras County",2016-05-01,37,9,29,11,86
"1131","Calaveras County",2016-06-01,37,10,31,13,91
"1132","Calaveras County",2016-07-01,37,9,32,11,89
"1133","Calaveras County",2016-08-01,50,10,32,10,102
"1134","Calaveras County",2016-09-01,42,11,29,10,92
"1135","Calaveras County",2016-10-01,46,12,29,7,94
"1136","Calaveras County",2016-11-01,42,12,28,7,89
"1137","Calaveras County",2016-12-01,41,10,34,10,95
"1138","Calaveras County",2017-01-01,43,10,32,10,95
"1139","Calaveras County",2017-02-01,45,9,37,9,100
"1140","Calaveras County",2017-03-01,39,9,35,8,91
"1141","Calaveras County",2017-04-01,44,6,35,9,94
"1142","Calaveras County",2017-05-01,46,7,38,9,100
"1143","Calaveras County",2017-06-01,47,8,34,5,94
"1144","Calaveras County",2017-07-01,50,8,35,7,100
"1145","Calaveras County",2017-08-01,48,10,30,8,96
"1146","Calaveras County",2017-09-01,49,10,23,9,91
"1147","Calaveras County",2017-10-01,55,12,22,7,96
"1148","Calaveras County",2017-11-01,57,11,23,5,96
"1149","Calaveras County",2017-12-01,53,7,24,8,92
"1150","Calaveras County",2018-01-01,57,13,28,8,106
"1151","Calaveras County",2018-02-01,56,10,33,10,109
"1152","Calaveras County",2018-03-01,45,10,43,12,110
"1153","Calaveras County",2018-04-01,43,7,38,11,99
"1154","Calaveras County",2018-05-01,45,8,37,7,97
"1155","Calaveras County",2018-06-01,43,5,32,6,86
"1156","Calaveras County",2018-07-01,49,7,27,6,89
"1157","Calaveras County",2018-08-01,44,7,24,9,84
"1158","Calaveras County",2018-09-01,44,7,24,10,85
"1159","Calaveras County",2018-10-01,47,10,23,5,85
"1160","Calaveras County",2018-11-01,54,12,23,6,95
"1161","Calaveras County",2018-12-01,53,8,23,8,92
"1162","Calaveras County",2019-01-01,55,9,27,10,101
"1163","Calaveras County",2019-02-01,56,9,23,10,98
"1164","Calaveras County",2019-03-01,55,8,18,9,90
"1165","Calaveras County",2019-04-01,53,5,18,8,84
"1166","Calaveras County",2019-05-01,52,5,22,2,81
"1167","Calaveras County",2019-06-01,52,4,27,6,89
"1168","Calaveras County",2019-07-01,59,8,31,6,104
"1169","Calaveras County",2019-08-01,62,7,26,9,104
"1170","Calaveras County",2019-09-01,69,10,26,6,111
"1171","Calaveras County",2019-10-01,65,11,27,3,106
"1172","Calaveras County",2019-11-01,67,11,26,4,108
"1173","Calaveras County",2019-12-01,61,11,24,4,100
"1174","Calaveras County",2020-01-01,66,11,23,7,107
"1175","Calaveras County",2020-02-01,74,13,24,9,120
"1176","Calaveras County",2020-03-01,62,9,28,8,107
"1177","Colusa County",1995-10-01,26,1,31,1,59
"1178","Colusa County",1995-11-01,25,2,38,2,67
"1179","Colusa County",1995-12-01,29,3,31,1,64
"1180","Colusa County",1996-01-01,26,4,36,1,67
"1181","Colusa County",1996-02-01,35,2,33,3,73
"1182","Colusa County",1996-03-01,24,2,33,7,66
"1183","Colusa County",1996-04-01,27,2,35,6,70
"1184","Colusa County",1996-05-01,28,3,35,8,74
"1185","Colusa County",1996-06-01,24,3,41,7,75
"1186","Colusa County",1996-07-01,20,2,43,7,72
"1187","Colusa County",1996-08-01,25,4,43,4,76
"1188","Colusa County",1996-09-01,21,2,43,4,70
"1189","Colusa County",1996-10-01,24,3,40,3,70
"1190","Colusa County",1996-11-01,24,3,35,1,63
"1191","Colusa County",1996-12-01,21,2,30,3,56
"1192","Colusa County",1997-01-01,27,3,33,4,67
"1193","Colusa County",1997-02-01,23,3,32,3,61
"1194","Colusa County",1997-03-01,27,3,33,4,67
"1195","Colusa County",1997-04-01,43,3,20,5,71
"1196","Colusa County",1997-05-01,37,4,4,23,68
"1197","Colusa County",1997-06-01,41,2,30,5,78
"1198","Colusa County",1997-07-01,37,4,28,4,73
"1199","Colusa County",1997-08-01,37,6,30,4,77
"1200","Colusa County",1997-09-01,33,4,33,4,74
"1201","Colusa County",1997-10-01,30,1,32,4,67
"1202","Colusa County",1997-11-01,29,2,38,2,71
"1203","Colusa County",1997-12-01,38,2,36,2,78
"1204","Colusa County",1998-01-01,30,2,36,3,71
"1205","Colusa County",1998-02-01,29,2,34,2,67
"1206","Colusa County",1998-03-01,38,2,36,2,78
"1207","Colusa County",1998-04-01,25,5,39,5,74
"1208","Colusa County",1998-05-01,25,5,39,5,74
"1209","Colusa County",1998-06-01,25,5,39,5,74
"1210","Colusa County",1998-07-01,32,5,34,4,75
"1211","Colusa County",1998-08-01,29,4,31,5,69
"1212","Colusa County",1998-09-01,32,5,30,5,72
"1213","Colusa County",1998-10-01,35,4,34,3,76
"1214","Colusa County",1998-11-01,37,4,30,5,76
"1215","Colusa County",1998-12-01,37,2,26,4,69
"1216","Colusa County",1999-01-01,36,2,34,2,74
"1217","Colusa County",1999-02-01,29,3,40,2,74
"1218","Colusa County",1999-03-01,25,2,38,4,69
"1219","Colusa County",1999-04-01,21,1,42,6,70
"1220","Colusa County",1999-05-01,27,1,34,4,66
"1221","Colusa County",1999-06-01,30,2,31,5,68
"1222","Colusa County",1999-07-01,34,3,29,4,70
"1223","Colusa County",1999-08-01,33,1,36,4,74
"1224","Colusa County",1999-09-01,34,2,47,5,88
"1225","Colusa County",1999-10-01,23,2,34,5,64
"1226","Colusa County",1999-11-01,16,7,43,5,71
"1227","Colusa County",1999-12-01,15,1,42,4,62
"1228","Colusa County",2000-01-01,19,1,35,3,58
"1229","Colusa County",2000-02-01,20,5,28,3,56
"1230","Colusa County",2000-03-01,20,1,31,4,56
"1231","Colusa County",2000-04-01,27,5,33,2,67
"1232","Colusa County",2000-05-01,23,4,28,2,57
"1233","Colusa County",2000-06-01,27,5,19,4,55
"1234","Colusa County",2000-07-01,13,2.8,10,1.8,27.6
"1235","Colusa County",2000-08-01,12,1.5,12,3.6,29.1
"1236","Colusa County",2000-09-01,13,1.4,15,3,32.4
"1237","Colusa County",2000-10-01,17,0.8,16,0.74,34.54
"1238","Colusa County",2000-11-01,16.95,0.17,18.52,0.88,36.52
"1239","Colusa County",2000-12-01,15,0.6,16,1.2,32.8
"1240","Colusa County",2001-01-01,12,0,15,3,30
"1241","Colusa County",2001-02-01,11,1,12,2,26
"1242","Colusa County",2001-03-01,18,1,27,2,48
"1243","Colusa County",2001-04-01,14,2,22,2,40
"1244","Colusa County",2001-05-01,16,2,26,5,49
"1245","Colusa County",2001-06-01,12,3,18,5,38
"1246","Colusa County",2001-07-01,15,3,19,3,40
"1247","Colusa County",2001-08-01,31,2,21,1,55
"1248","Colusa County",2001-09-01,23,3,19,1,46
"1249","Colusa County",2001-10-01,21,2,19,2,44
"1250","Colusa County",2001-11-01,27,3,23,4,57
"1251","Colusa County",2001-12-01,25,2,16,6,49
"1252","Colusa County",2002-01-01,23,2,20,7,52
"1253","Colusa County",2002-02-01,28,2,22,5,57
"1254","Colusa County",2002-03-01,21,4,27,5,57
"1255","Colusa County",2002-04-01,23,4,28,3,58
"1256","Colusa County",2002-05-01,24,3,21,2,50
"1257","Colusa County",2002-06-01,22,4,21,2,49
"1258","Colusa County",2002-07-01,23,5,19,3,50
"1259","Colusa County",2002-08-01,26,5,15,5,51
"1260","Colusa County",2002-09-01,21,4,23,3,51
"1261","Colusa County",2002-10-01,18,3,29,3,53
"1262","Colusa County",2002-11-01,17,5,21,2,45
"1263","Colusa County",2002-12-01,18,3,19,2,42
"1264","Colusa County",2003-01-01,20,3,21,2,46
"1265","Colusa County",2003-02-01,22,4,30,1,57
"1266","Colusa County",2003-03-01,17,3,38,3,61
"1267","Colusa County",2003-04-01,21,3,30,2,56
"1268","Colusa County",2003-05-01,20,4,22,3,49
"1269","Colusa County",2003-06-01,21,1,25,3,50
"1270","Colusa County",2003-07-01,30,2,28,2,62
"1271","Colusa County",2003-08-01,26,4,29,2,61
"1272","Colusa County",2003-09-01,22,3,27,3,55
"1273","Colusa County",2003-10-01,21,3,25,2,51
"1274","Colusa County",2003-11-01,16,2,22,3,43
"1275","Colusa County",2003-12-01,14,4,23,3,44
"1276","Colusa County",2004-01-01,20,3,24,6,53
"1277","Colusa County",2004-02-01,21,4,21,4,50
"1278","Colusa County",2004-03-01,17,2,19,7,45
"1279","Colusa County",2004-04-01,18,2,19,6,45
"1280","Colusa County",2004-05-01,18,4,25,3,50
"1281","Colusa County",2004-06-01,19,3,25,0,47
"1282","Colusa County",2004-07-01,19,3,23,1,46
"1283","Colusa County",2004-08-01,24,2,18,3,47
"1284","Colusa County",2004-09-01,20,2,16,3,41
"1285","Colusa County",2004-10-01,22,3,23,3,51
"1286","Colusa County",2004-11-01,26,2,26,3,57
"1287","Colusa County",2004-12-01,19,2,29,2,52
"1288","Colusa County",2005-01-01,13,3,28,3,47
"1289","Colusa County",2005-02-01,15,4,27,3,49
"1290","Colusa County",2005-03-01,13,2,26,3,44
"1291","Colusa County",2005-04-01,13,3,25,2,43
"1292","Colusa County",2005-05-01,18,4,26,1,49
"1293","Colusa County",2005-06-01,18,3,24,1,46
"1294","Colusa County",2005-07-01,19,5,23,3,50
"1295","Colusa County",2005-08-01,15,4,20,2,41
"1296","Colusa County",2005-09-01,19,7,17,1,44
"1297","Colusa County",2005-10-01,21,4,20,1,46
"1298","Colusa County",2005-11-01,24,5,26,4,59
"1299","Colusa County",2005-12-01,19,4,22,5,50
"1300","Colusa County",2006-01-01,14,4,12,4,34
"1301","Colusa County",2006-02-01,23,3,14,5,45
"1302","Colusa County",2006-03-01,18,7,16,3,44
"1303","Colusa County",2006-04-01,21,4,12,3,40
"1304","Colusa County",2006-05-01,26,3,10,5,44
"1305","Colusa County",2006-06-01,25,2,12,3,42
"1306","Colusa County",2006-07-01,21,2,14,2,39
"1307","Colusa County",2006-08-01,28,2,12,5,47
"1308","Colusa County",2006-09-01,31,7,14,7,59
"1309","Colusa County",2006-10-01,36,4,12,5,57
"1310","Colusa County",2006-11-01,27,3,17,3,50
"1311","Colusa County",2006-12-01,27,4,19,0,50
"1312","Colusa County",2007-01-01,26,3,24,3,56
"1313","Colusa County",2007-02-01,28,1,23,4,56
"1314","Colusa County",2007-03-01,29,3,21,4,57
"1315","Colusa County",2007-04-01,31,3,21,4,59
"1316","Colusa County",2007-05-01,31,5,24,5,65
"1317","Colusa County",2007-06-01,31,5,31,5,72
"1318","Colusa County",2007-07-01,28,5,25,5,63
"1319","Colusa County",2007-08-01,33,5,19,2,59
"1320","Colusa County",2007-09-01,29,3,14,3,49
"1321","Colusa County",2007-10-01,26,4,13,2,45
"1322","Colusa County",2007-11-01,31,7,15,2,55
"1323","Colusa County",2007-12-01,31,5,17,4,57
"1324","Colusa County",2008-01-01,24,4,20,5,53
"1325","Colusa County",2008-02-01,23,2,19,2,46
"1326","Colusa County",2008-03-01,23,2,17,4,46
"1327","Colusa County",2008-04-01,27,1,19,4,51
"1328","Colusa County",2008-05-01,27,2,15,2,46
"1329","Colusa County",2008-06-01,29,1,14,0,44
"1330","Colusa County",2008-07-01,26,1,17,0,44
"1331","Colusa County",2008-08-01,26,3,15,3,47
"1332","Colusa County",2008-09-01,25,3,18,5,51
"1333","Colusa County",2008-10-01,25,2,17,5,49
"1334","Colusa County",2008-11-01,26,3,19,5,53
"1335","Colusa County",2008-12-01,18,1,19,4,42
"1336","Colusa County",2009-01-01,21,3,17,4,45
"1337","Colusa County",2009-02-01,23,4,16,3,46
"1338","Colusa County",2009-03-01,25,3,14,4,46
"1339","Colusa County",2009-04-01,21,6,16,4,47
"1340","Colusa County",2009-05-01,19,6,13,2,40
"1341","Colusa County",2009-06-01,17,5,14,1,37
"1342","Colusa County",2009-07-01,21,4,16,0,41
"1343","Colusa County",2009-08-01,25,1,17,1,44
"1344","Colusa County",2009-09-01,25,4,16,0,45
"1345","Colusa County",2009-10-01,28,3,16,0,47
"1346","Colusa County",2009-11-01,27,3,14,0,44
"1347","Colusa County",2009-12-01,16,5,18,0,39
"1348","Colusa County",2010-01-01,18,5,13,0,36
"1349","Colusa County",2010-02-01,24,3,9,0,36
"1350","Colusa County",2010-03-01,32,4,7,2,45
"1351","Colusa County",2010-04-01,30,4,8,3,45
"1352","Colusa County",2010-05-01,23,3,13,3,42
"1353","Colusa County",2010-06-01,24,5,8,3,40
"1354","Colusa County",2010-07-01,27,8,9,3,47
"1355","Colusa County",2010-08-01,28,5,13,2,48
"1356","Colusa County",2010-09-01,27,5,12,4,48
"1357","Colusa County",2010-10-01,22,6,9,4,41
"1358","Colusa County",2010-11-01,23,4,11,7,45
"1359","Colusa County",2010-12-01,26,4,9,7,46
"1360","Colusa County",2011-01-01,26,3,18,4,51
"1361","Colusa County",2011-02-01,24,3,19,4,50
"1362","Colusa County",2011-03-01,22,5,19,3,49
"1363","Colusa County",2011-04-01,21,4,14,3,42
"1364","Colusa County",2011-05-01,25,2,15,4,46
"1365","Colusa County",2011-06-01,23,2,14,5,44
"1366","Colusa County",2011-07-01,26,2,14,6,48
"1367","Colusa County",2011-08-01,27,5,14,3,49
"1368","Colusa County",2011-09-01,28,5,13,2,48
"1369","Colusa County",2011-10-01,21,3,17,2,43
"1370","Colusa County",2011-11-01,26,4,24,2,56
"1371","Colusa County",2011-12-01,32,6,18,2,58
"1372","Colusa County",2012-01-01,30,12,20,2,64
"1373","Colusa County",2012-02-01,32,10,20,6,68
"1374","Colusa County",2012-03-01,30,10,18,6,64
"1375","Colusa County",2012-04-01,29,5,19,7,60
"1376","Colusa County",2012-05-01,24,7,23,6,60
"1377","Colusa County",2012-06-01,29,10,22,3,64
"1378","Colusa County",2012-07-01,35,10,19,3,67
"1379","Colusa County",2012-08-01,34,14,17,4,69
"1380","Colusa County",2012-09-01,37,12,13,4,66
"1381","Colusa County",2012-10-01,33,7,18,6,64
"1382","Colusa County",2012-11-01,33,8,20,5,66
"1383","Colusa County",2012-12-01,34,7,16,4,61
"1384","Colusa County",2013-01-01,38,5,14,3,60
"1385","Colusa County",2013-02-01,39,8,15,4,66
"1386","Colusa County",2013-03-01,41,7,18,7,73
"1387","Colusa County",2013-04-01,45,7,13,10,75
"1388","Colusa County",2013-05-01,44,6,18,10,78
"1389","Colusa County",2013-06-01,42,9,16,7,74
"1390","Colusa County",2013-07-01,38,9,15,6,68
"1391","Colusa County",2013-08-01,32,7,18,6,63
"1392","Colusa County",2013-09-01,32,6,23,7,68
"1393","Colusa County",2013-10-01,30,6,23,6,65
"1394","Colusa County",2013-11-01,34,8,21,6,69
"1395","Colusa County",2013-12-01,37,8,18,6,69
"1396","Colusa County",2014-01-01,47,9,16,6,78
"1397","Colusa County",2014-02-01,50,7,20,5,82
"1398","Colusa County",2014-03-01,49,6,22,6,83
"1399","Colusa County",2014-04-01,51,7,20,7,85
"1400","Colusa County",2014-05-01,50,7,18,7,82
"1401","Colusa County",2014-06-01,42,6,21,5,74
"1402","Colusa County",2014-07-01,44,5,20,4,73
"1403","Colusa County",2014-08-01,43,8,20,3,74
"1404","Colusa County",2014-09-01,47,10,16,4,77
"1405","Colusa County",2014-10-01,54,7,17,4,82
"1406","Colusa County",2014-11-01,53,4,21,8,86
"1407","Colusa County",2014-12-01,45,2,19,6,72
"1408","Colusa County",2015-01-01,45,6,14,5,70
"1409","Colusa County",2015-02-01,41,6,16,5,68
"1410","Colusa County",2015-03-01,38,6,18,8,70
"1411","Colusa County",2015-04-01,40,7,16,11,74
"1412","Colusa County",2015-05-01,42,6,18,9,75
"1413","Colusa County",2015-06-01,42,7,19,12,80
"1414","Colusa County",2015-07-01,39,6,20,9,74
"1415","Colusa County",2015-08-01,39,4,27,7,77
"1416","Colusa County",2015-09-01,46,6,23,6,81
"1417","Colusa County",2015-10-01,44,6,30,5,85
"1418","Colusa County",2015-11-01,50,6,29,5,90
"1419","Colusa County",2015-12-01,51,5,26,6,88
"1420","Colusa County",2016-01-01,47,6,27,4,84
"1421","Colusa County",2016-02-01,42,8,27,3,80
"1422","Colusa County",2016-03-01,42,9,27,3,81
"1423","Colusa County",2016-04-01,48,6,24,6,84
"1424","Colusa County",2016-05-01,42,6,29,4,81
"1425","Colusa County",2016-06-01,52,5,27,1,85
"1426","Colusa County",2016-07-01,51,4,24,3,82
"1427","Colusa County",2016-08-01,50,6,25,3,84
"1428","Colusa County",2016-09-01,47,8,26,2,83
"1429","Colusa County",2016-10-01,42,8,29,5,84
"1430","Colusa County",2016-11-01,42,7,26,6,81
"1431","Colusa County",2016-12-01,46,5,31,8,90
"1432","Colusa County",2017-01-01,41,7,32,5,85
"1433","Colusa County",2017-02-01,42,8,25,5,80
"1434","Colusa County",2017-03-01,41,7,27,5,80
"1435","Colusa County",2017-04-01,41,7,25,5,78
"1436","Colusa County",2017-05-01,42,7,22,4,75
"1437","Colusa County",2017-06-01,39,9,27,2,77
"1438","Colusa County",2017-07-01,42,10,22,3,77
"1439","Colusa County",2017-08-01,47,9,17,4,77
"1440","Colusa County",2017-09-01,43,11,17,4,75
"1441","Colusa County",2017-10-01,42,9,21,5,77
"1442","Colusa County",2017-11-01,47,10,20,3,80
"1443","Colusa County",2017-12-01,39,8,26,6,79
"1444","Colusa County",2018-01-01,37,6,22,9,74
"1445","Colusa County",2018-02-01,40,8,23,11,82
"1446","Colusa County",2018-03-01,37,10,23,9,79
"1447","Colusa County",2018-04-01,39,9,28,9,85
"1448","Colusa County",2018-05-01,35,13,23,8,79
"1449","Colusa County",2018-06-01,36,11,21,11,79
"1450","Colusa County",2018-07-01,40,10,21,6,77
"1451","Colusa County",2018-08-01,39,9,20,6,74
"1452","Colusa County",2018-09-01,35,9,22,5,71
"1453","Colusa County",2018-10-01,32,6,24,6,68
"1454","Colusa County",2018-11-01,37,5,26,5,73
"1455","Colusa County",2018-12-01,35,5,21,4,65
"1456","Colusa County",2019-01-01,41,7,19,4,71
"1457","Colusa County",2019-02-01,40,9,21,5,75
"1458","Colusa County",2019-03-01,40,7,16,6,69
"1459","Colusa County",2019-04-01,46,8,15,5,74
"1460","Colusa County",2019-05-01,40,7,14,3,64
"1461","Colusa County",2019-06-01,34,10,16,3,63
"1462","Colusa County",2019-07-01,39,10,19,4,72
"1463","Colusa County",2019-08-01,39,8,20,5,72
"1464","Colusa County",2019-09-01,46,7,17,5,75
"1465","Colusa County",2019-10-01,41,8,20,7,76
"1466","Colusa County",2019-11-01,36,6,23,6,71
"1467","Colusa County",2019-12-01,31,5,19,4,59
"1468","Colusa County",2020-01-01,34,8,22,3,67
"1469","Colusa County",2020-02-01,34,7,25,2,68
"1470","Colusa County",2020-03-01,31,6,26,2,65
"1471","Contra Costa County",1995-10-01,1244,0,230,0,1474
"1472","Contra Costa County",1995-11-01,864,0,654,0,1518
"1473","Contra Costa County",1995-12-01,835,0,598,0,1433
"1474","Contra Costa County",1996-01-01,783,0,677,0,1460
"1475","Contra Costa County",1996-02-01,821,0,696,0,1517
"1476","Contra Costa County",1996-03-01,814,0,716,0,1530
"1477","Contra Costa County",1996-04-01,880,0,708,0,1588
"1478","Contra Costa County",1996-05-01,848,0,740,0,1588
"1479","Contra Costa County",1996-06-01,856,0,739,0,1595
"1480","Contra Costa County",1996-07-01,863,0,757,0,1620
"1481","Contra Costa County",1996-08-01,840,0,785,0,1625
"1482","Contra Costa County",1996-09-01,889,0,730,0,1619
"1483","Contra Costa County",1996-10-01,700,154,600,92,1546
"1484","Contra Costa County",1996-11-01,700,165,500,183,1548
"1485","Contra Costa County",1996-12-01,700,136,500,148,1484
"1486","Contra Costa County",1997-01-01,788,119,584,59,1550
"1487","Contra Costa County",1997-02-01,772,113,620,61,1566
"1488","Contra Costa County",1997-03-01,830,148,622,77,1677
"1489","Contra Costa County",1997-04-01,801,120,649,68,1638
"1490","Contra Costa County",1997-05-01,760,125,686,79,1650
"1491","Contra Costa County",1997-06-01,745,127,662,78,1612
"1492","Contra Costa County",1997-07-01,760,140,665,78,1643
"1493","Contra Costa County",1997-08-01,729,135,689,63,1616
"1494","Contra Costa County",1997-09-01,788,146,615,73,1622
"1495","Contra Costa County",1997-10-01,771,127,645,74,1617
"1496","Contra Costa County",1997-11-01,789,383,375,69,1616
"1497","Contra Costa County",1997-12-01,792,131,598,67,1588
"1498","Contra Costa County",1998-01-01,744,121,569,63,1497
"1499","Contra Costa County",1998-02-01,708,366,364,69,1507
"1500","Contra Costa County",1998-03-01,820,151,587,72,1630
"1501","Contra Costa County",1998-04-01,814,148,612,71,1645
"1502","Contra Costa County",1998-05-01,831,139,575,66,1611
"1503","Contra Costa County",1998-06-01,878,153,583,56,1670
"1504","Contra Costa County",1998-07-01,850,134,611,63,1658
"1505","Contra Costa County",1998-08-01,834,154,589,69,1646
"1506","Contra Costa County",1998-09-01,877,159,568,65,1669
"1507","Contra Costa County",1998-10-01,842,141,574,64,1621
"1508","Contra Costa County",1998-11-01,832,122,558,54,1566
"1509","Contra Costa County",1998-12-01,859,124,501,51,1535
"1510","Contra Costa County",1999-01-01,805,127,510,54,1496
"1511","Contra Costa County",1999-02-01,1034,130,257,43,1464
"1512","Contra Costa County",1999-03-01,1125,134,290,45,1594
"1513","Contra Costa County",1999-04-01,838,138,513,100,1589
"1514","Contra Costa County",1999-05-01,798,140,525,53,1516
"1515","Contra Costa County",1999-06-01,825,127,499,49,1500
"1516","Contra Costa County",1999-07-01,830,122,494,46,1492
"1517","Contra Costa County",1999-08-01,755,104,509,47,1415
"1518","Contra Costa County",1999-09-01,826,117,497,44,1484
"1519","Contra Costa County",1999-10-01,801,127,551,60,1539
"1520","Contra Costa County",1999-11-01,825,148,533,58,1564
"1521","Contra Costa County",1999-12-01,763,118,486,47,1414
"1522","Contra Costa County",2000-01-01,900,90,485,29,1504
"1523","Contra Costa County",2000-02-01,917,87,523,28,1555
"1524","Contra Costa County",2000-03-01,934,95,525,31,1585
"1525","Contra Costa County",2000-04-01,920,124,510,43,1597
"1526","Contra Costa County",2000-05-01,914,130,509,47,1600
"1527","Contra Costa County",2000-06-01,902,127,489,44,1562
"1528","Contra Costa County",2000-07-01,953,121,504,43,1621
"1529","Contra Costa County",2000-08-01,988,131,515,45,1679
"1530","Contra Costa County",2000-09-01,955,125,490,43,1613
"1531","Contra Costa County",2000-10-01,946,144,498,49,1637
"1532","Contra Costa County",2000-11-01,943,139,490,48,1620
"1533","Contra Costa County",2000-12-01,941,166,469,48,1624
"1534","Contra Costa County",2001-01-01,964,135,488,47,1634
"1535","Contra Costa County",2001-02-01,1010,147,519,51,1727
"1536","Contra Costa County",2001-03-01,1034,150,551,51,1786
"1537","Contra Costa County",2001-04-01,1029,151,562,52,1794
"1538","Contra Costa County",2001-05-01,1019,139,547,48,1753
"1539","Contra Costa County",2001-06-01,1008,138,530,47,1723
"1540","Contra Costa County",2001-07-01,1019,142,515,50,1726
"1541","Contra Costa County",2001-08-01,1037,142,511,50,1740
"1542","Contra Costa County",2001-09-01,1060,147,511,51,1769
"1543","Contra Costa County",2001-10-01,1065,139,502,48,1754
"1544","Contra Costa County",2001-11-01,1058,152,481,53,1744
"1545","Contra Costa County",2001-12-01,1021,145,462,51,1679
"1546","Contra Costa County",2002-01-01,1001,151,454,53,1659
"1547","Contra Costa County",2002-02-01,1064,173,471,60,1768
"1548","Contra Costa County",2002-03-01,1094,166,481,57,1798
"1549","Contra Costa County",2002-04-01,1092,153,497,52,1794
"1550","Contra Costa County",2002-05-01,1125,151,507,52,1835
"1551","Contra Costa County",2002-06-01,1108,155,478,54,1795
"1552","Contra Costa County",2002-07-01,1186,168,487,54,1895
"1553","Contra Costa County",2002-08-01,1045,149,426,47,1667
"1554","Contra Costa County",2002-09-01,1063,150,428,46,1687
"1555","Contra Costa County",2002-10-01,1002,140,438,48,1628
"1556","Contra Costa County",2002-11-01,966,149,412,50,1577
"1557","Contra Costa County",2002-12-01,950,144,427,50,1571
"1558","Contra Costa County",2003-01-01,867,141,474,60,1542
"1559","Contra Costa County",2003-02-01,903,145,492,60,1600
"1560","Contra Costa County",2003-03-01,928,146,511,62,1647
"1561","Contra Costa County",2003-04-01,918,138,502,57,1615
"1562","Contra Costa County",2003-05-01,884,113,536,44,1577
"1563","Contra Costa County",2003-06-01,836,148,535,63,1582
"1564","Contra Costa County",2003-07-01,841,138,539,61,1579
"1565","Contra Costa County",2003-08-01,865,119,523,54,1561
"1566","Contra Costa County",2003-09-01,838,126,504,60,1528
"1567","Contra Costa County",2003-10-01,849,120,510,59,1538
"1568","Contra Costa County",2003-11-01,796,118,524,58,1496
"1569","Contra Costa County",2003-12-01,840,137,468,51,1496
"1570","Contra Costa County",2004-01-01,895,127,481,47,1550
"1571","Contra Costa County",2004-02-01,938,128,536,50,1652
"1572","Contra Costa County",2004-03-01,960,142,542,55,1699
"1573","Contra Costa County",2004-04-01,930,147,549,63,1689
"1574","Contra Costa County",2004-05-01,912,142,551,65,1670
"1575","Contra Costa County",2004-06-01,915,140,547,63,1665
"1576","Contra Costa County",2004-07-01,931,139,547,56,1673
"1577","Contra Costa County",2004-08-01,949,159,496,51,1655
"1578","Contra Costa County",2004-09-01,979,166,514,52,1711
"1579","Contra Costa County",2004-10-01,921,161,501,53,1636
"1580","Contra Costa County",2004-11-01,927,165,475,46,1613
"1581","Contra Costa County",2004-12-01,890,154,468,44,1556
"1582","Contra Costa County",2005-01-01,895,158,453,46,1552
"1583","Contra Costa County",2005-02-01,934,147,468,45,1594
"1584","Contra Costa County",2005-03-01,943,137,490,41,1611
"1585","Contra Costa County",2005-04-01,953,135,530,46,1664
"1586","Contra Costa County",2005-05-01,937,129,541,48,1655
"1587","Contra Costa County",2005-06-01,943,139,538,49,1669
"1588","Contra Costa County",2005-07-01,973,137,556,49,1715
"1589","Contra Costa County",2005-08-01,956,138,560,49,1703
"1590","Contra Costa County",2005-09-01,945,137,579,49,1710
"1591","Contra Costa County",2005-10-01,957,150,564,49,1720
"1592","Contra Costa County",2005-11-01,969,153,531,46,1699
"1593","Contra Costa County",2005-12-01,916,140,526,45,1627
"1594","Contra Costa County",2006-01-01,881,140,550,55,1626
"1595","Contra Costa County",2006-02-01,859,149,540,53,1601
"1596","Contra Costa County",2006-03-01,839,147,545,61,1592
"1597","Contra Costa County",2006-04-01,903,152,548,57,1660
"1598","Contra Costa County",2006-05-01,879,147,559,57,1642
"1599","Contra Costa County",2006-06-01,867,143,552,55,1617
"1600","Contra Costa County",2006-07-01,903,146,557,52,1658
"1601","Contra Costa County",2006-08-01,911,146,552,52,1661
"1602","Contra Costa County",2006-09-01,920,144,572,54,1690
"1603","Contra Costa County",2006-10-01,921,154,574,59,1708
"1604","Contra Costa County",2006-11-01,902,150,554,57,1663
"1605","Contra Costa County",2006-12-01,882,148,484,44,1558
"1606","Contra Costa County",2007-01-01,878,130,532,47,1587
"1607","Contra Costa County",2007-02-01,895,133,537,47,1612
"1608","Contra Costa County",2007-03-01,906,131,520,43,1600
"1609","Contra Costa County",2007-04-01,951,137,481,43,1612
"1610","Contra Costa County",2007-05-01,928,129,525,64,1646
"1611","Contra Costa County",2007-06-01,933,117,518,40,1608
"1612","Contra Costa County",2007-07-01,963,129,486,40,1618
"1613","Contra Costa County",2007-08-01,970,142,460,38,1610
"1614","Contra Costa County",2007-09-01,973,143,463,39,1618
"1615","Contra Costa County",2007-10-01,966,151,451,45,1613
"1616","Contra Costa County",2007-11-01,988,155,475,44,1662
"1617","Contra Costa County",2007-12-01,938,139,464,41,1582
"1618","Contra Costa County",2008-01-01,918,133,470,43,1564
"1619","Contra Costa County",2008-02-01,895,123,454,42,1514
"1620","Contra Costa County",2008-03-01,871,126,421,38,1456
"1621","Contra Costa County",2008-04-01,877,117,417,38,1449
"1622","Contra Costa County",2008-05-01,862,118,450,42,1472
"1623","Contra Costa County",2008-06-01,864,119,438,42,1463
"1624","Contra Costa County",2008-07-01,972,112,367,41,1492
"1625","Contra Costa County",2008-08-01,876,106,411,44,1437
"1626","Contra Costa County",2008-09-01,841,96,431,73,1441
"1627","Contra Costa County",2008-10-01,1091,194,155,13,1453
"1628","Contra Costa County",2008-11-01,1079,129,355,54,1617
"1629","Contra Costa County",2008-12-01,1192,206,164,14,1576
"1630","Contra Costa County",2009-01-01,1217,212,179,15,1623
"1631","Contra Costa County",2009-02-01,1240,218,190,15,1663
"1632","Contra Costa County",2009-03-01,1111,138,297,41,1587
"1633","Contra Costa County",2009-04-01,1179,205,170,14,1568
"1634","Contra Costa County",2009-05-01,1008,156,341,65,1570
"1635","Contra Costa County",2009-06-01,1192,214,170,15,1591
"1636","Contra Costa County",2009-07-01,1174,208,167,15,1564
"1637","Contra Costa County",2009-08-01,1177,202,175,14,1568
"1638","Contra Costa County",2009-09-01,1176,206,175,14,1571
"1639","Contra Costa County",2009-10-01,1126,199,193,14,1532
"1640","Contra Costa County",2009-11-01,1098,206,187,14,1505
"1641","Contra Costa County",2009-12-01,964,160,277,49,1450
"1642","Contra Costa County",2010-01-01,961,158,276,49,1444
"1643","Contra Costa County",2010-02-01,1064,147,166,38,1415
"1644","Contra Costa County",2010-03-01,918,148,258,51,1375
"1645","Contra Costa County",2010-04-01,1033,156,268,43,1500
"1646","Contra Costa County",2010-05-01,1013,151,290,41,1495
"1647","Contra Costa County",2010-06-01,1091,166,272,43,1572
"1648","Contra Costa County",2010-07-01,1109,170,246,34,1559
"1649","Contra Costa County",2010-08-01,1162,181,219,29,1591
"1650","Contra Costa County",2010-09-01,1238,183,230,28,1679
"1651","Contra Costa County",2010-10-01,1202,174,216,24,1616
"1652","Contra Costa County",2010-11-01,1213,177,219,23,1632
"1653","Contra Costa County",2010-12-01,1186,180,189,22,1577
"1654","Contra Costa County",2011-01-01,1175,156,220,20,1571
"1655","Contra Costa County",2011-02-01,1158,149,228,24,1559
"1656","Contra Costa County",2011-03-01,1101,156,221,22,1500
"1657","Contra Costa County",2011-04-01,1080,149,209,23,1461
"1658","Contra Costa County",2011-05-01,1087,147,216,19,1469
"1659","Contra Costa County",2011-06-01,1115,131,190,18,1454
"1660","Contra Costa County",2011-07-01,1115,129,202,21,1467
"1661","Contra Costa County",2011-08-01,1103,121,179,18,1421
"1662","Contra Costa County",2011-09-01,1102,124,190,17,1433
"1663","Contra Costa County",2011-10-01,1138,120,196,22,1476
"1664","Contra Costa County",2011-11-01,1104,126,253,25,1508
"1665","Contra Costa County",2011-12-01,823,134,365,29,1351
"1666","Contra Costa County",2012-01-01,890,136,412,32,1470
"1667","Contra Costa County",2012-02-01,1001,139,348,25,1513
"1668","Contra Costa County",2012-03-01,991,142,342,21,1496
"1669","Contra Costa County",2012-04-01,1047,144,365,25,1581
"1670","Contra Costa County",2012-05-01,1042,146,401,28,1617
"1671","Contra Costa County",2012-06-01,1021,150,408,26,1605
"1672","Contra Costa County",2012-07-01,1020,146,408,22,1596
"1673","Contra Costa County",2012-08-01,1039,145,391,21,1596
"1674","Contra Costa County",2012-09-01,1055,141,417,15,1628
"1675","Contra Costa County",2012-10-01,1050,149,412,25,1636
"1676","Contra Costa County",2012-11-01,1051,142,414,20,1627
"1677","Contra Costa County",2012-12-01,990,150,290,21,1451
"1678","Contra Costa County",2013-01-01,995,139,314,14,1462
"1679","Contra Costa County",2013-02-01,979,131,307,10,1427
"1680","Contra Costa County",2013-03-01,1041,127,307,15,1490
"1681","Contra Costa County",2013-04-01,1003,134,302,14,1453
"1682","Contra Costa County",2013-05-01,1001,134,326,18,1479
"1683","Contra Costa County",2013-06-01,988,155,291,29,1463
"1684","Contra Costa County",2013-07-01,993,157,313,30,1493
"1685","Contra Costa County",2013-08-01,1020,153,336,24,1533
"1686","Contra Costa County",2013-09-01,1027,151,372,22,1572
"1687","Contra Costa County",2013-10-01,1034,183,368,25,1610
"1688","Contra Costa County",2013-11-01,1057,162,353,15,1587
"1689","Contra Costa County",2013-12-01,1066,135,312,22,1535
"1690","Contra Costa County",2014-01-01,1068,132,312,21,1533
"1691","Contra Costa County",2014-02-01,1065,129,314,15,1523
"1692","Contra Costa County",2014-03-01,1051,124,378,19,1572
"1693","Contra Costa County",2014-04-01,1062,144,388,40,1634
"1694","Contra Costa County",2014-05-01,977,98,472,108,1655
"1695","Contra Costa County",2014-06-01,999,101,489,105,1694
"1696","Contra Costa County",2014-07-01,990,100,495,106,1691
"1697","Contra Costa County",2014-08-01,913,101,484,112,1610
"1698","Contra Costa County",2014-09-01,906,106,527,117,1656
"1699","Contra Costa County",2014-10-01,889,125,472,67,1553
"1700","Contra Costa County",2014-11-01,797,106,454,43,1400
"1701","Contra Costa County",2014-12-01,731,93,380,45,1249
"1702","Contra Costa County",2015-01-01,835,133,276,11,1255
"1703","Contra Costa County",2015-02-01,874,119,277,10,1280
"1704","Contra Costa County",2015-03-01,883,140,305,30,1358
"1705","Contra Costa County",2015-04-01,883,138,311,16,1348
"1706","Contra Costa County",2015-05-01,889,110,319,35,1353
"1707","Contra Costa County",2015-06-01,967,141,299,42,1449
"1708","Contra Costa County",2015-07-01,890,167,299,52,1408
"1709","Contra Costa County",2015-08-01,896,142,297,51,1386
"1710","Contra Costa County",2015-09-01,946,122,335,45,1448
"1711","Contra Costa County",2015-10-01,1000,114,290,43,1447
"1712","Contra Costa County",2015-11-01,964,170,255,36,1425
"1713","Contra Costa County",2015-12-01,871,160,291,38,1360
"1714","Contra Costa County",2016-01-01,855,138,343,42,1378
"1715","Contra Costa County",2016-02-01,1037,143,257,33,1470
"1716","Contra Costa County",2016-03-01,899,178,264,38,1379
"1717","Contra Costa County",2016-04-01,950,181,214,52,1397
"1718","Contra Costa County",2016-05-01,957,170,230,39,1396
"1719","Contra Costa County",2016-06-01,1011,145,200,34,1390
"1720","Contra Costa County",2016-07-01,911,189,228,46,1374
"1721","Contra Costa County",2016-08-01,923,188,254,35,1400
"1722","Contra Costa County",2016-09-01,969,184,280,34,1467
"1723","Contra Costa County",2016-10-01,1043,173,245,37,1498
"1724","Contra Costa County",2016-11-01,1011,172,248,53,1484
"1725","Contra Costa County",2016-12-01,977,204,249,49,1479
"1726","Contra Costa County",2017-01-01,991,185,265,57,1498
"1727","Contra Costa County",2017-02-01,1042,151,286,41,1520
"1728","Contra Costa County",2017-03-01,993,188,297,45,1523
"1729","Contra Costa County",2017-04-01,1061,152,275,72,1560
"1730","Contra Costa County",2017-05-01,922,205,329,86,1542
"1731","Contra Costa County",2017-06-01,1028,185,268,83,1564
"1732","Contra Costa County",2017-07-01,922,217,266,76,1481
"1733","Contra Costa County",2017-08-01,937,128,311,77,1453
"1734","Contra Costa County",2017-09-01,909,194,315,60,1478
"1735","Contra Costa County",2017-10-01,934,190,305,77,1506
"1736","Contra Costa County",2017-11-01,947,204,282,66,1499
"1737","Contra Costa County",2017-12-01,964,134,269,68,1435
"1738","Contra Costa County",2018-01-01,894,189,265,68,1416
"1739","Contra Costa County",2018-02-01,940,146,260,68,1414
"1740","Contra Costa County",2018-03-01,929,162,285,42,1418
"1741","Contra Costa County",2018-04-01,900,168,306,54,1428
"1742","Contra Costa County",2018-05-01,956,163,290,70,1479
"1743","Contra Costa County",2018-06-01,996,110,284,66,1456
"1744","Contra Costa County",2018-07-01,956,108,295,63,1422
"1745","Contra Costa County",2018-08-01,828,147,335,39,1349
"1746","Contra Costa County",2018-09-01,823,109,298,49,1279
"1747","Contra Costa County",2018-10-01,772,116,324,50,1262
"1748","Contra Costa County",2018-11-01,846,145,252,41,1284
"1749","Contra Costa County",2018-12-01,803,148,257,41,1249
"1750","Contra Costa County",2019-01-01,791,125,305,49,1270
"1751","Contra Costa County",2019-02-01,822,121,332,36,1311
"1752","Contra Costa County",2019-03-01,829,101,313,45,1288
"1753","Contra Costa County",2019-04-01,836,111,309,36,1292
"1754","Contra Costa County",2019-05-01,847,89,217,60,1213
"1755","Contra Costa County",2019-06-01,724,103,296,40,1163
"1756","Contra Costa County",2019-07-01,755,127,246,18,1146
"1757","Contra Costa County",2019-08-01,704,138,250,31,1123
"1758","Contra Costa County",2019-09-01,715,192,217,31,1155
"1759","Contra Costa County",2019-10-01,709,154,235,33,1131
"1760","Contra Costa County",2019-11-01,787,153,238,32,1210
"1761","Contra Costa County",2019-12-01,717,136,215,27,1095
"1762","Contra Costa County",2020-01-01,721,129,222,31,1103
"1763","Contra Costa County",2020-02-01,804,120,134,35,1093
"1764","Contra Costa County",2020-03-01,806,71,117,14,1008
"1765","Del Norte County",1995-10-01,65.83,7.22,0,0,73.05
"1766","Del Norte County",1995-11-01,65.57,9.43,0,0,75
"1767","Del Norte County",1995-12-01,77,0,0,0,77
"1768","Del Norte County",1996-01-01,40,8,27,5,80
"1769","Del Norte County",1996-02-01,44,10,30,7,91
"1770","Del Norte County",1996-03-01,42,9,28,6,85
"1771","Del Norte County",1996-04-01,69.13,16.87,0,0,86
"1772","Del Norte County",1996-05-01,76.26,16.74,0,0,93
"1773","Del Norte County",1996-06-01,71.44,11.56,0,0,83
"1774","Del Norte County",1996-07-01,84.7,15.3,0,0,100
"1775","Del Norte County",1996-08-01,76.94,19.06,0,0,96
"1776","Del Norte County",1996-09-01,85.38,18.62,0,0,104
"1777","Del Norte County",1996-10-01,79.55,22.45,0,0,102
"1778","Del Norte County",1996-11-01,77.13,15.87,0,0,93
"1779","Del Norte County",1996-12-01,63.24,20.76,0,0,84
"1780","Del Norte County",1997-01-01,20,4,56,8,88
"1781","Del Norte County",1997-02-01,22,8,61,9,100
"1782","Del Norte County",1997-03-01,32,5,57,7,101
"1783","Del Norte County",1997-04-01,20,7,60,10,97
"1784","Del Norte County",1997-05-01,18,9,60,10,97
"1785","Del Norte County",1997-06-01,32,8,41,7,88
"1786","Del Norte County",1997-07-01,57.6,11.48,24.7,4.92,98.7
"1787","Del Norte County",1997-08-01,62.58,12.74,26.82,5.46,107.6
"1788","Del Norte County",1997-09-01,55.23,12.18,23.67,5.22,96.3
"1789","Del Norte County",1997-10-01,64.82,11.41,27.78,4.89,108.9
"1790","Del Norte County",1997-11-01,74.06,8.26,31.74,3.54,117.6
"1791","Del Norte County",1997-12-01,67.08,10.17,28.74,4.36,110.35
"1792","Del Norte County",1998-01-01,74.42,8.78,31.9,3.76,118.86
"1793","Del Norte County",1998-02-01,74.74,8,32.03,3.42,118.19
"1794","Del Norte County",1998-03-01,69.47,11.08,29.77,4.75,115.07
"1795","Del Norte County",1998-04-01,70.91,8.47,30.39,3.63,113.4
"1796","Del Norte County",1998-05-01,70.65,6.82,30.27,2.92,110.66
"1797","Del Norte County",1998-06-01,56.74,9.45,30.55,3.15,99.89
"1798","Del Norte County",1998-07-01,51.32,8.08,27.63,4.32,91.35
"1799","Del Norte County",1998-08-01,50.61,8,29.72,4.34,92.67
"1800","Del Norte County",1998-09-01,43.5,8,41,2,94.5
"1801","Del Norte County",1998-10-01,47.71,4.24,47.71,6.36,106.02
"1802","Del Norte County",1998-11-01,45.36,2.3,37.74,6.43,91.83
"1803","Del Norte County",1998-12-01,44.06,4.7,39.09,5.6,93.45
"1804","Del Norte County",1999-01-01,47.78,7.11,41.69,5.09,101.67
"1805","Del Norte County",1999-02-01,31,4,28,11,74
"1806","Del Norte County",1999-03-01,41,11,25,8,85
"1807","Del Norte County",1999-04-01,54.52,10.32,27.26,5.16,97.26
"1808","Del Norte County",1999-05-01,25.98,4.73,51.96,9.44,92.11
"1809","Del Norte County",1999-06-01,67.98,7.68,33.99,3.84,113.49
"1810","Del Norte County",1999-07-01,66.62,8.89,33.31,4.99,113.81
"1811","Del Norte County",1999-08-01,50.13,8.45,29.42,6.3,94.3
"1812","Del Norte County",1999-09-01,46.71,8.91,31.14,5.94,92.7
"1813","Del Norte County",1999-10-01,60.42,10.11,40.78,6.74,118.05
"1814","Del Norte County",1999-11-01,61.68,8.37,30.87,5.58,106.5
"1815","Del Norte County",1999-12-01,53.34,6.63,35.56,4.42,99.95
"1816","Del Norte County",2000-01-01,63.54,8.28,42.36,5.52,119.7
"1817","Del Norte County",2000-02-01,58.8,9.6,39.2,6.4,114
"1818","Del Norte County",2000-03-01,58,8,36,6,108
"1819","Del Norte County",2000-04-01,56.4,5.6,37.6,8.4,108
"1820","Del Norte County",2000-05-01,55.95,8.07,37.3,8.07,109.39
"1821","Del Norte County",2000-06-01,60.57,7.7,40.38,11.55,120.2
"1822","Del Norte County",2000-07-01,66.72,7.12,44.48,10.68,129
"1823","Del Norte County",2000-08-01,74.14,7.12,37.07,10.67,129
"1824","Del Norte County",2000-09-01,66.84,6.08,44.49,9.2,126.61
"1825","Del Norte County",2000-10-01,66,6,44,10,126
"1826","Del Norte County",2000-11-01,65,8,43,9,125
"1827","Del Norte County",2000-12-01,56,8,38,8,110
"1828","Del Norte County",2001-01-01,56,8,36,7,107
"1829","Del Norte County",2001-02-01,56,8,39,8,111
"1830","Del Norte County",2001-03-01,59,11,40,7,117
"1831","Del Norte County",2001-04-01,67,10,45,7,129
"1832","Del Norte County",2001-05-01,71,6,35,9,121
"1833","Del Norte County",2001-06-01,70,9,35,6,120
"1834","Del Norte County",2001-07-01,58,8,37,4,107
"1835","Del Norte County",2001-08-01,59,10,38,7,114
"1836","Del Norte County",2001-09-01,47,7,53,10,117
"1837","Del Norte County",2001-10-01,57,11,43,9,120
"1838","Del Norte County",2001-11-01,55,11,45,6,117
"1839","Del Norte County",2001-12-01,48,10,40,7,105
"1840","Del Norte County",2002-01-01,59,10,43,7,119
"1841","Del Norte County",2002-02-01,62,9,47,12,130
"1842","Del Norte County",2002-03-01,72,11,48,8,139
"1843","Del Norte County",2002-04-01,90,9,17,6,122
"1844","Del Norte County",2002-05-01,53,13,18,7,91
"1845","Del Norte County",2002-06-01,54,14,34,7,109
"1846","Del Norte County",2002-07-01,63,14,19,7,103
"1847","Del Norte County",2002-08-01,50,18,19,7,94
"1848","Del Norte County",2002-09-01,61,24,14,9,108
"1849","Del Norte County",2002-10-01,57,12,44,6,119
"1850","Del Norte County",2002-11-01,56,16,38,4,114
"1851","Del Norte County",2002-12-01,70,15,19,8,112
"1852","Del Norte County",2003-01-01,84,8,21,10,123
"1853","Del Norte County",2003-02-01,45,5,49,16,115
"1854","Del Norte County",2003-03-01,38,19,49,26,132
"1855","Del Norte County",2003-04-01,44,4,56,16,120
"1856","Del Norte County",2003-05-01,44,11,51,19,125
"1857","Del Norte County",2003-06-01,49,9,47,16,121
"1858","Del Norte County",2003-07-01,47,7,44,12,110
"1859","Del Norte County",2003-08-01,53,8,41,16,118
"1860","Del Norte County",2003-09-01,36,20,42,30,128
"1861","Del Norte County",2003-10-01,23,15,45,29,112
"1862","Del Norte County",2003-11-01,40,2,31,15,88
"1863","Del Norte County",2003-12-01,45,6,28,19,98
"1864","Del Norte County",2004-01-01,19,4,78,16,117
"1865","Del Norte County",2004-02-01,28,4,58,12,102
"1866","Del Norte County",2004-03-01,48,12,11,28,99
"1867","Del Norte County",2004-04-01,44,4,64,17,129
"1868","Del Norte County",2004-05-01,38,6,64,12,120
"1869","Del Norte County",2004-06-01,40,5,58,11,114
"1870","Del Norte County",2004-07-01,41,3,52,10,106
"1871","Del Norte County",2004-08-01,37,10,63,9,119
"1872","Del Norte County",2004-09-01,35,13,62,12,122
"1873","Del Norte County",2004-10-01,49,10,63,19,141
"1874","Del Norte County",2004-11-01,45,10,59,12,126
"1875","Del Norte County",2004-12-01,46,9,71,5,131
"1876","Del Norte County",2005-01-01,39,14,78,13,144
"1877","Del Norte County",2005-02-01,31,9,87,13,140
"1878","Del Norte County",2005-03-01,60,9,59,13,141
"1879","Del Norte County",2005-04-01,67,7,64,14,152
"1880","Del Norte County",2005-05-01,50,7,58,13,128
"1881","Del Norte County",2005-06-01,63,12,47,13,135
"1882","Del Norte County",2005-07-01,51,9,49,11,120
"1883","Del Norte County",2005-08-01,57,9,42,9,117
"1884","Del Norte County",2005-09-01,59,11,38,7,115
"1885","Del Norte County",2005-10-01,62,9,36,13,120
"1886","Del Norte County",2005-11-01,55,5,46,10,116
"1887","Del Norte County",2005-12-01,52,7,37,8,104
"1888","Del Norte County",2006-01-01,65,8,33,11,117
"1889","Del Norte County",2006-02-01,65,8,46,12,131
"1890","Del Norte County",2006-03-01,72,14,42,9,137
"1891","Del Norte County",2006-04-01,63,10,36,13,122
"1892","Del Norte County",2006-05-01,49,7,58,13,127
"1893","Del Norte County",2006-06-01,74,16,45,10,145
"1894","Del Norte County",2006-07-01,61,8,41,19,129
"1895","Del Norte County",2006-08-01,62,7,36,17,122
"1896","Del Norte County",2006-09-01,61,8,41,19,129
"1897","Del Norte County",2006-10-01,63,8,45,14,130
"1898","Del Norte County",2006-11-01,59,9,47,12,127
"1899","Del Norte County",2006-12-01,57,10,50,12,129
"1900","Del Norte County",2007-01-01,64,10,55,11,140
"1901","Del Norte County",2007-02-01,66,12,51,13,142
"1902","Del Norte County",2007-03-01,73,11,49,12,145
"1903","Del Norte County",2007-04-01,68,13,47,11,139
"1904","Del Norte County",2007-05-01,67,14,41,10,132
"1905","Del Norte County",2007-06-01,61,12,45,17,135
"1906","Del Norte County",2007-07-01,64,9,43,17,133
"1907","Del Norte County",2007-08-01,78,8,43,16,145
"1908","Del Norte County",2007-09-01,74,6,39,12,131
"1909","Del Norte County",2007-10-01,70,8,42,11,131
"1910","Del Norte County",2007-11-01,79,6,45,14,144
"1911","Del Norte County",2007-12-01,74,8,44,16,142
"1912","Del Norte County",2008-01-01,71,14,47,14,146
"1913","Del Norte County",2008-02-01,65,11,48,14,138
"1914","Del Norte County",2008-03-01,57,10,49,12,128
"1915","Del Norte County",2008-04-01,66,9,50,14,139
"1916","Del Norte County",2008-05-01,70,10,48,15,143
"1917","Del Norte County",2008-06-01,76,11,42,14,143
"1918","Del Norte County",2008-07-01,77,10,40,13,140
"1919","Del Norte County",2008-08-01,74,7,41,15,137
"1920","Del Norte County",2008-09-01,74,8,45,17,144
"1921","Del Norte County",2008-10-01,78,9,47,13,147
"1922","Del Norte County",2008-11-01,73,11,42,9,135
"1923","Del Norte County",2008-12-01,85,10,34,9,138
"1924","Del Norte County",2009-01-01,79,11,38,12,140
"1925","Del Norte County",2009-02-01,79,12,35,14,140
"1926","Del Norte County",2009-03-01,67,11,52,13,143
"1927","Del Norte County",2009-04-01,56,10,57,16,139
"1928","Del Norte County",2009-05-01,70,10,48,15,143
"1929","Del Norte County",2009-06-01,66,12,36,11,125
"1930","Del Norte County",2009-07-01,77,10,40,13,140
"1931","Del Norte County",2009-08-01,71,8,33,9,121
"1932","Del Norte County",2009-09-01,70,8,36,8,122
"1933","Del Norte County",2009-10-01,68,8,30,9,115
"1934","Del Norte County",2009-11-01,58,9,32,13,112
"1935","Del Norte County",2009-12-01,58,8,36,13,115
"1936","Del Norte County",2010-01-01,59,7,34,10,110
"1937","Del Norte County",2010-02-01,67,8,28,11,114
"1938","Del Norte County",2010-03-01,71,9,28,8,116
"1939","Del Norte County",2010-04-01,76,7,25,6,114
"1940","Del Norte County",2010-05-01,76,7,31,5,119
"1941","Del Norte County",2010-06-01,75,8,28,8,119
"1942","Del Norte County",2010-07-01,75,7,28,10,120
"1943","Del Norte County",2010-08-01,70,7,29,13,119
"1944","Del Norte County",2010-09-01,60,7,29,12,108
"1945","Del Norte County",2010-10-01,68,8,28,13,117
"1946","Del Norte County",2010-11-01,71,8,23,12,114
"1947","Del Norte County",2010-12-01,58,8,23,14,103
"1948","Del Norte County",2011-01-01,66,6,29,15,116
"1949","Del Norte County",2011-02-01,71,7,33,9,120
"1950","Del Norte County",2011-03-01,66,5,35,9,115
"1951","Del Norte County",2011-04-01,62,4,39,10,115
"1952","Del Norte County",2011-05-01,68,8,35,7,118
"1953","Del Norte County",2011-06-01,59,5,34,9,107
"1954","Del Norte County",2011-07-01,58,2,36,13,109
"1955","Del Norte County",2011-08-01,55,4,28,11,98
"1956","Del Norte County",2011-09-01,68,5,31,11,115
"1957","Del Norte County",2011-10-01,62,7,35,7,111
"1958","Del Norte County",2011-11-01,55,8,37,7,107
"1959","Del Norte County",2011-12-01,47,10,37,8,102
"1960","Del Norte County",2012-01-01,46,8,41,10,105
"1961","Del Norte County",2012-02-01,50,7,38,4,99
"1962","Del Norte County",2012-03-01,51,8,33,6,98
"1963","Del Norte County",2012-04-01,45,6,41,5,97
"1964","Del Norte County",2012-05-01,45,5,31,5,86
"1965","Del Norte County",2012-06-01,38,3,39,6,86
"1966","Del Norte County",2012-07-01,37,4,32,7,80
"1967","Del Norte County",2012-08-01,37,7,33,8,85
"1968","Del Norte County",2012-09-01,39,6,29,5,79
"1969","Del Norte County",2012-10-01,40,10,33,9,92
"1970","Del Norte County",2012-11-01,41,4,37,13,95
"1971","Del Norte County",2012-12-01,43,5,32,12,92
"1972","Del Norte County",2013-01-01,41,6,32,16,95
"1973","Del Norte County",2013-02-01,43,7,31,12,93
"1974","Del Norte County",2013-03-01,45,10,30,8,93
"1975","Del Norte County",2013-04-01,36,8,37,7,88
"1976","Del Norte County",2013-05-01,32,7,40,13,92
"1977","Del Norte County",2013-06-01,36,9,37,14,96
"1978","Del Norte County",2013-07-01,41,8,31,11,91
"1979","Del Norte County",2013-08-01,36,9,35,10,90
"1980","Del Norte County",2013-09-01,32,7,35,13,87
"1981","Del Norte County",2013-10-01,33,6,27,15,81
"1982","Del Norte County",2013-11-01,29,7,30,17,83
"1983","Del Norte County",2013-12-01,31,7,30,13,81
"1984","Del Norte County",2014-01-01,40,6,38,11,95
"1985","Del Norte County",2014-02-01,38,7,38,11,94
"1986","Del Norte County",2014-03-01,42,7,33,12,94
"1987","Del Norte County",2014-04-01,39,7,37,12,95
"1988","Del Norte County",2014-05-01,40,6,44,11,101
"1989","Del Norte County",2014-06-01,36,5,46,12,99
"1990","Del Norte County",2014-07-01,39,5,44,13,101
"1991","Del Norte County",2014-08-01,44,6,41,12,103
"1992","Del Norte County",2014-09-01,44,7,32,12,95
"1993","Del Norte County",2014-10-01,41,7,32,14,94
"1994","Del Norte County",2014-11-01,44,5,36,14,99
"1995","Del Norte County",2014-12-01,37,4,33,11,85
"1996","Del Norte County",2015-01-01,36,6,32,11,85
"1997","Del Norte County",2015-02-01,39,7,35,12,93
"1998","Del Norte County",2015-03-01,37,6,48,8,99
"1999","Del Norte County",2015-04-01,38,6,47,8,99
"2000","Del Norte County",2015-05-01,39,7,42,11,99
"2001","Del Norte County",2015-06-01,40,7,32,7,86
"2002","Del Norte County",2015-07-01,39,9,30,7,85
"2003","Del Norte County",2015-08-01,44,5,28,6,83
"2004","Del Norte County",2015-09-01,48,6,28,6,88
"2005","Del Norte County",2015-10-01,40,7,31,7,85
"2006","Del Norte County",2015-11-01,37,9,37,9,92
"2007","Del Norte County",2015-12-01,49,11,35,7,102
"2008","Del Norte County",2016-01-01,42,8,42,10,102
"2009","Del Norte County",2016-02-01,38,10,46,9,103
"2010","Del Norte County",2016-03-01,39,12,44,11,106
"2011","Del Norte County",2016-04-01,34,12,51,10,107
"2012","Del Norte County",2016-05-01,27,10,55,15,107
"2013","Del Norte County",2016-06-01,36,13,46,12,107
"2014","Del Norte County",2016-07-01,34,10,53,11,108
"2015","Del Norte County",2016-08-01,33,7,54,12,106
"2016","Del Norte County",2016-09-01,36,10,50,10,106
"2017","Del Norte County",2016-10-01,46,14,39,8,107
"2018","Del Norte County",2016-11-01,44,13,39,7,103
"2019","Del Norte County",2016-12-01,40,11,30,9,90
"2020","Del Norte County",2017-01-01,37,12,38,10,97
"2021","Del Norte County",2017-02-01,48,12,35,8,103
"2022","Del Norte County",2017-03-01,56,14,32,7,109
"2023","Del Norte County",2017-04-01,59,12,31,10,112
"2024","Del Norte County",2017-05-01,60,16,28,10,114
"2025","Del Norte County",2017-06-01,50,10,36,12,108
"2026","Del Norte County",2017-07-01,50,11,35,13,109
"2027","Del Norte County",2017-08-01,52,9,34,13,108
"2028","Del Norte County",2017-09-01,50,4,36,18,108
"2029","Del Norte County",2017-10-01,55,5,33,14,107
"2030","Del Norte County",2017-11-01,52,7,32,13,104
"2031","Del Norte County",2017-12-01,53,7,27,11,98
"2032","Del Norte County",2018-01-01,54,10,25,7,96
"2033","Del Norte County",2018-02-01,53,11,24,5,93
"2034","Del Norte County",2018-03-01,54,12,30,4,100
"2035","Del Norte County",2018-04-01,46,9,33,6,94
"2036","Del Norte County",2018-05-01,45,7,31,10,93
"2037","Del Norte County",2018-06-01,45,7,26,10,88
"2038","Del Norte County",2018-07-01,41,7,26,13,87
"2039","Del Norte County",2018-08-01,45,9,26,8,88
"2040","Del Norte County",2018-09-01,46,12,32,7,97
"2041","Del Norte County",2018-10-01,42,13,35,11,101
"2042","Del Norte County",2018-11-01,44,11,32,9,96
"2043","Del Norte County",2018-12-01,45,10,33,7,95
"2044","Del Norte County",2019-01-01,47,12,37,7,103
"2045","Del Norte County",2019-02-01,53,12,29,3,97
"2046","Del Norte County",2019-03-01,47,11,33,4,95
"2047","Del Norte County",2019-04-01,41,11,29,5,86
"2048","Del Norte County",2019-05-01,44,14,29,9,96
"2049","Del Norte County",2019-06-01,54,14,31,9,108
"2050","Del Norte County",2019-07-01,61,13,33,10,117
"2051","Del Norte County",2019-08-01,52,11,39,9,111
"2052","Del Norte County",2019-09-01,61,12,34,7,114
"2053","Del Norte County",2019-10-01,62,10,36,8,116
"2054","Del Norte County",2019-11-01,52,8,40,9,109
"2055","Del Norte County",2019-12-01,50,12,35,7,104
"2056","Del Norte County",2020-01-01,48,11,38,9,106
"2057","Del Norte County",2020-02-01,53,12,37,8,110
"2058","Del Norte County",2020-03-01,49,11,25,3,88
"2059","El Dorado County",1995-10-01,101,19,152,20,292
"2060","El Dorado County",1995-11-01,90,11,163,22,286
"2061","El Dorado County",1995-12-01,76,7,159,16,258
"2062","El Dorado County",1996-01-01,78,12,160,21,271
"2063","El Dorado County",1996-02-01,88,10,156,20,274
"2064","El Dorado County",1996-03-01,75,6,156,16,253
"2065","El Dorado County",1996-04-01,66,6,161,16,249
"2066","El Dorado County",1996-05-01,73,9,162,14,258
"2067","El Dorado County",1996-06-01,72,9,174,12,267
"2068","El Dorado County",1996-07-01,63,6,219,16,304
"2069","El Dorado County",1996-08-01,60,6,215,17,298
"2070","El Dorado County",1996-09-01,62,7,217,17,303
"2071","El Dorado County",1996-10-01,59,8,217,18,302
"2072","El Dorado County",1996-11-01,69,4,216,20,309
"2073","El Dorado County",1996-12-01,64,5,203,17,289
"2074","El Dorado County",1997-01-01,52,9,217,19,297
"2075","El Dorado County",1997-02-01,66,5,208,23,302
"2076","El Dorado County",1997-03-01,74,11,203,30,318
"2077","El Dorado County",1997-04-01,92,6,195,22,315
"2078","El Dorado County",1997-05-01,96,14,192,21,323
"2079","El Dorado County",1997-06-01,81,17,193,20,311
"2080","El Dorado County",1997-07-01,112,13,175,24,324
"2081","El Dorado County",1997-08-01,111,14,169,27,321
"2082","El Dorado County",1997-09-01,103,10,174,26,313
"2083","El Dorado County",1997-10-01,122,19,156,19,316
"2084","El Dorado County",1997-11-01,108,10,170,24,312
"2085","El Dorado County",1997-12-01,114,14,162,23,313
"2086","El Dorado County",1998-01-01,127,16,153,21,317
"2087","El Dorado County",1998-02-01,120,18,168,22,328
"2088","El Dorado County",1998-03-01,134,13,161,20,328
"2089","El Dorado County",1998-04-01,128,14,165,19,326
"2090","El Dorado County",1998-05-01,132,18,141,21,312
"2091","El Dorado County",1998-06-01,130,18,160,21,329
"2092","El Dorado County",1998-07-01,124,18,169,17,328
"2093","El Dorado County",1998-08-01,125,14,168,25,332
"2094","El Dorado County",1998-09-01,127,16,162,24,329
"2095","El Dorado County",1998-10-01,106,10,183,22,321
"2096","El Dorado County",1998-11-01,111,14,172,23,320
"2097","El Dorado County",1998-12-01,117,17,166,18,318
"2098","El Dorado County",1999-01-01,102,15,140,21,278
"2099","El Dorado County",1999-02-01,104,19,152,13,288
"2100","El Dorado County",1999-03-01,116,9,156,19,300
"2101","El Dorado County",1999-04-01,120,16,159,17,312
"2102","El Dorado County",1999-05-01,125,13,161,27,326
"2103","El Dorado County",1999-06-01,117,9,161,26,313
"2104","El Dorado County",1999-07-01,121,13,142,24,300
"2105","El Dorado County",1999-08-01,141,14,132,18,305
"2106","El Dorado County",1999-09-01,141,19,125,21,306
"2107","El Dorado County",1999-10-01,143,12,142,23,320
"2108","El Dorado County",1999-11-01,110,19,146,19,294
"2109","El Dorado County",1999-12-01,99,20,137,23,279
"2110","El Dorado County",2000-01-01,125,19,116,18,278
"2111","El Dorado County",2000-02-01,106,10,134,19,269
"2112","El Dorado County",2000-03-01,102,15,117,17,251
"2113","El Dorado County",2000-04-01,106,13,113,21,253
"2114","El Dorado County",2000-05-01,111,18,110,17,256
"2115","El Dorado County",2000-06-01,101,14,119,25,259
"2116","El Dorado County",2000-07-01,103,11,126,27,267
"2117","El Dorado County",2000-08-01,106,8,133,31,278
"2118","El Dorado County",2000-09-01,118,18,146,21,303
"2119","El Dorado County",2000-10-01,105,20,145,22,292
"2120","El Dorado County",2000-11-01,99,18,128,20,265
"2121","El Dorado County",2000-12-01,104,11,112,17,244
"2122","El Dorado County",2001-01-01,96,16,131,13,256
"2123","El Dorado County",2001-02-01,97,12,132,9,250
"2124","El Dorado County",2001-03-01,107,14,115,13,249
"2125","El Dorado County",2001-04-01,94,12,120,24,250
"2126","El Dorado County",2001-05-01,104,9,108,30,251
"2127","El Dorado County",2001-06-01,101,17,112,21,251
"2128","El Dorado County",2001-07-01,115,15,103,20,253
"2129","El Dorado County",2001-08-01,110,14,110,23,257
"2130","El Dorado County",2001-09-01,126,12,100,21,259
"2131","El Dorado County",2001-10-01,113,16,109,16,254
"2132","El Dorado County",2001-11-01,106,21,96,16,239
"2133","El Dorado County",2001-12-01,114,19,86,20,239
"2134","El Dorado County",2002-01-01,104,17,105,21,247
"2135","El Dorado County",2002-02-01,136,20,95,26,277
"2136","El Dorado County",2002-03-01,133,15,102,21,271
"2137","El Dorado County",2002-04-01,126,14,102,20,262
"2138","El Dorado County",2002-05-01,120,19,114,23,276
"2139","El Dorado County",2002-06-01,123,20,130,20,293
"2140","El Dorado County",2002-07-01,143,10,125,24,302
"2141","El Dorado County",2002-08-01,131,15,138,18,302
"2142","El Dorado County",2002-09-01,118,20,133,31,302
"2143","El Dorado County",2002-10-01,135,15,139,28,317
"2144","El Dorado County",2002-11-01,147,21,140,22,330
"2145","El Dorado County",2002-12-01,144,9,141,17,311
"2146","El Dorado County",2003-01-01,132,21,132,16,301
"2147","El Dorado County",2003-02-01,125,14,142,23,304
"2148","El Dorado County",2003-03-01,122,11,140,17,290
"2149","El Dorado County",2003-04-01,125,16,127,19,287
"2150","El Dorado County",2003-05-01,135,19,124,19,297
"2151","El Dorado County",2003-06-01,134,17,134,17,302
"2152","El Dorado County",2003-07-01,146,15,131,24,316
"2153","El Dorado County",2003-08-01,144,20,140,20,324
"2154","El Dorado County",2003-09-01,143,20,151,16,330
"2155","El Dorado County",2003-10-01,147,27,135,15,324
"2156","El Dorado County",2003-11-01,141,21,138,18,318
"2157","El Dorado County",2003-12-01,137,22,145,18,322
"2158","El Dorado County",2004-01-01,151,14,149,21,335
"2159","El Dorado County",2004-02-01,145,16,150,23,334
"2160","El Dorado County",2004-03-01,150,17,145,23,335
"2161","El Dorado County",2004-04-01,148,13,139,24,324
"2162","El Dorado County",2004-05-01,136,18,140,24,318
"2163","El Dorado County",2004-06-01,121,15,142,27,305
"2164","El Dorado County",2004-07-01,124,16,142,24,306
"2165","El Dorado County",2004-08-01,135,17,139,23,314
"2166","El Dorado County",2004-09-01,126,27,137,18,308
"2167","El Dorado County",2004-10-01,137,19,142,26,324
"2168","El Dorado County",2004-11-01,149,24,136,19,328
"2169","El Dorado County",2004-12-01,155,17,129,28,329
"2170","El Dorado County",2005-01-01,163,25,122,22,332
"2171","El Dorado County",2005-02-01,145,23,147,25,340
"2172","El Dorado County",2005-03-01,165,26,131,21,343
"2173","El Dorado County",2005-04-01,138,23,152,26,339
"2174","El Dorado County",2005-05-01,138,26,144,26,334
"2175","El Dorado County",2005-06-01,128,23,142,43,336
"2176","El Dorado County",2005-07-01,126,20,153,31,330
"2177","El Dorado County",2005-08-01,137,22,142,38,339
"2178","El Dorado County",2005-09-01,146,16,128,30,320
"2179","El Dorado County",2005-10-01,145,22,124,36,327
"2180","El Dorado County",2005-11-01,155,33,146,34,368
"2181","El Dorado County",2005-12-01,148,25,139,42,354
"2182","El Dorado County",2006-01-01,158,18,133,40,349
"2183","El Dorado County",2006-02-01,146,12,167,37,362
"2184","El Dorado County",2006-03-01,164,15,152,30,361
"2185","El Dorado County",2006-04-01,166,18,153,28,365
"2186","El Dorado County",2006-05-01,171,20,135,25,351
"2187","El Dorado County",2006-06-01,184,21,144,21,370
"2188","El Dorado County",2006-07-01,187,26,130,25,368
"2189","El Dorado County",2006-08-01,182,31,136,20,369
"2190","El Dorado County",2006-09-01,176,24,146,31,377
"2191","El Dorado County",2006-10-01,168,27,141,28,364
"2192","El Dorado County",2006-11-01,198,24,115,29,366
"2193","El Dorado County",2006-12-01,181,19,138,21,359
"2194","El Dorado County",2007-01-01,170,23,135,19,347
"2195","El Dorado County",2007-02-01,178,23,138,19,358
"2196","El Dorado County",2007-03-01,177,25,148,22,372
"2197","El Dorado County",2007-04-01,165,27,151,22,365
"2198","El Dorado County",2007-05-01,153,23,144,27,347
"2199","El Dorado County",2007-06-01,159,25,133,26,343
"2200","El Dorado County",2007-07-01,141,23,157,27,348
"2201","El Dorado County",2007-08-01,153,20,145,31,349
"2202","El Dorado County",2007-09-01,152,17,153,31,353
"2203","El Dorado County",2007-10-01,155,26,139,18,338
"2204","El Dorado County",2007-11-01,160,26,125,22,333
"2205","El Dorado County",2007-12-01,157,22,129,24,332
"2206","El Dorado County",2008-01-01,159,23,125,21,328
"2207","El Dorado County",2008-02-01,142,21,135,21,319
"2208","El Dorado County",2008-03-01,143,22,132,22,319
"2209","El Dorado County",2008-04-01,154,18,142,24,338
"2210","El Dorado County",2008-05-01,169,16,153,23,361
"2211","El Dorado County",2008-06-01,153,16,157,19,345
"2212","El Dorado County",2008-07-01,169,21,125,25,340
"2213","El Dorado County",2008-08-01,167,27,141,23,358
"2214","El Dorado County",2008-09-01,186,28,141,14,369
"2215","El Dorado County",2008-10-01,155,27,149,27,358
"2216","El Dorado County",2008-11-01,152,27,154,23,356
"2217","El Dorado County",2008-12-01,156,19,140,24,339
"2218","El Dorado County",2009-01-01,146,22,131,27,326
"2219","El Dorado County",2009-02-01,165,25,139,26,355
"2220","El Dorado County",2009-03-01,153,25,148,34,360
"2221","El Dorado County",2009-04-01,153,23,148,27,351
"2222","El Dorado County",2009-05-01,166,33,135,29,363
"2223","El Dorado County",2009-06-01,170,27,130,31,358
"2224","El Dorado County",2009-07-01,127,37,153,31,348
"2225","El Dorado County",2009-08-01,152,25,148,27,352
"2226","El Dorado County",2009-09-01,176,29,144,27,376
"2227","El Dorado County",2009-10-01,171,26,149,28,374
"2228","El Dorado County",2009-11-01,180,19,152,26,377
"2229","El Dorado County",2009-12-01,171,29,138,23,361
"2230","El Dorado County",2010-01-01,162,36,130,27,355
"2231","El Dorado County",2010-02-01,156,24,140,31,351
"2232","El Dorado County",2010-03-01,143,24,133,24,324
"2233","El Dorado County",2010-04-01,144,28,136,25,333
"2234","El Dorado County",2010-05-01,152,24,142,28,346
"2235","El Dorado County",2010-06-01,164,21,132,27,344
"2236","El Dorado County",2010-07-01,164,27,124,23,338
"2237","El Dorado County",2010-08-01,159,18,136,28,341
"2238","El Dorado County",2010-09-01,141,25,153,24,343
"2239","El Dorado County",2010-10-01,161,21,127,28,337
"2240","El Dorado County",2010-11-01,156,20,114,26,316
"2241","El Dorado County",2010-12-01,129,20,125,26,300
"2242","El Dorado County",2011-01-01,130,30,120,24,304
"2243","El Dorado County",2011-02-01,130,23,124,25,302
"2244","El Dorado County",2011-03-01,133,33,107,30,303
"2245","El Dorado County",2011-04-01,134,18,112,24,288
"2246","El Dorado County",2011-05-01,153,32,110,20,315
"2247","El Dorado County",2011-06-01,166,38,107,22,333
"2248","El Dorado County",2011-07-01,155,38,116,21,330
"2249","El Dorado County",2011-08-01,161,32,109,20,322
"2250","El Dorado County",2011-09-01,161,30,122,33,346
"2251","El Dorado County",2011-10-01,148,26,122,33,329
"2252","El Dorado County",2011-11-01,137,23,148,27,335
"2253","El Dorado County",2011-12-01,127,13,156,28,324
"2254","El Dorado County",2012-01-01,148,21,163,24,356
"2255","El Dorado County",2012-02-01,141,25,164,29,359
"2256","El Dorado County",2012-03-01,132,21,151,34,338
"2257","El Dorado County",2012-04-01,148,23,144,28,343
"2258","El Dorado County",2012-05-01,159,28,141,26,354
"2259","El Dorado County",2012-06-01,161,26,132,24,343
"2260","El Dorado County",2012-07-01,139,20,139,31,329
"2261","El Dorado County",2012-08-01,148,27,138,30,343
"2262","El Dorado County",2012-09-01,163,20,147,30,360
"2263","El Dorado County",2012-10-01,164,27,162,29,382
"2264","El Dorado County",2012-11-01,161,40,158,29,388
"2265","El Dorado County",2012-12-01,160,21,161,32,374
"2266","El Dorado County",2013-01-01,165,25,154,37,381
"2267","El Dorado County",2013-02-01,137,20,171,42,370
"2268","El Dorado County",2013-03-01,173,27,151,33,384
"2269","El Dorado County",2013-04-01,168,26,150,36,380
"2270","El Dorado County",2013-05-01,165,30,149,35,379
"2271","El Dorado County",2013-06-01,171,32,144,33,380
"2272","El Dorado County",2013-07-01,179,36,129,36,380
"2273","El Dorado County",2013-08-01,161,33,130,31,355
"2274","El Dorado County",2013-09-01,165,33,133,32,363
"2275","El Dorado County",2013-10-01,160,27,132,27,346
"2276","El Dorado County",2013-11-01,159,30,138,24,351
"2277","El Dorado County",2013-12-01,169,27,122,29,347
"2278","El Dorado County",2014-01-01,160,38,130,28,356
"2279","El Dorado County",2014-02-01,169,35,128,34,366
"2280","El Dorado County",2014-03-01,165,36,135,37,373
"2281","El Dorado County",2014-04-01,160,36,138,37,371
"2282","El Dorado County",2014-05-01,164,36,145,40,385
"2283","El Dorado County",2014-06-01,178,41,146,40,405
"2284","El Dorado County",2014-07-01,180,41,153,38,412
"2285","El Dorado County",2014-08-01,176,39,165,38,418
"2286","El Dorado County",2014-09-01,176,36,164,42,418
"2287","El Dorado County",2014-10-01,179,28,167,46,420
"2288","El Dorado County",2014-11-01,166,29,157,39,391
"2289","El Dorado County",2014-12-01,153,29,149,35,366
"2290","El Dorado County",2015-01-01,158,28,140,35,361
"2291","El Dorado County",2015-02-01,175,29,127,36,367
"2292","El Dorado County",2015-03-01,169,28,137,35,369
"2293","El Dorado County",2015-04-01,172,36,140,30,378
"2294","El Dorado County",2015-05-01,177,34,142,29,382
"2295","El Dorado County",2015-06-01,160,34,153,27,374
"2296","El Dorado County",2015-07-01,173,33,156,33,395
"2297","El Dorado County",2015-08-01,183,34,146,38,401
"2298","El Dorado County",2015-09-01,178,32,159,36,405
"2299","El Dorado County",2015-10-01,175,35,160,35,405
"2300","El Dorado County",2015-11-01,172,33,154,33,392
"2301","El Dorado County",2015-12-01,176,35,150,32,393
"2302","El Dorado County",2016-01-01,176,35,158,30,399
"2303","El Dorado County",2016-02-01,179,28,160,31,398
"2304","El Dorado County",2016-03-01,174,30,151,28,383
"2305","El Dorado County",2016-04-01,159,33,153,27,372
"2306","El Dorado County",2016-05-01,172,30,135,23,360
"2307","El Dorado County",2016-06-01,191,35,130,24,380
"2308","El Dorado County",2016-07-01,184,35,139,28,386
"2309","El Dorado County",2016-08-01,184,35,154,33,406
"2310","El Dorado County",2016-09-01,192,29,147,32,400
"2311","El Dorado County",2016-10-01,182,29,153,32,396
"2312","El Dorado County",2016-11-01,176,26,145,38,385
"2313","El Dorado County",2016-12-01,165,31,144,35,375
"2314","El Dorado County",2017-01-01,166,34,135,38,373
"2315","El Dorado County",2017-02-01,151,33,137,40,361
"2316","El Dorado County",2017-03-01,153,32,154,34,373
"2317","El Dorado County",2017-04-01,155,29,175,41,400
"2318","El Dorado County",2017-05-01,170,31,169,41,411
"2319","El Dorado County",2017-06-01,177,34,167,40,418
"2320","El Dorado County",2017-07-01,173,29,180,40,422
"2321","El Dorado County",2017-08-01,173,32,182,35,422
"2322","El Dorado County",2017-09-01,170,30,166,35,401
"2323","El Dorado County",2017-10-01,168,28,168,37,401
"2324","El Dorado County",2017-11-01,174,31,162,36,403
"2325","El Dorado County",2017-12-01,163,33,165,35,396
"2326","El Dorado County",2018-01-01,168,31,152,39,390
"2327","El Dorado County",2018-02-01,167,30,150,38,385
"2328","El Dorado County",2018-03-01,176,29,140,36,381
"2329","El Dorado County",2018-04-01,176,27,142,38,383
"2330","El Dorado County",2018-05-01,178,28,146,38,390
"2331","El Dorado County",2018-06-01,172,25,146,42,385
"2332","El Dorado County",2018-07-01,173,28,158,47,406
"2333","El Dorado County",2018-08-01,176,26,157,46,405
"2334","El Dorado County",2018-09-01,179,29,153,41,402
"2335","El Dorado County",2018-10-01,177,25,138,45,385
"2336","El Dorado County",2018-11-01,173,22,134,40,369
"2337","El Dorado County",2018-12-01,167,19,136,39,361
"2338","El Dorado County",2019-01-01,181,24,133,34,372
"2339","El Dorado County",2019-02-01,180,26,135,33,374
"2340","El Dorado County",2019-03-01,197,25,133,41,396
"2341","El Dorado County",2019-04-01,191,22,150,40,403
"2342","El Dorado County",2019-05-01,192,24,143,41,400
"2343","El Dorado County",2019-06-01,191,26,138,33,388
"2344","El Dorado County",2019-07-01,193,31,127,31,382
"2345","El Dorado County",2019-08-01,197,34,117,33,381
"2346","El Dorado County",2019-09-01,194,30,124,38,386
"2347","El Dorado County",2019-10-01,182,34,135,43,394
"2348","El Dorado County",2019-11-01,193,33,120,41,387
"2349","El Dorado County",2019-12-01,196,32,119,36,383
"2350","El Dorado County",2020-01-01,192,33,121,36,382
"2351","El Dorado County",2020-02-01,198,29,126,40,393
"2352","El Dorado County",2020-03-01,184,28,114,34,360
"2353","Fresno County",1995-10-01,1423,155,431,72,2081
"2354","Fresno County",1995-11-01,1415,140,409,83,2047
"2355","Fresno County",1995-12-01,1424,155,350,66,1995
"2356","Fresno County",1996-01-01,1424,163,365,63,2015
"2357","Fresno County",1996-02-01,1446,171,378,57,2052
"2358","Fresno County",1996-03-01,1448,147,393,71,2059
"2359","Fresno County",1996-04-01,1416,141,435,75,2067
"2360","Fresno County",1996-05-01,1442,147,395,70,2054
"2361","Fresno County",1996-06-01,1464,158,377,66,2065
"2362","Fresno County",1996-07-01,1484,162,360,65,2071
"2363","Fresno County",1996-08-01,1464,176,351,58,2049
"2364","Fresno County",1996-09-01,1501,179,361,44,2085
"2365","Fresno County",1996-10-01,1507,188,411,48,2154
"2366","Fresno County",1996-11-01,1532,180,378,52,2142
"2367","Fresno County",1996-12-01,1528,178,368,47,2121
"2368","Fresno County",1997-01-01,1533,183,364,37,2117
"2369","Fresno County",1997-02-01,1555,160,355,69,2139
"2370","Fresno County",1997-03-01,1550,164,363,67,2144
"2371","Fresno County",1997-04-01,1561,171,385,65,2182
"2372","Fresno County",1997-05-01,1556,171,384,69,2180
"2373","Fresno County",1997-06-01,1517,173,419,62,2171
"2374","Fresno County",1997-07-01,1502,164,410,71,2147
"2375","Fresno County",1997-08-01,1486,181,417,54,2138
"2376","Fresno County",1997-09-01,1515,167,419,62,2163
"2377","Fresno County",1997-10-01,1533,169,404,53,2159
"2378","Fresno County",1997-11-01,1542,303,256,47,2148
"2379","Fresno County",1997-12-01,1478,162,408,57,2105
"2380","Fresno County",1998-01-01,1529,315,273,40,2157
"2381","Fresno County",1998-02-01,1559,197,386,41,2183
"2382","Fresno County",1998-03-01,1571,195,378,42,2186
"2383","Fresno County",1998-04-01,1553,186,395,50,2184
"2384","Fresno County",1998-05-01,1589,195,357,45,2186
"2385","Fresno County",1998-06-01,1593,297,238,40,2168
"2386","Fresno County",1998-07-01,1615,200,400,34,2249
"2387","Fresno County",1998-08-01,1541,177,443,57,2218
"2388","Fresno County",1998-09-01,1576,189,431,45,2241
"2389","Fresno County",1998-10-01,1577,189,435,50,2251
"2390","Fresno County",1998-11-01,1555,59,447,174,2235
"2391","Fresno County",1998-12-01,1531,171,458,61,2221
"2392","Fresno County",1999-01-01,1527,179,438,57,2201
"2393","Fresno County",1999-02-01,1547,192,456,46,2241
"2394","Fresno County",1999-03-01,1553,193,446,48,2240
"2395","Fresno County",1999-04-01,1579,191,426,49,2245
"2396","Fresno County",1999-05-01,1595,188,428,48,2259
"2397","Fresno County",1999-06-01,1576,189,442,47,2254
"2398","Fresno County",1999-07-01,1608,177,416,54,2255
"2399","Fresno County",1999-08-01,1618,183,407,56,2264
"2400","Fresno County",1999-09-01,1591,184,414,48,2237
"2401","Fresno County",1999-10-01,1602,190,404,48,2244
"2402","Fresno County",1999-11-01,1582,191,451,48,2272
"2403","Fresno County",1999-12-01,1529,169,436,49,2183
"2404","Fresno County",2000-01-01,1594,184,430,41,2249
"2405","Fresno County",2000-02-01,1607,181,433,51,2272
"2406","Fresno County",2000-03-01,1632,185,495,51,2363
"2407","Fresno County",2000-04-01,1612,168,528,67,2375
"2408","Fresno County",2000-05-01,1641,194,500,48,2383
"2409","Fresno County",2000-06-01,1625,166,535,71,2397
"2410","Fresno County",2000-07-01,1614,185,482,54,2335
"2411","Fresno County",2000-08-01,1538,181,493,54,2266
"2412","Fresno County",2000-09-01,1611,169,503,66,2349
"2413","Fresno County",2000-10-01,1636,181,498,54,2369
"2414","Fresno County",2000-11-01,1627,182,488,58,2355
"2415","Fresno County",2000-12-01,1583,179,469,57,2288
"2416","Fresno County",2001-01-01,1654,181,431,58,2324
"2417","Fresno County",2001-02-01,1685,250,350,62,2347
"2418","Fresno County",2001-03-01,1693,185,422,58,2358
"2419","Fresno County",2001-04-01,1726,186,409,55,2376
"2420","Fresno County",2001-05-01,1702,171,427,63,2363
"2421","Fresno County",2001-06-01,1699,169,414,61,2343
"2422","Fresno County",2001-07-01,1716,167,405,55,2343
"2423","Fresno County",2001-08-01,1710,179,378,52,2319
"2424","Fresno County",2001-09-01,1725,188,313,41,2267
"2425","Fresno County",2001-10-01,1680,164,313,45,2202
"2426","Fresno County",2001-11-01,1645,156,320,50,2171
"2427","Fresno County",2001-12-01,1608,165,293,39,2105
"2428","Fresno County",2002-01-01,1662,171,318,45,2196
"2429","Fresno County",2002-02-01,1680,170,349,44,2243
"2430","Fresno County",2002-03-01,1726,167,337,50,2280
"2431","Fresno County",2002-04-01,1674,173,320,49,2216
"2432","Fresno County",2002-05-01,1729,181,321,39,2270
"2433","Fresno County",2002-06-01,1582,156,275,40,2053
"2434","Fresno County",2002-07-01,1749,177,307,44,2277
"2435","Fresno County",2002-08-01,1672,178,297,39,2186
"2436","Fresno County",2002-09-01,1681,166,289,46,2182
"2437","Fresno County",2002-10-01,1723,165,319,56,2263
"2438","Fresno County",2002-11-01,1528,157,317,45,2047
"2439","Fresno County",2002-12-01,1849,183,343,48,2423
"2440","Fresno County",2003-01-01,2092,246,348,59,2745
"2441","Fresno County",2003-02-01,2252,286,366,62,2966
"2442","Fresno County",2003-03-01,2224,263,432,77,2996
"2443","Fresno County",2003-04-01,2173,257,453,92,2975
"2444","Fresno County",2003-05-01,2207,271,497,73,3048
"2445","Fresno County",2003-06-01,2176,260,538,78,3052
"2446","Fresno County",2003-07-01,2135,253,563,85,3036
"2447","Fresno County",2003-08-01,2108,256,567,84,3015
"2448","Fresno County",2003-09-01,2091,257,573,83,3004
"2449","Fresno County",2003-10-01,2066,254,555,81,2956
"2450","Fresno County",2003-11-01,2123,257,544,87,3011
"2451","Fresno County",2003-12-01,2120,236,519,90,2965
"2452","Fresno County",2004-01-01,2013,254,562,96,2925
"2453","Fresno County",2004-02-01,1987,258,580,90,2915
"2454","Fresno County",2004-03-01,1930,252,610,85,2877
"2455","Fresno County",2004-04-01,1942,254,629,103,2928
"2456","Fresno County",2004-05-01,2055,268,629,92,3044
"2457","Fresno County",2004-06-01,2021,266,692,103,3082
"2458","Fresno County",2004-07-01,2059,270,660,120,3109
"2459","Fresno County",2004-08-01,2030,261,732,123,3146
"2460","Fresno County",2004-09-01,2139,271,642,113,3165
"2461","Fresno County",2004-10-01,2088,281,676,97,3142
"2462","Fresno County",2004-11-01,2017,244,636,81,2978
"2463","Fresno County",2004-12-01,2033,251,559,72,2915
"2464","Fresno County",2005-01-01,2027,249,573,82,2931
"2465","Fresno County",2005-02-01,2089,260,555,84,2988
"2466","Fresno County",2005-03-01,2151,255,514,107,3027
"2467","Fresno County",2005-04-01,2152,249,562,111,3074
"2468","Fresno County",2005-05-01,2083,223,573,110,2989
"2469","Fresno County",2005-06-01,2121,240,483,102,2946
"2470","Fresno County",2005-07-01,2008,238,591,111,2948
"2471","Fresno County",2005-08-01,2115,253,573,106,3047
"2472","Fresno County",2005-09-01,2160,274,569,103,3106
"2473","Fresno County",2005-10-01,2103,292,599,103,3097
"2474","Fresno County",2005-11-01,2142,274,616,113,3145
"2475","Fresno County",2005-12-01,2090,269,581,107,3047
"2476","Fresno County",2006-01-01,2004,279,637,106,3026
"2477","Fresno County",2006-02-01,2125,279,654,109,3167
"2478","Fresno County",2006-03-01,2088,260,672,113,3133
"2479","Fresno County",2006-04-01,2113,252,693,124,3182
"2480","Fresno County",2006-05-01,2186,287,660,125,3258
"2481","Fresno County",2006-06-01,2197,280,638,129,3244
"2482","Fresno County",2006-07-01,2223,262,682,132,3299
"2483","Fresno County",2006-08-01,2284,269,696,136,3385
"2484","Fresno County",2006-09-01,2291,139,720,133,3283
"2485","Fresno County",2006-10-01,2185,301,749,133,3368
"2486","Fresno County",2006-11-01,2247,276,708,130,3361
"2487","Fresno County",2006-12-01,2165,252,702,139,3258
"2488","Fresno County",2007-01-01,2150,288,700,140,3278
"2489","Fresno County",2007-02-01,2168,298,689,139,3294
"2490","Fresno County",2007-03-01,2143,254,674,152,3223
"2491","Fresno County",2007-04-01,2110,276,657,146,3189
"2492","Fresno County",2007-05-01,2028,264,652,150,3094
"2493","Fresno County",2007-06-01,2263,298,408,104,3073
"2494","Fresno County",2007-07-01,2223,262,612,132,3229
"2495","Fresno County",2007-08-01,2027,285,669,112,3093
"2496","Fresno County",2007-09-01,2036,260,718,114,3128
"2497","Fresno County",2007-10-01,2088,260,672,113,3133
"2498","Fresno County",2007-11-01,1877,79,544,50,2550
"2499","Fresno County",2007-12-01,2118,298,488,71,2975
"2500","Fresno County",2008-01-01,1949,261,564,112,2886
"2501","Fresno County",2008-02-01,2158,271,366,50,2845
"2502","Fresno County",2008-03-01,1844,164,724,127,2859
"2503","Fresno County",2008-04-01,1827,216,728,131,2902
"2504","Fresno County",2008-05-01,1847,177,591,116,2731
"2505","Fresno County",2008-06-01,1594,195,608,135,2532
"2506","Fresno County",2008-07-01,1818,227,684,150,2879
"2507","Fresno County",2008-08-01,1938,233,778,167,3116
"2508","Fresno County",2008-09-01,1998,241,782,150,3171
"2509","Fresno County",2008-10-01,1967,233,805,159,3164
"2510","Fresno County",2008-11-01,1917,232,767,148,3064
"2511","Fresno County",2008-12-01,1869,218,773,160,3020
"2512","Fresno County",2009-01-01,1854,220,719,150,2943
"2513","Fresno County",2009-02-01,1902,229,707,147,2985
"2514","Fresno County",2009-03-01,2099,260,405,89,2853
"2515","Fresno County",2009-04-01,1862,232,674,127,2895
"2516","Fresno County",2009-05-01,1818,226,703,121,2868
"2517","Fresno County",2009-06-01,1785,226,694,121,2826
"2518","Fresno County",2009-07-01,1833,233,668,121,2855
"2519","Fresno County",2009-08-01,1843,220,642,126,2831
"2520","Fresno County",2009-09-01,1823,216,261,136,2436
"2521","Fresno County",2009-10-01,1772,213,618,134,2737
"2522","Fresno County",2009-11-01,1780,227,597,130,2734
"2523","Fresno County",2009-12-01,1686,205,569,104,2564
"2524","Fresno County",2010-01-01,1598,174,423,68,2263
"2525","Fresno County",2010-02-01,1566,159,305,45,2075
"2526","Fresno County",2010-03-01,1668,174,363,52,2257
"2527","Fresno County",2010-04-01,1529,171,263,41,2004
"2528","Fresno County",2010-05-01,1374,161,220,26,1781
"2529","Fresno County",2010-06-01,1369,146,198,24,1737
"2530","Fresno County",2010-07-01,1361,146,176,24,1707
"2531","Fresno County",2010-08-01,1362,147,180,29,1718
"2532","Fresno County",2010-09-01,1378,138,169,24,1709
"2533","Fresno County",2010-10-01,1390,142,177,24,1733
"2534","Fresno County",2010-11-01,1390,152,189,32,1763
"2535","Fresno County",2010-12-01,1382,148,185,36,1751
"2536","Fresno County",2011-01-01,1404,162,174,32,1772
"2537","Fresno County",2011-02-01,1427,143,181,43,1794
"2538","Fresno County",2011-03-01,1436,146,169,37,1788
"2539","Fresno County",2011-04-01,1431,156,167,32,1786
"2540","Fresno County",2011-05-01,1427,153,173,31,1784
"2541","Fresno County",2011-06-01,1371,151,176,33,1731
"2542","Fresno County",2011-07-01,1448,160,173,35,1816
"2543","Fresno County",2011-08-01,1437,161,198,36,1832
"2544","Fresno County",2011-09-01,1413,161,201,35,1810
"2545","Fresno County",2011-10-01,1633,201,298,53,2185
"2546","Fresno County",2011-11-01,1584,213,457,94,2348
"2547","Fresno County",2011-12-01,1477,192,566,118,2353
"2548","Fresno County",2012-01-01,1454,182,584,130,2350
"2549","Fresno County",2012-02-01,1460,172,576,145,2353
"2550","Fresno County",2012-03-01,1453,171,570,151,2345
"2551","Fresno County",2012-04-01,1457,177,523,144,2301
"2552","Fresno County",2012-05-01,1475,176,559,145,2355
"2553","Fresno County",2012-06-01,1522,178,560,156,2416
"2554","Fresno County",2012-07-01,1530,176,553,150,2409
"2555","Fresno County",2012-08-01,1509,171,539,142,2361
"2556","Fresno County",2012-09-01,1822,202,596,139,2759
"2557","Fresno County",2012-10-01,1816,188,669,152,2825
"2558","Fresno County",2012-11-01,1763,161,734,135,2793
"2559","Fresno County",2012-12-01,1755,145,762,129,2791
"2560","Fresno County",2013-01-01,1971,158,814,124,3067
"2561","Fresno County",2013-02-01,2003,167,844,111,3125
"2562","Fresno County",2013-03-01,1924,152,871,74,3021
"2563","Fresno County",2013-04-01,1877,152,915,73,3017
"2564","Fresno County",2013-05-01,1882,166,972,68,3088
"2565","Fresno County",2013-06-01,1892,172,996,63,3123
"2566","Fresno County",2013-07-01,1949,181,928,56,3114
"2567","Fresno County",2013-08-01,1980,180,894,57,3111
"2568","Fresno County",2013-09-01,1935,172,899,59,3065
"2569","Fresno County",2013-10-01,1912,137,899,70,3018
"2570","Fresno County",2013-11-01,1841,155,897,76,2969
"2571","Fresno County",2013-12-01,1847,156,843,72,2918
"2572","Fresno County",2014-01-01,1921,165,786,73,2945
"2573","Fresno County",2014-02-01,1969,174,752,64,2959
"2574","Fresno County",2014-03-01,1928,170,780,68,2946
"2575","Fresno County",2014-04-01,1820,164,815,75,2874
"2576","Fresno County",2014-05-01,1791,163,866,78,2898
"2577","Fresno County",2014-06-01,1804,174,871,66,2915
"2578","Fresno County",2014-07-01,1768,170,896,66,2900
"2579","Fresno County",2014-08-01,1720,168,904,66,2858
"2580","Fresno County",2014-09-01,1737,158,889,77,2861
"2581","Fresno County",2014-10-01,1734,163,880,76,2853
"2582","Fresno County",2014-11-01,1612,163,869,76,2720
"2583","Fresno County",2014-12-01,1561,175,781,95,2612
"2584","Fresno County",2015-01-01,1565,204,702,107,2578
"2585","Fresno County",2015-02-01,1608,238,689,120,2655
"2586","Fresno County",2015-03-01,1605,233,689,126,2653
"2587","Fresno County",2015-04-01,1588,220,684,123,2615
"2588","Fresno County",2015-05-01,1608,216,702,133,2659
"2589","Fresno County",2015-06-01,1666,211,701,149,2727
"2590","Fresno County",2015-07-01,1638,199,723,157,2717
"2591","Fresno County",2015-08-01,1650,199,764,153,2766
"2592","Fresno County",2015-09-01,1610,193,769,147,2719
"2593","Fresno County",2015-10-01,1567,190,733,143,2633
"2594","Fresno County",2015-11-01,1594,192,718,127,2631
"2595","Fresno County",2015-12-01,1556,195,719,114,2584
"2596","Fresno County",2016-01-01,1621,204,692,131,2648
"2597","Fresno County",2016-02-01,1708,231,733,123,2795
"2598","Fresno County",2016-03-01,1697,226,754,127,2804
"2599","Fresno County",2016-04-01,1705,217,799,136,2857
"2600","Fresno County",2016-05-01,1745,209,785,141,2880
"2601","Fresno County",2016-06-01,1794,222,776,130,2922
"2602","Fresno County",2016-07-01,1799,227,784,116,2926
"2603","Fresno County",2016-08-01,1774,223,810,114,2921
"2604","Fresno County",2016-09-01,1764,209,800,109,2882
"2605","Fresno County",2016-10-01,1718,206,749,107,2780
"2606","Fresno County",2016-11-01,1703,216,760,103,2782
"2607","Fresno County",2016-12-01,1717,209,742,110,2778
"2608","Fresno County",2017-01-01,1751,196,739,114,2800
"2609","Fresno County",2017-02-01,1783,197,725,118,2823
"2610","Fresno County",2017-03-01,1782,199,714,123,2818
"2611","Fresno County",2017-04-01,1807,212,727,114,2860
"2612","Fresno County",2017-05-01,1801,206,749,124,2880
"2613","Fresno County",2017-06-01,1834,214,538,346,2932
"2614","Fresno County",2017-07-01,1831,227,771,115,2944
"2615","Fresno County",2017-08-01,1825,215,828,130,2998
"2616","Fresno County",2017-09-01,1898,219,810,132,3059
"2617","Fresno County",2017-10-01,1906,226,769,120,3021
"2618","Fresno County",2017-11-01,1920,233,758,122,3033
"2619","Fresno County",2017-12-01,1894,220,756,117,2987
"2620","Fresno County",2018-01-01,1988,235,725,109,3057
"2621","Fresno County",2018-02-01,2053,239,734,110,3136
"2622","Fresno County",2018-03-01,1985,222,747,118,3072
"2623","Fresno County",2018-04-01,1948,226,704,113,2991
"2624","Fresno County",2018-05-01,1951,223,743,114,3031
"2625","Fresno County",2018-06-01,1990,205,722,120,3037
"2626","Fresno County",2018-07-01,2054,215,688,110,3067
"2627","Fresno County",2018-08-01,2038,218,695,108,3059
"2628","Fresno County",2018-09-01,2031,225,703,106,3065
"2629","Fresno County",2018-10-01,2030,199,710,108,3047
"2630","Fresno County",2018-11-01,1989,215,746,106,3056
"2631","Fresno County",2018-12-01,1960,221,719,108,3008
"2632","Fresno County",2019-01-01,1990,221,680,109,3000
"2633","Fresno County",2019-02-01,2005,224,695,109,3033
"2634","Fresno County",2019-03-01,2005,222,704,114,3045
"2635","Fresno County",2019-04-01,2004,228,695,106,3033
"2636","Fresno County",2019-05-01,2049,213,693,106,3061
"2637","Fresno County",2019-06-01,2099,203,689,87,3078
"2638","Fresno County",2019-07-01,2072,203,675,84,3034
"2639","Fresno County",2019-08-01,2095,207,688,84,3074
"2640","Fresno County",2019-09-01,2102,215,676,86,3079
"2641","Fresno County",2019-10-01,2104,219,682,71,3076
"2642","Fresno County",2019-11-01,2051,209,670,74,3004
"2643","Fresno County",2019-12-01,2015,196,639,82,2932
"2644","Fresno County",2020-01-01,2055,192,610,83,2940
"2645","Fresno County",2020-02-01,2123,190,573,77,2963
"2646","Fresno County",2020-03-01,2114,204,537,67,2922
"2647","Glenn County",1995-10-01,43,4,32,5,84
"2648","Glenn County",1995-11-01,38,4,37,5,84
"2649","Glenn County",1995-12-01,38,4,33,6,81
"2650","Glenn County",1996-01-01,45,3,25,7,80
"2651","Glenn County",1996-02-01,36.34,5.13,25.83,6,73.3
"2652","Glenn County",1996-03-01,33,3,28,6,70
"2653","Glenn County",1996-04-01,38,1,30,5,74
"2654","Glenn County",1996-05-01,37,3,27,7,74
"2655","Glenn County",1996-06-01,30,3,26,6,65
"2656","Glenn County",1996-07-01,36,3,27,6,72
"2657","Glenn County",1996-08-01,37,5,24,6,72
"2658","Glenn County",1996-09-01,38,4,18,5,65
"2659","Glenn County",1996-10-01,43,3,19,5,70
"2660","Glenn County",1996-11-01,37,4,23,3,67
"2661","Glenn County",1996-12-01,37,4,19,1,61
"2662","Glenn County",1997-01-01,43,3,27,1,74
"2663","Glenn County",1997-02-01,46,3,25,6,80
"2664","Glenn County",1997-03-01,47,4,23,3,77
"2665","Glenn County",1997-04-01,45,4,28,4,81
"2666","Glenn County",1997-05-01,46,3,25,4,78
"2667","Glenn County",1997-06-01,41,4,24,4,73
"2668","Glenn County",1997-07-01,38,6,23,2,69
"2669","Glenn County",1997-08-01,40,5,19,1,65
"2670","Glenn County",1997-09-01,37,5,20,5,67
"2671","Glenn County",1997-10-01,44,3,22,4,73
"2672","Glenn County",1997-11-01,35,2,19,4,60
"2673","Glenn County",1997-12-01,38,4,19,4,65
"2674","Glenn County",1998-01-01,45,9,21,2,77
"2675","Glenn County",1998-02-01,52,10,21,4,87
"2676","Glenn County",1998-03-01,63,9,21,6,99
"2677","Glenn County",1998-04-01,51,5,23,8,87
"2678","Glenn County",1998-05-01,51,1,17,7,76
"2679","Glenn County",1998-06-01,49,2,17,8,76
"2680","Glenn County",1998-07-01,54,5,19,6,84
"2681","Glenn County",1998-08-01,47,6,22,6,81
"2682","Glenn County",1998-09-01,49,5,19,6,79
"2683","Glenn County",1998-10-01,50,5,23,7,85
"2684","Glenn County",1998-11-01,51,3,29,9,92
"2685","Glenn County",1998-12-01,46,3,24,4,77
"2686","Glenn County",1999-01-01,41,5,22,3,71
"2687","Glenn County",1999-02-01,43,20,22,2,87
"2688","Glenn County",1999-03-01,45,19,20,3,87
"2689","Glenn County",1999-04-01,49,22,15,5,91
"2690","Glenn County",1999-05-01,55,32,16,4,107
"2691","Glenn County",1999-06-01,51,34,15,4,104
"2692","Glenn County",1999-07-01,45,31,17,2,95
"2693","Glenn County",1999-08-01,48,29,17,3,97
"2694","Glenn County",1999-09-01,45,25,12,3,85
"2695","Glenn County",1999-10-01,36,31,16,2,85
"2696","Glenn County",1999-11-01,52,28,16,4,100
"2697","Glenn County",1999-12-01,44,32,12,4,92
"2698","Glenn County",2000-01-01,51,34,15,4,104
"2699","Glenn County",2000-02-01,53,36,15,2,106
"2700","Glenn County",2000-03-01,54,35,16,2,107
"2701","Glenn County",2000-04-01,53,35,18,2,108
"2702","Glenn County",2000-05-01,54,27,21,1,103
"2703","Glenn County",2000-06-01,61,26,23,4,114
"2704","Glenn County",2000-07-01,57,26,25,8,116
"2705","Glenn County",2000-08-01,42,25,34,14,115
"2706","Glenn County",2000-09-01,54,26,18,6,104
"2707","Glenn County",2000-10-01,40,19,7,2,68
"2708","Glenn County",2000-11-01,55,17,8,0,80
"2709","Glenn County",2000-12-01,45,13,6,0,64
"2710","Glenn County",2001-01-01,44,16,4,0,64
"2711","Glenn County",2001-02-01,48,17,3,0,68
"2712","Glenn County",2001-03-01,47,12,2,0,61
"2713","Glenn County",2001-04-01,66,11,3,0,80
"2714","Glenn County",2001-05-01,81,14,6,0,101
"2715","Glenn County",2001-06-01,75,12,12,2,101
"2716","Glenn County",2001-07-01,60,12,5,3,80
"2717","Glenn County",2001-08-01,66,12,4,0,82
"2718","Glenn County",2001-09-01,69,17,4,0,90
"2719","Glenn County",2001-10-01,70,18,7,3,98
"2720","Glenn County",2001-11-01,61,11,19,4,95
"2721","Glenn County",2001-12-01,63,11,7,1,82
"2722","Glenn County",2002-01-01,61,10,5,0,76
"2723","Glenn County",2002-02-01,57,14,4,2,77
"2724","Glenn County",2002-03-01,56,13,6,3,78
"2725","Glenn County",2002-04-01,56,11,6,3,76
"2726","Glenn County",2002-05-01,56,7,7,2,72
"2727","Glenn County",2002-06-01,60,13,10,4,87
"2728","Glenn County",2002-07-01,50,16,8,5,79
"2729","Glenn County",2002-08-01,48,11,9,3,71
"2730","Glenn County",2002-09-01,55,9,11,2,77
"2731","Glenn County",2002-10-01,42,5,32,6,85
"2732","Glenn County",2002-11-01,44,6,34,6,90
"2733","Glenn County",2002-12-01,46,6,36,6,94
"2734","Glenn County",2003-01-01,57,13,33,3,106
"2735","Glenn County",2003-02-01,72,16,40,4,132
"2736","Glenn County",2003-03-01,88,12,39,5,144
"2737","Glenn County",2003-04-01,99,9,31,4,143
"2738","Glenn County",2003-05-01,93,15,28,2,138
"2739","Glenn County",2003-06-01,75,15,38,3,131
"2740","Glenn County",2003-07-01,64,17,47,3,131
"2741","Glenn County",2003-08-01,60,19,49,3,131
"2742","Glenn County",2003-09-01,72,14,44,4,134
"2743","Glenn County",2003-10-01,68,11,39,7,125
"2744","Glenn County",2003-11-01,67,12,46,5,130
"2745","Glenn County",2003-12-01,70,14,42,7,133
"2746","Glenn County",2004-01-01,70,11,42,9,132
"2747","Glenn County",2004-02-01,80,9,54,8,151
"2748","Glenn County",2004-03-01,73,10,56,6,145
"2749","Glenn County",2004-04-01,65,11,45,3,124
"2750","Glenn County",2004-05-01,63,8,48,5,124
"2751","Glenn County",2004-06-01,67,9,44,5,125
"2752","Glenn County",2004-07-01,70,13,50,7,140
"2753","Glenn County",2004-08-01,68,11,46,8,133
"2754","Glenn County",2004-09-01,62,11,44,3,120
"2755","Glenn County",2004-10-01,55,9,42,2,108
"2756","Glenn County",2004-11-01,60,10,36,5,111
"2757","Glenn County",2004-12-01,59,9,34,5,107
"2758","Glenn County",2005-01-01,65,8,48,4,125
"2759","Glenn County",2005-02-01,62,8,59,8,137
"2760","Glenn County",2005-03-01,66,9,60,7,142
"2761","Glenn County",2005-04-01,75,7,63,5,150
"2762","Glenn County",2005-05-01,71,7,62,7,147
"2763","Glenn County",2005-06-01,70,10,59,9,148
"2764","Glenn County",2005-07-01,74,11,56,12,153
"2765","Glenn County",2005-08-01,82,14,46,14,156
"2766","Glenn County",2005-09-01,82,15,38,11,146
"2767","Glenn County",2005-10-01,83,14,34,9,140
"2768","Glenn County",2005-11-01,85,15,35,9,144
"2769","Glenn County",2005-12-01,79,14,39,9,141
"2770","Glenn County",2006-01-01,83,17,27,8,135
"2771","Glenn County",2006-02-01,83,14,28,9,134
"2772","Glenn County",2006-03-01,88,14,29,13,144
"2773","Glenn County",2006-04-01,77,15,28,12,132
"2774","Glenn County",2006-05-01,63,10,21,9,103
"2775","Glenn County",2006-06-01,60,10,27,9,106
"2776","Glenn County",2006-07-01,65,10,28,5,108
"2777","Glenn County",2006-08-01,76,11,23,5,115
"2778","Glenn County",2006-09-01,83,11,28,5,127
"2779","Glenn County",2006-10-01,79,11,34,7,131
"2780","Glenn County",2006-11-01,80,9,34,7,130
"2781","Glenn County",2006-12-01,72,12,35,8,127
"2782","Glenn County",2007-01-01,67,12,35,9,123
"2783","Glenn County",2007-02-01,65,12,39,6,122
"2784","Glenn County",2007-03-01,67,13,34,8,122
"2785","Glenn County",2007-04-01,66,13,33,8,120
"2786","Glenn County",2007-05-01,68,14,29,6,117
"2787","Glenn County",2007-06-01,70,12,27,7,116
"2788","Glenn County",2007-07-01,72,15,34,7,128
"2789","Glenn County",2007-08-01,67,11,39,9,126
"2790","Glenn County",2007-09-01,58,11,38,8,115
"2791","Glenn County",2007-10-01,59,12,35,9,115
"2792","Glenn County",2007-11-01,57,11,31,11,110
"2793","Glenn County",2007-12-01,54,10,24,7,95
"2794","Glenn County",2008-01-01,60,11,21,3,95
"2795","Glenn County",2008-02-01,57,13,28,6,104
"2796","Glenn County",2008-03-01,58,13,18,5,94
"2797","Glenn County",2008-04-01,66,9,22,11,108
"2798","Glenn County",2008-05-01,58,6,32,9,105
"2799","Glenn County",2008-06-01,62,6,31,6,105
"2800","Glenn County",2008-07-01,63,8,24,6,101
"2801","Glenn County",2008-08-01,60,9,23,5,97
"2802","Glenn County",2008-09-01,55,8,21,4,88
"2803","Glenn County",2008-10-01,55,10,22,3,90
"2804","Glenn County",2008-11-01,55,10,22,3,90
"2805","Glenn County",2008-12-01,62,9,23,5,99
"2806","Glenn County",2009-01-01,63,9,27,7,106
"2807","Glenn County",2009-02-01,60,9,26,9,104
"2808","Glenn County",2009-03-01,49,8,24,8,89
"2809","Glenn County",2009-04-01,57,8,21,5,91
"2810","Glenn County",2009-05-01,63,8,23,7,101
"2811","Glenn County",2009-06-01,56,5,21,6,88
"2812","Glenn County",2009-07-01,43,5,30,6,84
"2813","Glenn County",2009-08-01,41,6,27,4,78
"2814","Glenn County",2009-09-01,48,6,22,7,83
"2815","Glenn County",2009-10-01,50,4,21,7,82
"2816","Glenn County",2009-11-01,58,7,17,8,90
"2817","Glenn County",2009-12-01,52,9,17,8,86
"2818","Glenn County",2010-01-01,60,10,16,9,95
"2819","Glenn County",2010-02-01,63,8,12,4,87
"2820","Glenn County",2010-03-01,55,5,16,2,78
"2821","Glenn County",2010-04-01,56,8,17,3,84
"2822","Glenn County",2010-05-01,57,9,21,3,90
"2823","Glenn County",2010-06-01,62,9,16,4,91
"2824","Glenn County",2010-07-01,54,8,19,3,84
"2825","Glenn County",2010-08-01,56,12,18,3,89
"2826","Glenn County",2010-09-01,55,15,13,6,89
"2827","Glenn County",2010-10-01,51,14,14,5,84
"2828","Glenn County",2010-11-01,53,8,19,7,87
"2829","Glenn County",2010-12-01,47,8,16,7,78
"2830","Glenn County",2011-01-01,48,8,15,7,78
"2831","Glenn County",2011-02-01,48,9,22,5,84
"2832","Glenn County",2011-03-01,50,9,21,4,84
"2833","Glenn County",2011-04-01,60,8,17,5,90
"2834","Glenn County",2011-05-01,62,10,24,6,102
"2835","Glenn County",2011-06-01,65,14,20,9,108
"2836","Glenn County",2011-07-01,63,15,16,8,102
"2837","Glenn County",2011-08-01,72,13,19,9,113
"2838","Glenn County",2011-09-01,68,9,16,7,100
"2839","Glenn County",2011-10-01,66,9,9,5,89
"2840","Glenn County",2011-11-01,56,7,17,3,83
"2841","Glenn County",2011-12-01,60,7,20,2,89
"2842","Glenn County",2012-01-01,56,8,20,2,86
"2843","Glenn County",2012-02-01,63,9,19,3,94
"2844","Glenn County",2012-03-01,62,7,20,5,94
"2845","Glenn County",2012-04-01,69,9,23,5,106
"2846","Glenn County",2012-05-01,66,8,23,4,101
"2847","Glenn County",2012-06-01,64,8,23,6,101
"2848","Glenn County",2012-07-01,61,11,23,4,99
"2849","Glenn County",2012-08-01,66,9,21,4,100
"2850","Glenn County",2012-09-01,59,11,25,3,98
"2851","Glenn County",2012-10-01,63,9,29,4,105
"2852","Glenn County",2012-11-01,65,7,22,5,99
"2853","Glenn County",2012-12-01,59,7,18,5,89
"2854","Glenn County",2013-01-01,57,8,16,8,89
"2855","Glenn County",2013-02-01,61,10,20,7,98
"2856","Glenn County",2013-03-01,69,11,23,8,111
"2857","Glenn County",2013-04-01,74,10,23,5,112
"2858","Glenn County",2013-05-01,75,10,25,4,114
"2859","Glenn County",2013-06-01,73,10,25,5,113
"2860","Glenn County",2013-07-01,73,10,26,7,116
"2861","Glenn County",2013-08-01,72,8,24,7,111
"2862","Glenn County",2013-09-01,67,9,22,7,105
"2863","Glenn County",2013-10-01,62,11,25,7,105
"2864","Glenn County",2013-11-01,58,9,27,7,101
"2865","Glenn County",2013-12-01,61,8,30,6,105
"2866","Glenn County",2014-01-01,61,12,33,5,111
"2867","Glenn County",2014-02-01,60,13,31,6,110
"2868","Glenn County",2014-03-01,60,9,34,9,112
"2869","Glenn County",2014-04-01,52,6,33,7,98
"2870","Glenn County",2014-05-01,53,9,27,6,95
"2871","Glenn County",2014-06-01,54,9,29,6,98
"2872","Glenn County",2014-07-01,52,7,30,7,96
"2873","Glenn County",2014-08-01,54,6,29,7,96
"2874","Glenn County",2014-09-01,61,7,26,7,101
"2875","Glenn County",2014-10-01,58,10,27,7,102
"2876","Glenn County",2014-11-01,56,10,31,6,103
"2877","Glenn County",2014-12-01,58,12,29,7,106
"2878","Glenn County",2015-01-01,57,11,30,5,103
"2879","Glenn County",2015-02-01,58,11,26,5,100
"2880","Glenn County",2015-03-01,61,13,25,5,104
"2881","Glenn County",2015-04-01,50,12,32,7,101
"2882","Glenn County",2015-05-01,44,10,30,7,91
"2883","Glenn County",2015-06-01,42,9,32,5,88
"2884","Glenn County",2015-07-01,43,10,28,5,86
"2885","Glenn County",2015-08-01,39,13,32,7,91
"2886","Glenn County",2015-09-01,35,13,37,4,89
"2887","Glenn County",2015-10-01,36,13,34,8,91
"2888","Glenn County",2015-11-01,42,13,34,7,96
"2889","Glenn County",2015-12-01,41,11,37,10,99
"2890","Glenn County",2016-01-01,38,9,31,12,90
"2891","Glenn County",2016-02-01,40,12,28,9,89
"2892","Glenn County",2016-03-01,46,16,25,9,96
"2893","Glenn County",2016-04-01,54,18,29,9,110
"2894","Glenn County",2016-05-01,48,13,34,10,105
"2895","Glenn County",2016-06-01,50,12,25,8,95
"2896","Glenn County",2016-07-01,52,12,32,7,103
"2897","Glenn County",2016-08-01,0,0,0,0,0
"2898","Glenn County",2016-09-01,69,15,26,5,115
"2899","Glenn County",2016-10-01,63,16,19,6,104
"2900","Glenn County",2016-11-01,0,0,0,0,0
"2901","Glenn County",2016-12-01,54,16,19,3,92
"2902","Glenn County",2017-01-01,60,13,22,5,100
"2903","Glenn County",2017-02-01,58,15,20,2,95
"2904","Glenn County",2017-03-01,51,15,23,6,95
"2905","Glenn County",2017-04-01,55,14,30,5,104
"2906","Glenn County",2017-05-01,54,13,32,6,105
"2907","Glenn County",2017-06-01,56,14,21,10,101
"2908","Glenn County",2017-07-01,61,12,21,11,105
"2909","Glenn County",2017-08-01,61,10,27,10,108
"2910","Glenn County",2017-09-01,72,7,19,13,111
"2911","Glenn County",2017-10-01,58,6,25,12,101
"2912","Glenn County",2017-11-01,59,10,24,7,100
"2913","Glenn County",2017-12-01,56,11,28,9,104
"2914","Glenn County",2018-01-01,47,12,24,8,91
"2915","Glenn County",2018-02-01,49,13,25,9,96
"2916","Glenn County",2018-03-01,48,13,27,8,96
"2917","Glenn County",2018-04-01,51,16,26,6,99
"2918","Glenn County",2018-05-01,55,14,25,9,103
"2919","Glenn County",2018-06-01,58,16,20,4,98
"2920","Glenn County",2018-07-01,62,11,27,7,107
"2921","Glenn County",2018-08-01,73,9,30,10,122
"2922","Glenn County",2018-09-01,65,11,27,7,110
"2923","Glenn County",2018-10-01,67,11,24,4,106
"2924","Glenn County",2018-11-01,66,11,23,7,107
"2925","Glenn County",2018-12-01,74,13,20,6,113
"2926","Glenn County",2019-01-01,71,13,22,6,112
"2927","Glenn County",2019-02-01,65,18,23,5,111
"2928","Glenn County",2019-03-01,73,16,21,6,116
"2929","Glenn County",2019-04-01,53,17,24,6,100
"2930","Glenn County",2019-05-01,61,14,20,6,101
"2931","Glenn County",2019-06-01,67,10,24,3,104
"2932","Glenn County",2019-07-01,62,13,27,4,106
"2933","Glenn County",2019-08-01,62,13,23,6,104
"2934","Glenn County",2019-09-01,59,13,23,5,100
"2935","Glenn County",2019-10-01,60,12,21,6,99
"2936","Glenn County",2019-11-01,58,10,27,5,100
"2937","Glenn County",2019-12-01,55,14,25,2,96
"2938","Glenn County",2020-01-01,56,17,21,4,98
"2939","Glenn County",2020-02-01,62,16,20,4,102
"2940","Glenn County",2020-03-01,53,12,19,3,87
"2941","Humboldt County",1995-10-01,148,22,15,13,198
"2942","Humboldt County",1995-11-01,155,23,21,1,200
"2943","Humboldt County",1995-12-01,167,22,24,5,218
"2944","Humboldt County",1996-01-01,168,26,23,3,220
"2945","Humboldt County",1996-02-01,177,22,25,1,225
"2946","Humboldt County",1996-03-01,180,21,21,1,223
"2947","Humboldt County",1996-04-01,178,19,20,1,218
"2948","Humboldt County",1996-05-01,164,26,26,1,217
"2949","Humboldt County",1996-06-01,168,27,18,2,215
"2950","Humboldt County",1996-07-01,175,26,11,3,215
"2951","Humboldt County",1996-08-01,173,20,10,2,205
"2952","Humboldt County",1996-09-01,154,20,14,10,198
"2953","Humboldt County",1996-10-01,184,27,10,2,223
"2954","Humboldt County",1996-11-01,191,34,14,2,241
"2955","Humboldt County",1996-12-01,182,24,8,3,217
"2956","Humboldt County",1997-01-01,212,25,15,2,254
"2957","Humboldt County",1997-02-01,184,27,59,2,272
"2958","Humboldt County",1997-03-01,200,31,45,2,278
"2959","Humboldt County",1997-04-01,195,32,58,2,287
"2960","Humboldt County",1997-05-01,189,32,55,10,286
"2961","Humboldt County",1997-06-01,196,26,61,7,290
"2962","Humboldt County",1997-07-01,199,30,55,2,286
"2963","Humboldt County",1997-08-01,228,29,23,1,281
"2964","Humboldt County",1997-09-01,216,20,8,0,244
"2965","Humboldt County",1997-10-01,222,30,9,0.38,261.38
"2966","Humboldt County",1997-11-01,228,31,9,1,269
"2967","Humboldt County",1997-12-01,218,24,16,2,260
"2968","Humboldt County",1998-01-01,238,32,36,2,308
"2969","Humboldt County",1998-02-01,274,30,27,5,336
"2970","Humboldt County",1998-03-01,285,29,17,1,332
"2971","Humboldt County",1998-04-01,309,31,12,0,352
"2972","Humboldt County",1998-05-01,299,31,17,2,349
"2973","Humboldt County",1998-06-01,282,31,21,1,335
"2974","Humboldt County",1998-07-01,255,29,22,3,309
"2975","Humboldt County",1998-08-01,256,35,20,1,312
"2976","Humboldt County",1998-09-01,257,34,25,3,319
"2977","Humboldt County",1998-10-01,273,40,13,3,329
"2978","Humboldt County",1998-11-01,267,36,14,3,320
"2979","Humboldt County",1998-12-01,256,39,16,2,313
"2980","Humboldt County",1999-01-01,263,43,16,2,324
"2981","Humboldt County",1999-02-01,200,27,73,17,317
"2982","Humboldt County",1999-03-01,183,24,79,13,299
"2983","Humboldt County",1999-04-01,206,29,80,14,329
"2984","Humboldt County",1999-05-01,189,28,91,18,326
"2985","Humboldt County",1999-06-01,188,26,80,18,312
"2986","Humboldt County",1999-07-01,168,29,98,19,314
"2987","Humboldt County",1999-08-01,188,28,103,20,339
"2988","Humboldt County",1999-09-01,193,27,93,15,328
"2989","Humboldt County",1999-10-01,196,26,92,14,328
"2990","Humboldt County",1999-11-01,199,25,94,9,327
"2991","Humboldt County",1999-12-01,189,28,84,10,311
"2992","Humboldt County",2000-01-01,192,28,82,11,313
"2993","Humboldt County",2000-02-01,193,31,88,12,324
"2994","Humboldt County",2000-03-01,221,30,80,13,344
"2995","Humboldt County",2000-04-01,208,23,86,16,333
"2996","Humboldt County",2000-05-01,207,31,98,14,350
"2997","Humboldt County",2000-06-01,217,31,111,18,377
"2998","Humboldt County",2000-07-01,208,28,111,21,368
"2999","Humboldt County",2000-08-01,193,26,111,19,349
"3000","Humboldt County",2000-09-01,194,31,121,14,360
"3001","Humboldt County",2000-10-01,201,25,118,14,358
"3002","Humboldt County",2000-11-01,212,27,102,14,355
"3003","Humboldt County",2000-12-01,202,26,105,13,346
"3004","Humboldt County",2001-01-01,208,28,105,16,357
"3005","Humboldt County",2001-02-01,212,31,109,18,370
"3006","Humboldt County",2001-03-01,203,28,116,19,366
"3007","Humboldt County",2001-04-01,221,27,114,23,385
"3008","Humboldt County",2001-05-01,209,30,124,17,380
"3009","Humboldt County",2001-06-01,181,27,150,16,374
"3010","Humboldt County",2001-07-01,175,31,148,18,372
"3011","Humboldt County",2001-08-01,185,30,124,14,353
"3012","Humboldt County",2001-09-01,205,34,123,11,373
"3013","Humboldt County",2001-10-01,215,32,121,14,382
"3014","Humboldt County",2001-11-01,208,30,118,24,380
"3015","Humboldt County",2001-12-01,214,28,113,15,370
"3016","Humboldt County",2002-01-01,218,24,114,17,373
"3017","Humboldt County",2002-02-01,217,26,121,18,382
"3018","Humboldt County",2002-03-01,201,28,120,23,372
"3019","Humboldt County",2002-04-01,214,34,119,20,387
"3020","Humboldt County",2002-05-01,204,29,123,22,378
"3021","Humboldt County",2002-06-01,188,30,103,16,337
"3022","Humboldt County",2002-07-01,201,33,93,16,343
"3023","Humboldt County",2002-08-01,205,33,91,16,345
"3024","Humboldt County",2002-09-01,227,33,100,15,375
"3025","Humboldt County",2002-10-01,231,37,112,19,399
"3026","Humboldt County",2002-11-01,219,43,116,16,394
"3027","Humboldt County",2002-12-01,211,34,114,15,374
"3028","Humboldt County",2003-01-01,205,39,113,15,372
"3029","Humboldt County",2003-02-01,213,35,116,17,381
"3030","Humboldt County",2003-03-01,218,30,107,14,369
"3031","Humboldt County",2003-04-01,214,31,111,14,370
"3032","Humboldt County",2003-05-01,229,40,106,10,385
"3033","Humboldt County",2003-06-01,234,35,104,11,384
"3034","Humboldt County",2003-07-01,243,33,105,10,391
"3035","Humboldt County",2003-08-01,229,35,109,13,386
"3036","Humboldt County",2003-09-01,237,41,99,14,391
"3037","Humboldt County",2003-10-01,236,38,95,14,383
"3038","Humboldt County",2003-11-01,204,34,92,18,348
"3039","Humboldt County",2003-12-01,192,29,101,18,340
"3040","Humboldt County",2004-01-01,200,32,102,19,353
"3041","Humboldt County",2004-02-01,198,40,111,20,369
"3042","Humboldt County",2004-03-01,207,37,110,17,371
"3043","Humboldt County",2004-04-01,208,33,113,15,369
"3044","Humboldt County",2004-05-01,189,29,124,15,357
"3045","Humboldt County",2004-06-01,177,32,127,19,355
"3046","Humboldt County",2004-07-01,196,30,117,18,361
"3047","Humboldt County",2004-08-01,208,30,107,16,361
"3048","Humboldt County",2004-09-01,204,32,106,16,358
"3049","Humboldt County",2004-10-01,198,29,95,18,340
"3050","Humboldt County",2004-11-01,205,30,98,21,354
"3051","Humboldt County",2004-12-01,201,35,107,16,359
"3052","Humboldt County",2005-01-01,205,33,115,20,373
"3053","Humboldt County",2005-02-01,212,29,129,18,388
"3054","Humboldt County",2005-03-01,190,32,139,16,377
"3055","Humboldt County",2005-04-01,179,29,144,18,370
"3056","Humboldt County",2005-05-01,183,31,145,20,379
"3057","Humboldt County",2005-06-01,195,31,133,22,381
"3058","Humboldt County",2005-07-01,202,40,120,14,376
"3059","Humboldt County",2005-08-01,203,40,118,19,380
"3060","Humboldt County",2005-09-01,198,37,120,19,374
"3061","Humboldt County",2005-10-01,203,35,123,24,385
"3062","Humboldt County",2005-11-01,201,28,124,19,372
"3063","Humboldt County",2005-12-01,199,30,120,20,369
"3064","Humboldt County",2006-01-01,199,35,113,20,367
"3065","Humboldt County",2006-02-01,212,35,107,27,381
"3066","Humboldt County",2006-03-01,202,23,119,26,370
"3067","Humboldt County",2006-04-01,214,20,114,23,371
"3068","Humboldt County",2006-05-01,180,31,128,26,365
"3069","Humboldt County",2006-06-01,197,26,120,27,370
"3070","Humboldt County",2006-07-01,203,26,116,23,368
"3071","Humboldt County",2006-08-01,209,29,105,19,362
"3072","Humboldt County",2006-09-01,209,31,120,20,380
"3073","Humboldt County",2006-10-01,200,30,116,22,368
"3074","Humboldt County",2006-11-01,207,26,99,18,350
"3075","Humboldt County",2006-12-01,174,27,108,17,326
"3076","Humboldt County",2007-01-01,188,27,114,22,351
"3077","Humboldt County",2007-02-01,226,38,108,19,391
"3078","Humboldt County",2007-03-01,228,38,111,19,396
"3079","Humboldt County",2007-04-01,230,25,111,22,388
"3080","Humboldt County",2007-05-01,229,39,103,21,392
"3081","Humboldt County",2007-06-01,210,32,116,25,383
"3082","Humboldt County",2007-07-01,203,34,116,20,373
"3083","Humboldt County",2007-08-01,176,35,128,18,357
"3084","Humboldt County",2007-09-01,177,35,132,10,354
"3085","Humboldt County",2007-10-01,190,39,127,13,369
"3086","Humboldt County",2007-11-01,166,58,84,53,361
"3087","Humboldt County",2007-12-01,170,29,120,16,335
"3088","Humboldt County",2008-01-01,173,30,121,23,347
"3089","Humboldt County",2008-02-01,180,34,100,17,331
"3090","Humboldt County",2008-03-01,198,33,96,19,346
"3091","Humboldt County",2008-04-01,207,35,100,18,360
"3092","Humboldt County",2008-05-01,198,28,102,15,343
"3093","Humboldt County",2008-06-01,187,32,92,15,326
"3094","Humboldt County",2008-07-01,196,29,89,13,327
"3095","Humboldt County",2008-08-01,186,38,94,15,333
"3096","Humboldt County",2008-09-01,182,35,100,22,339
"3097","Humboldt County",2008-10-01,184,34,95,24,337
"3098","Humboldt County",2008-11-01,193,31,91,17,332
"3099","Humboldt County",2008-12-01,191,32,91,16,330
"3100","Humboldt County",2009-01-01,174,30,100,15,319
"3101","Humboldt County",2009-02-01,198,29,92,17,336
"3102","Humboldt County",2009-03-01,204,36,93,13,346
"3103","Humboldt County",2009-04-01,214,38,91,17,360
"3104","Humboldt County",2009-05-01,211,29,100,22,362
"3105","Humboldt County",2009-06-01,223,29,96,19,367
"3106","Humboldt County",2009-07-01,219,34,93,21,367
"3107","Humboldt County",2009-08-01,221,43,88,15,367
"3108","Humboldt County",2009-09-01,211,44,96,17,368
"3109","Humboldt County",2009-10-01,207,41,93,16,357
"3110","Humboldt County",2009-11-01,224,41,91,15,371
"3111","Humboldt County",2009-12-01,225,34,80,12,351
"3112","Humboldt County",2010-01-01,246,40,81,15,382
"3113","Humboldt County",2010-02-01,247,42,86,16,391
"3114","Humboldt County",2010-03-01,257,36,89,22,404
"3115","Humboldt County",2010-04-01,238,26,91,14,369
"3116","Humboldt County",2010-05-01,215,34,93,14,356
"3117","Humboldt County",2010-06-01,229,34,83,16,362
"3118","Humboldt County",2010-07-01,234,37,68,17,356
"3119","Humboldt County",2010-08-01,226,45,68,17,356
"3120","Humboldt County",2010-09-01,250,51,71,19,391
"3121","Humboldt County",2010-10-01,253,46,74,24,397
"3122","Humboldt County",2010-11-01,249,43,73,26,391
"3123","Humboldt County",2010-12-01,240,33,73,27,373
"3124","Humboldt County",2011-01-01,237,39,89,28,393
"3125","Humboldt County",2011-02-01,231,40,97,26,394
"3126","Humboldt County",2011-03-01,216,30,108,26,380
"3127","Humboldt County",2011-04-01,220,44,94,17,375
"3128","Humboldt County",2011-05-01,232,44,90,19,385
"3129","Humboldt County",2011-06-01,222,42,90,21,375
"3130","Humboldt County",2011-07-01,214,37,97,21,369
"3131","Humboldt County",2011-08-01,229,37,101,24,391
"3132","Humboldt County",2011-09-01,229,46,94,16,385
"3133","Humboldt County",2011-10-01,206,45,93,14,358
"3134","Humboldt County",2011-11-01,206,44,101,15,366
"3135","Humboldt County",2011-12-01,220,41,99,10,370
"3136","Humboldt County",2012-01-01,238,40,107,10,395
"3137","Humboldt County",2012-02-01,238,52,91,16,397
"3138","Humboldt County",2012-03-01,215,46,99,16,376
"3139","Humboldt County",2012-04-01,218,32,95,21,366
"3140","Humboldt County",2012-05-01,208,31,99,20,358
"3141","Humboldt County",2012-06-01,207,29,106,25,367
"3142","Humboldt County",2012-07-01,221,30,100,20,371
"3143","Humboldt County",2012-08-01,201,36,114,18,369
"3144","Humboldt County",2012-09-01,203,32,105,22,362
"3145","Humboldt County",2012-10-01,210,31,100,24,365
"3146","Humboldt County",2012-11-01,212,35,99,18,364
"3147","Humboldt County",2012-12-01,215,32,104,18,369
"3148","Humboldt County",2013-01-01,219,35,100,15,369
"3149","Humboldt County",2013-02-01,203,33,111,20,367
"3150","Humboldt County",2013-03-01,191,25,119,27,362
"3151","Humboldt County",2013-04-01,201,32,118,20,371
"3152","Humboldt County",2013-05-01,209,35,115,21,380
"3153","Humboldt County",2013-06-01,200,28,123,24,375
"3154","Humboldt County",2013-07-01,204,28,115,23,370
"3155","Humboldt County",2013-08-01,222,34,103,18,377
"3156","Humboldt County",2013-09-01,211,35,114,15,375
"3157","Humboldt County",2013-10-01,214,37,109,14,374
"3158","Humboldt County",2013-11-01,209,32,115,18,374
"3159","Humboldt County",2013-12-01,205,33,105,18,361
"3160","Humboldt County",2014-01-01,201,33,109,19,362
"3161","Humboldt County",2014-02-01,196,28,120,25,369
"3162","Humboldt County",2014-03-01,194,29,116,25,364
"3163","Humboldt County",2014-04-01,191,29,110,25,355
"3164","Humboldt County",2014-05-01,201,26,115,24,366
"3165","Humboldt County",2014-06-01,182,27,137,21,367
"3166","Humboldt County",2014-07-01,175,30,130,20,355
"3167","Humboldt County",2014-08-01,193,25,117,25,360
"3168","Humboldt County",2014-09-01,193,26,122,19,360
"3169","Humboldt County",2014-10-01,188,28,121,17,354
"3170","Humboldt County",2014-11-01,158,22,108,15,303
"3171","Humboldt County",2014-12-01,146,20,85,12,263
"3172","Humboldt County",2015-01-01,177,22,85,13,297
"3173","Humboldt County",2015-02-01,202,27,88,14,331
"3174","Humboldt County",2015-03-01,202,32,87,10,331
"3175","Humboldt County",2015-04-01,230,41,75,16,362
"3176","Humboldt County",2015-05-01,211,36,84,17,348
"3177","Humboldt County",2015-06-01,229,34,88,15,366
"3178","Humboldt County",2015-07-01,211,36,86,15,348
"3179","Humboldt County",2015-08-01,199,31,105,19,354
"3180","Humboldt County",2015-09-01,202,29,106,18,355
"3181","Humboldt County",2015-10-01,186,30,106,12,334
"3182","Humboldt County",2015-11-01,200,28,93,14,335
"3183","Humboldt County",2015-12-01,202,31,85,9,327
"3184","Humboldt County",2016-01-01,210,38,85,13,346
"3185","Humboldt County",2016-02-01,232,28,87,11,358
"3186","Humboldt County",2016-03-01,211,29,107,12,359
"3187","Humboldt County",2016-04-01,224,31,100,11,366
"3188","Humboldt County",2016-05-01,227,28,99,13,367
"3189","Humboldt County",2016-06-01,239,38,90,14,381
"3190","Humboldt County",2016-07-01,223,39,100,11,373
"3191","Humboldt County",2016-08-01,225,32,110,11,378
"3192","Humboldt County",2016-09-01,221,37,107,11,376
"3193","Humboldt County",2016-10-01,227,42,105,12,386
"3194","Humboldt County",2016-11-01,233,37,103,14,387
"3195","Humboldt County",2016-12-01,221,39,94,15,369
"3196","Humboldt County",2017-01-01,239,34,88,15,376
"3197","Humboldt County",2017-02-01,247,39,93,16,395
"3198","Humboldt County",2017-03-01,238,38,98,21,395
"3199","Humboldt County",2017-04-01,241,36,102,19,398
"3200","Humboldt County",2017-05-01,219,37,116,16,388
"3201","Humboldt County",2017-06-01,220,40,112,15,387
"3202","Humboldt County",2017-07-01,218,42,113,18,391
"3203","Humboldt County",2017-08-01,202,42,131,17,392
"3204","Humboldt County",2017-09-01,230,50,97,14,391
"3205","Humboldt County",2017-10-01,248,43,79,15,385
"3206","Humboldt County",2017-11-01,240,39,87,12,378
"3207","Humboldt County",2017-12-01,230,38,93,15,376
"3208","Humboldt County",2018-01-01,236,43,89,16,384
"3209","Humboldt County",2018-02-01,249,47,88,21,405
"3210","Humboldt County",2018-03-01,231,41,103,25,400
"3211","Humboldt County",2018-04-01,230,37,99,27,393
"3212","Humboldt County",2018-05-01,234,47,101,23,405
"3213","Humboldt County",2018-06-01,246,38,94,18,396
"3214","Humboldt County",2018-07-01,249,41,90,16,396
"3215","Humboldt County",2018-08-01,248,44,91,13,396
"3216","Humboldt County",2018-09-01,234,48,99,15,396
"3217","Humboldt County",2018-10-01,238,50,96,27,411
"3218","Humboldt County",2018-11-01,242,42,90,17,391
"3219","Humboldt County",2018-12-01,233,41,104,20,398
"3220","Humboldt County",2019-01-01,240,40,97,17,394
"3221","Humboldt County",2019-02-01,235,42,90,15,382
"3222","Humboldt County",2019-03-01,236,41,100,16,393
"3223","Humboldt County",2019-04-01,230,41,99,19,389
"3224","Humboldt County",2019-05-01,226,41,103,15,385
"3225","Humboldt County",2019-06-01,233,46,99,16,394
"3226","Humboldt County",2019-07-01,245,44,90,19,398
"3227","Humboldt County",2019-08-01,258,47,84,18,407
"3228","Humboldt County",2019-09-01,249,48,91,19,407
"3229","Humboldt County",2019-10-01,245,42,94,20,401
"3230","Humboldt County",2019-11-01,245,36,90,21,392
"3231","Humboldt County",2019-12-01,242,42,86,18,388
"3232","Humboldt County",2020-01-01,245,45,86,21,397
"3233","Humboldt County",2020-02-01,249,48,85,18,400
"3234","Humboldt County",2020-03-01,223,42,77,15,357
"3235","Imperial County",1995-10-01,305,20,297,15,637
"3236","Imperial County",1995-11-01,297,19,271,15,602
"3237","Imperial County",1995-12-01,265,15,236,12,528
"3238","Imperial County",1996-01-01,313,27,130,8,478
"3239","Imperial County",1996-02-01,323,30,138,7,498
"3240","Imperial County",1996-03-01,330,27,147,5,509
"3241","Imperial County",1996-04-01,326,29,149,7,511
"3242","Imperial County",1996-05-01,332.8,31.2,150.8,5.2,520
"3243","Imperial County",1996-06-01,341.76,32.04,154.86,5.34,534
"3244","Imperial County",1996-07-01,337.92,31.68,153.12,5.28,528
"3245","Imperial County",1996-08-01,329.6,30.9,149.35,5.15,515
"3246","Imperial County",1996-09-01,334.72,31.38,151.67,5.23,523
"3247","Imperial County",1996-10-01,368.64,34.56,167.04,5.76,576
"3248","Imperial County",1996-11-01,341.76,32.04,154.86,5.34,534
"3249","Imperial County",1996-12-01,191,40,264,40,535
"3250","Imperial County",1997-01-01,200,80,187,80,547
"3251","Imperial County",1997-02-01,200,80,144,80,504
"3252","Imperial County",1997-03-01,100,100,159,80,439
"3253","Imperial County",1997-04-01,109.25,109.25,109.25,109.25,437
"3254","Imperial County",1997-05-01,124.25,124.25,124.25,124.25,497
"3255","Imperial County",1997-06-01,126.25,126.25,126.25,126.25,505
"3256","Imperial County",1997-07-01,127.5,127.5,127.5,127.5,510
"3257","Imperial County",1997-08-01,262.5,0,262.5,0,525
"3258","Imperial County",1997-09-01,133.75,133.75,133.75,133.75,535
"3259","Imperial County",1997-10-01,117.75,117.75,117.75,117.75,471
"3260","Imperial County",1997-11-01,124,124,124,124,496
"3261","Imperial County",1997-12-01,133.25,133.25,133.25,133.25,533
"3262","Imperial County",1998-01-01,152.25,152.25,152.25,152.25,609
"3263","Imperial County",1998-02-01,161,161,161,161,644
"3264","Imperial County",1998-03-01,150,150,150,150,600
"3265","Imperial County",1998-04-01,154,154,154,154,616
"3266","Imperial County",1998-05-01,164.75,164.75,164.75,164.75,659
"3267","Imperial County",1998-06-01,166.25,166.25,166.25,166.25,665
"3268","Imperial County",1998-07-01,162.5,162.5,162.5,162.5,650
"3269","Imperial County",1998-08-01,152.25,152.25,152.25,152.25,609
"3270","Imperial County",1998-09-01,149.5,149.5,149.5,149.5,598
"3271","Imperial County",1998-10-01,138.5,138.5,138.5,138.5,554
"3272","Imperial County",1998-11-01,141.25,141.25,141.25,141.25,565
"3273","Imperial County",1998-12-01,136.75,136.75,136.75,136.75,547
"3274","Imperial County",1999-01-01,142,142,142,142,568
"3275","Imperial County",1999-02-01,141,141,141,141,564
"3276","Imperial County",1999-03-01,137.5,137.5,137.5,137.5,550
"3277","Imperial County",1999-04-01,143.25,143.25,143.25,143.25,573
"3278","Imperial County",1999-05-01,148,148,148,148,592
"3279","Imperial County",1999-06-01,159,157,158,157,631
"3280","Imperial County",1999-07-01,162.75,162.75,162.75,162.75,651
"3281","Imperial County",1999-08-01,164.5,164.5,164.5,164.5,658
"3282","Imperial County",1999-09-01,165.5,165.5,165.5,165.5,662
"3283","Imperial County",1999-10-01,138.75,138.75,138.75,138.75,555
"3284","Imperial County",1999-11-01,127.75,127.75,127.75,127.75,511
"3285","Imperial County",1999-12-01,132.75,132.75,132.75,132.75,531
"3286","Imperial County",2000-01-01,150.5,150.5,150.5,150.5,602
"3287","Imperial County",2000-02-01,160.5,160.5,160.5,160.5,642
"3288","Imperial County",2000-03-01,162.5,162.5,162.5,162.5,650
"3289","Imperial County",2000-04-01,164.25,164.25,164.25,164.25,657
"3290","Imperial County",2000-05-01,157.5,157.5,157.5,157.5,630
"3291","Imperial County",2000-06-01,165.5,165.5,165.5,165.5,662
"3292","Imperial County",2000-07-01,161.75,161.75,161.75,161.75,647
"3293","Imperial County",2000-08-01,126,126,126,126,504
"3294","Imperial County",2000-09-01,137,137,137,137,548
"3295","Imperial County",2000-10-01,124.5,124.5,124.5,124.5,498
"3296","Imperial County",2000-11-01,135,135,135,135,540
"3297","Imperial County",2000-12-01,130,130,130,130,520
"3298","Imperial County",2001-01-01,327,19,174,7,527
"3299","Imperial County",2001-02-01,287,19,153,3,462
"3300","Imperial County",2001-03-01,298,16,158,6,478
"3301","Imperial County",2001-04-01,273,16,146,8,443
"3302","Imperial County",2001-05-01,284,17,168,9,478
"3303","Imperial County",2001-06-01,318,21,228,15,582
"3304","Imperial County",2001-07-01,245,32,157,14,448
"3305","Imperial County",2001-08-01,214,30,180,10,434
"3306","Imperial County",2001-09-01,221,31,202,10,464
"3307","Imperial County",2001-10-01,232,33,175,10,450
"3308","Imperial County",2001-11-01,263,25,158,10,456
"3309","Imperial County",2001-12-01,257,14,150,10,431
"3310","Imperial County",2002-01-01,221,25,130,9,385
"3311","Imperial County",2002-02-01,234,36,120,10,400
"3312","Imperial County",2002-03-01,262,28,103,10,403
"3313","Imperial County",2002-04-01,221,12,176,8,417
"3314","Imperial County",2002-05-01,218,11,176,8,413
"3315","Imperial County",2002-06-01,223,24,154,11,412
"3316","Imperial County",2002-07-01,223,24,154,11,412
"3317","Imperial County",2002-08-01,262,32,112,7,413
"3318","Imperial County",2002-09-01,260,32,128,8,428
"3319","Imperial County",2002-10-01,232,36,146,10,424
"3320","Imperial County",2002-11-01,222,33,105,15,375
"3321","Imperial County",2002-12-01,168,57,140,12,377
"3322","Imperial County",2003-01-01,192,30,148,13,383
"3323","Imperial County",2003-02-01,201,34,159,11,405
"3324","Imperial County",2003-03-01,233,35,161,12,441
"3325","Imperial County",2003-04-01,194,36,161,12,403
"3326","Imperial County",2003-05-01,204,31,155,9,399
"3327","Imperial County",2003-06-01,183,36,169,7,395
"3328","Imperial County",2003-07-01,176,30,150,10,366
"3329","Imperial County",2003-08-01,241,32,105,21,399
"3330","Imperial County",2003-09-01,207,24,175,10,416
"3331","Imperial County",2003-10-01,198,24,172,10,404
"3332","Imperial County",2003-11-01,202,27,149,9,387
"3333","Imperial County",2003-12-01,181,23,210,6,420
"3334","Imperial County",2004-01-01,210,21,208,7,446
"3335","Imperial County",2004-02-01,271,27,215,9,522
"3336","Imperial County",2004-03-01,288,17,311,20,636
"3337","Imperial County",2004-04-01,283,29,309,12,633
"3338","Imperial County",2004-05-01,302,31,271,15,619
"3339","Imperial County",2004-06-01,315,30,295,16,656
"3340","Imperial County",2004-07-01,286,31,297,13,627
"3341","Imperial County",2004-08-01,274,41,262,17,594
"3342","Imperial County",2004-09-01,293,37,279,19,628
"3343","Imperial County",2004-10-01,248,31,291,23,593
"3344","Imperial County",2004-11-01,264,32,245,13,554
"3345","Imperial County",2004-12-01,231,27,204,15,477
"3346","Imperial County",2005-01-01,219,23,193,9,444
"3347","Imperial County",2005-02-01,223,44,334,13,614
"3348","Imperial County",2005-03-01,234,37,338,17,626
"3349","Imperial County",2005-04-01,223,35,327,13,598
"3350","Imperial County",2005-05-01,281,42,295,9,627
"3351","Imperial County",2005-06-01,279,35,290,18,622
"3352","Imperial County",2005-07-01,282,37,244,16,579
"3353","Imperial County",2005-08-01,271,33,256,21,581
"3354","Imperial County",2005-09-01,270,38,249,26,583
"3355","Imperial County",2005-10-01,257,41,228,27,553
"3356","Imperial County",2005-11-01,240,39,249,27,555
"3357","Imperial County",2005-12-01,202,40,253,27,522
"3358","Imperial County",2006-01-01,181,49,221,31,482
"3359","Imperial County",2006-02-01,200,42,259,16,517
"3360","Imperial County",2006-03-01,230,32,235,27,524
"3361","Imperial County",2006-04-01,239,41,238,11,529
"3362","Imperial County",2006-05-01,304,27,226,31,588
"3363","Imperial County",2006-06-01,238,51,223,14,526
"3364","Imperial County",2006-07-01,182,36,202,34,454
"3365","Imperial County",2006-08-01,143,32,243,23,441
"3366","Imperial County",2006-09-01,180,24,212,32,448
"3367","Imperial County",2006-10-01,203,18,224,24,469
"3368","Imperial County",2006-11-01,199,21,235,31,486
"3369","Imperial County",2006-12-01,177,33,209,24,443
"3370","Imperial County",2007-01-01,177,30,193,27,427
"3371","Imperial County",2007-02-01,203,28,294,14,539
"3372","Imperial County",2007-03-01,258,30,231,26,545
"3373","Imperial County",2007-04-01,185,36,304,35,560
"3374","Imperial County",2007-05-01,241,32,226,24,523
"3375","Imperial County",2007-06-01,324,41,118,17,500
"3376","Imperial County",2007-07-01,257,34,171,24,486
"3377","Imperial County",2007-08-01,198,21,230,32,481
"3378","Imperial County",2007-09-01,226,25,205,29,485
"3379","Imperial County",2007-10-01,196,32,206,23,457
"3380","Imperial County",2007-11-01,194,41,196,22,453
"3381","Imperial County",2007-12-01,203,36,151,24,414
"3382","Imperial County",2008-01-01,185,31,136,21,373
"3383","Imperial County",2008-02-01,197,22,173,33,425
"3384","Imperial County",2008-03-01,257,24,161,15,457
"3385","Imperial County",2008-04-01,281,40,143,15,479
"3386","Imperial County",2008-05-01,321,39,138,22,520
"3387","Imperial County",2008-06-01,308,37,149,12,506
"3388","Imperial County",2008-07-01,311,36,127,14,488
"3389","Imperial County",2008-08-01,313,48,121,15,497
"3390","Imperial County",2008-09-01,374,45,86,19,524
"3391","Imperial County",2008-10-01,378,49,110,16,553
"3392","Imperial County",2008-11-01,365,59,146,18,588
"3393","Imperial County",2008-12-01,368,58,169,18,613
"3394","Imperial County",2009-01-01,400,45,105,25,575
"3395","Imperial County",2009-02-01,431,57,136,15,639
"3396","Imperial County",2009-03-01,442,47,144,20,653
"3397","Imperial County",2009-04-01,421,44,141,20,626
"3398","Imperial County",2009-05-01,440,35,143,19,637
"3399","Imperial County",2009-06-01,428,30,152,19,629
"3400","Imperial County",2009-07-01,380,34,166,15,595
"3401","Imperial County",2009-08-01,327,29,175,19,550
"3402","Imperial County",2009-09-01,335,30,166,20,551
"3403","Imperial County",2009-10-01,330,35,165,21,551
"3404","Imperial County",2009-11-01,303,30,158,14,505
"3405","Imperial County",2009-12-01,319,24,148,17,508
"3406","Imperial County",2010-01-01,308,27,125,19,479
"3407","Imperial County",2010-02-01,301,29,136,21,487
"3408","Imperial County",2010-03-01,298,22,160,16,496
"3409","Imperial County",2010-04-01,378,24,152,17,571
"3410","Imperial County",2010-05-01,372,30,154,17,573
"3411","Imperial County",2010-06-01,383,33,140,18,574
"3412","Imperial County",2010-07-01,374,25,153,17,569
"3413","Imperial County",2010-08-01,339,24,133,14,510
"3414","Imperial County",2010-09-01,365,29,132,16,542
"3415","Imperial County",2010-10-01,390,32,143,17,582
"3416","Imperial County",2010-11-01,400,36,138,14,588
"3417","Imperial County",2010-12-01,380,38,124,13,555
"3418","Imperial County",2011-01-01,376,42,121,14,553
"3419","Imperial County",2011-02-01,376,41,127,10,554
"3420","Imperial County",2011-03-01,377,41,127,10,555
"3421","Imperial County",2011-04-01,388,46,134,13,581
"3422","Imperial County",2011-05-01,407,44,132,12,595
"3423","Imperial County",2011-06-01,423,46,145,15,629
"3424","Imperial County",2011-07-01,463,44,151,14,672
"3425","Imperial County",2011-08-01,455,41,152,13,661
"3426","Imperial County",2011-09-01,427,40,146,12,625
"3427","Imperial County",2011-10-01,381,36,131,9,557
"3428","Imperial County",2011-11-01,321,50,99,12,482
"3429","Imperial County",2011-12-01,315,46,93,11,465
"3430","Imperial County",2012-01-01,280,38,99,15,432
"3431","Imperial County",2012-02-01,283,37,117,14,451
"3432","Imperial County",2012-03-01,287,35,123,13,458
"3433","Imperial County",2012-04-01,294,31,123,17,465
"3434","Imperial County",2012-05-01,325,31,119,17,492
"3435","Imperial County",2012-06-01,321,29,155,23,528
"3436","Imperial County",2012-07-01,339,33,173,23,568
"3437","Imperial County",2012-08-01,257,28,225,25,535
"3438","Imperial County",2012-09-01,251,26,205,23,505
"3439","Imperial County",2012-10-01,284,30,176,19,509
"3440","Imperial County",2012-11-01,297,33,171,17,518
"3441","Imperial County",2012-12-01,290,33,155,18,496
"3442","Imperial County",2013-01-01,255,25,184,21,485
"3443","Imperial County",2013-02-01,274,24,179,20,497
"3444","Imperial County",2013-03-01,300,29,158,20,507
"3445","Imperial County",2013-04-01,292,28,205,22,547
"3446","Imperial County",2013-05-01,341,41,179,22,583
"3447","Imperial County",2013-06-01,298,35,227,32,592
"3448","Imperial County",2013-07-01,252,31,256,39,578
"3449","Imperial County",2013-08-01,233,35,241,40,549
"3450","Imperial County",2013-09-01,206,31,229,40,506
"3451","Imperial County",2013-10-01,213,31,229,32,505
"3452","Imperial County",2013-11-01,217,28,214,33,492
"3453","Imperial County",2013-12-01,240,29,188,31,488
"3454","Imperial County",2014-01-01,221,24,216,34,495
"3455","Imperial County",2014-02-01,287,31,208,34,560
"3456","Imperial County",2014-03-01,317,41,212,33,603
"3457","Imperial County",2014-04-01,277,39,235,27,578
"3458","Imperial County",2014-05-01,288,47,233,27,595
"3459","Imperial County",2014-06-01,295,43,195,27,560
"3460","Imperial County",2014-07-01,282,37,166,24,509
"3461","Imperial County",2014-08-01,264,30,204,33,531
"3462","Imperial County",2014-09-01,287,39,209,31,566
"3463","Imperial County",2014-10-01,301,36,178,35,550
"3464","Imperial County",2014-11-01,303,33,152,32,520
"3465","Imperial County",2014-12-01,272,27,145,24,468
"3466","Imperial County",2015-01-01,249,31,172,25,477
"3467","Imperial County",2015-02-01,311,37,179,28,555
"3468","Imperial County",2015-03-01,327,30,194,26,577
"3469","Imperial County",2015-04-01,288,30,184,22,524
"3470","Imperial County",2015-05-01,253,24,172,19,468
"3471","Imperial County",2015-06-01,317,35,157,18,527
"3472","Imperial County",2015-07-01,320,39,146,16,521
"3473","Imperial County",2015-08-01,305,44,165,20,534
"3474","Imperial County",2015-09-01,295,44,172,19,530
"3475","Imperial County",2015-10-01,292,43,178,17,530
"3476","Imperial County",2015-11-01,264,37,185,22,508
"3477","Imperial County",2015-12-01,272,38,176,27,513
"3478","Imperial County",2016-01-01,285,39,207,31,562
"3479","Imperial County",2016-02-01,299,39,188,32,558
"3480","Imperial County",2016-03-01,310,43,147,24,524
"3481","Imperial County",2016-04-01,241,35,211,39,526
"3482","Imperial County",2016-05-01,242,35,228,43,548
"3483","Imperial County",2016-06-01,243,33,200,16,492
"3484","Imperial County",2016-07-01,241,35,211,39,526
"3485","Imperial County",2016-08-01,242,30,201,28,501
"3486","Imperial County",2016-09-01,242,33,204,16,495
"3487","Imperial County",2016-10-01,210,28,177,14,429
"3488","Imperial County",2016-11-01,216,29,183,14,442
"3489","Imperial County",2016-12-01,213,28,179,14,434
"3490","Imperial County",2017-01-01,223,28,189,15,455
"3491","Imperial County",2017-02-01,222,30,188,15,455
"3492","Imperial County",2017-03-01,228,30,192,15,465
"3493","Imperial County",2017-04-01,234,30,198,15,477
"3494","Imperial County",2017-05-01,255,34,216,17,522
"3495","Imperial County",2017-06-01,237,31,200,15,483
"3496","Imperial County",2017-07-01,225,30,190,15,460
"3497","Imperial County",2017-08-01,225,30,191,15,461
"3498","Imperial County",2017-09-01,234,30,197,15,476
"3499","Imperial County",2017-10-01,219,28,184,13,444
"3500","Imperial County",2017-11-01,238,31,201,15,485
"3501","Imperial County",2017-12-01,243,31,205,15,494
"3502","Imperial County",2018-01-01,252,33,213,17,515
"3503","Imperial County",2018-02-01,246,31,207,15,499
"3504","Imperial County",2018-03-01,244,31,207,15,497
"3505","Imperial County",2018-04-01,246,33,207,16,502
"3506","Imperial County",2018-05-01,253,33,211,17,514
"3507","Imperial County",2018-06-01,231,30,195,15,471
"3508","Imperial County",2018-07-01,198,27,169,14,408
"3509","Imperial County",2018-08-01,219,30,186,15,450
"3510","Imperial County",2018-09-01,232,31,196,15,474
"3511","Imperial County",2018-10-01,222,31,73,11,337
"3512","Imperial County",2018-11-01,283,64,76,9,432
"3513","Imperial County",2018-12-01,300,63,71,13,447
"3514","Imperial County",2019-01-01,282,62,78,10,432
"3515","Imperial County",2019-02-01,278,61,75,11,425
"3516","Imperial County",2019-03-01,256,54,65,11,386
"3517","Imperial County",2019-04-01,249,56,59,11,375
"3518","Imperial County",2019-05-01,239,49,64,12,364
"3519","Imperial County",2019-06-01,238,47,66,14,365
"3520","Imperial County",2019-07-01,215,46,80,20,361
"3521","Imperial County",2019-08-01,182,38,144,38,402
"3522","Imperial County",2019-09-01,172,32,124,33,361
"3523","Imperial County",2019-10-01,205,35,115,32,387
"3524","Imperial County",2019-11-01,192,35,129,33,389
"3525","Imperial County",2019-12-01,180,38,132,36,386
"3526","Imperial County",2020-01-01,172,34,129,34,369
"3527","Imperial County",2020-02-01,174,34,135,30,373
"3528","Imperial County",2020-03-01,170,26,120,29,345
"3529","Inyo County",1995-10-01,19.1,4.7,26,0.8,50.6
"3530","Inyo County",1995-11-01,20.8,3.8,27.1,2.6,54.3
"3531","Inyo County",1995-12-01,19.8,3,25.5,1.3,49.6
"3532","Inyo County",1996-01-01,16.8,2,33.3,3.5,55.6
"3533","Inyo County",1996-02-01,20.4,2.3,31.7,4,58.4
"3534","Inyo County",1996-03-01,20.4,2.3,28.9,3.3,54.9
"3535","Inyo County",1996-04-01,22.6,1.5,30.7,2.9,57.7
"3536","Inyo County",1996-05-01,17.6,2.1,42,3.1,64.8
"3537","Inyo County",1996-06-01,18.3,1.7,44.9,6.2,71.1
"3538","Inyo County",1996-07-01,22.3,0.6,38.9,9.8,71.6
"3539","Inyo County",1996-08-01,23.8,2.2,41.3,5.6,72.9
"3540","Inyo County",1996-09-01,25.4,2.8,40.4,4.6,73.2
"3541","Inyo County",1996-10-01,22,0.9,28.8,6,57.7
"3542","Inyo County",1996-11-01,17.6,1,36,4.6,59.2
"3543","Inyo County",1996-12-01,16.6,3.9,35.8,5.5,61.8
"3544","Inyo County",1997-01-01,21.5,4.7,33,5,64.2
"3545","Inyo County",1997-02-01,25.5,2,27.8,5,60.3
"3546","Inyo County",1997-03-01,22.1,0,31.6,4.1,57.8
"3547","Inyo County",1997-04-01,21.7,1.2,27.8,4.8,55.5
"3548","Inyo County",1997-05-01,22.7,2.1,28.8,4.9,58.5
"3549","Inyo County",1997-06-01,24.7,3.3,22.5,2.7,53.2
"3550","Inyo County",1997-07-01,28.5,1.4,19.7,5.8,55.4
"3551","Inyo County",1997-08-01,25.2,2.1,26.2,9.5,63
"3552","Inyo County",1997-09-01,23.9,4.2,31.5,9.3,68.9
"3553","Inyo County",1997-10-01,17.5,6.3,39.7,12.2,75.7
"3554","Inyo County",1997-11-01,17.5,3.3,29.7,13.3,63.8
"3555","Inyo County",1997-12-01,21.7,1.2,27.8,4.8,55.5
"3556","Inyo County",1998-01-01,21.8,3.2,40.5,9.8,75.3
"3557","Inyo County",1998-02-01,23.4,5.4,40.4,7.4,76.6
"3558","Inyo County",1998-03-01,26.9,3.5,35.5,8,73.9
"3559","Inyo County",1998-04-01,22.1,1.5,39.2,6.6,69.4
"3560","Inyo County",1998-05-01,23.4,2.7,39.7,7.9,73.7
"3561","Inyo County",1998-06-01,17.2,1.5,41,8.8,68.5
"3562","Inyo County",1998-07-01,20,4,31.1,6.1,61.2
"3563","Inyo County",1998-08-01,26.9,3.5,35.5,8,73.9
"3564","Inyo County",1998-09-01,20.3,1.2,34.2,8.2,63.9
"3565","Inyo County",1998-10-01,18.5,3.6,34.8,8.9,65.8
"3566","Inyo County",1998-11-01,16.2,2,31.6,10,59.8
"3567","Inyo County",1998-12-01,18.5,3.1,28.5,7.8,57.9
"3568","Inyo County",1999-01-01,23.5,4.2,31.6,8.3,67.6
"3569","Inyo County",1999-02-01,19.5,6.3,41.2,10.7,77.7
"3570","Inyo County",1999-03-01,21.7,4.2,38.4,12.6,76.9
"3571","Inyo County",1999-04-01,18.6,5.1,40,12.4,76.1
"3572","Inyo County",1999-05-01,23.8,4,39.2,10.8,77.8
"3573","Inyo County",1999-06-01,22.3,1.7,42.4,8.2,74.6
"3574","Inyo County",1999-07-01,22,3.7,35.1,8,68.8
"3575","Inyo County",1999-08-01,27.5,4.9,32.1,9.5,74
"3576","Inyo County",1999-09-01,26.6,2.3,33.1,10.2,72.2
"3577","Inyo County",1999-10-01,27.2,2.4,30.8,8.4,68.8
"3578","Inyo County",1999-11-01,28.6,1.3,31.8,8.7,70.4
"3579","Inyo County",1999-12-01,21.1,3.8,28.2,6.7,59.8
"3580","Inyo County",2000-01-01,23.7,2.1,26.9,5.6,58.3
"3581","Inyo County",2000-02-01,27.6,4.3,26.9,7.4,66.2
"3582","Inyo County",2000-03-01,27.1,3.5,32.3,6,68.9
"3583","Inyo County",2000-04-01,26.7,3.8,34.8,4.4,69.7
"3584","Inyo County",2000-05-01,25,3.1,33,6.9,68
"3585","Inyo County",2000-06-01,22.4,2.2,32.3,8.6,65.5
"3586","Inyo County",2000-07-01,15.5,4.7,26.7,5.7,52.6
"3587","Inyo County",2000-08-01,18.5,4.6,19.3,4.3,46.7
"3588","Inyo County",2000-09-01,20.2,5,19.9,4.4,49.5
"3589","Inyo County",2000-10-01,18.4,4,22.3,5.7,50.4
"3590","Inyo County",2000-11-01,18.2,3.9,21.8,5.6,49.5
"3591","Inyo County",2000-12-01,22.2,2.7,14,3.3,42.2
"3592","Inyo County",2001-01-01,22,2,22,3,50
"3593","Inyo County",2001-02-01,21,3,30,4,58
"3594","Inyo County",2001-03-01,20,1,27,5,53
"3595","Inyo County",2001-04-01,20,4,24,4,52
"3596","Inyo County",2001-05-01,26,5,20,4,55
"3597","Inyo County",2001-06-01,24,4,22,5,55
"3598","Inyo County",2001-07-01,27,4,25,4,60
"3599","Inyo County",2001-08-01,21,3,18,3,45
"3600","Inyo County",2001-09-01,20,3,19,5,47
"3601","Inyo County",2001-10-01,21,4,16,5,46
"3602","Inyo County",2001-11-01,20,2,15,3,40
"3603","Inyo County",2001-12-01,20,5,12,3,40
"3604","Inyo County",2002-01-01,22,5,14,3,44
"3605","Inyo County",2002-02-01,27,6,22,4,59
"3606","Inyo County",2002-03-01,29,8,25,5,67
"3607","Inyo County",2002-04-01,35,6,27,5,73
"3608","Inyo County",2002-05-01,29,2,26,8,65
"3609","Inyo County",2002-06-01,22,5,29,8,64
"3610","Inyo County",2002-07-01,22,7,28,5,62
"3611","Inyo County",2002-08-01,30,5,32,7,74
"3612","Inyo County",2002-09-01,33,6,34,8,81
"3613","Inyo County",2002-10-01,29,5,34,7,75
"3614","Inyo County",2002-11-01,31,7,38,5,81
"3615","Inyo County",2002-12-01,33,3,34,4,74
"3616","Inyo County",2003-01-01,33,5,38,4,80
"3617","Inyo County",2003-02-01,32,9,38,5,84
"3618","Inyo County",2003-03-01,22,7,36,5,70
"3619","Inyo County",2003-04-01,16,4,40,6,66
"3620","Inyo County",2003-05-01,23,6,33,6,68
"3621","Inyo County",2003-06-01,31,6,29,7,73
"3622","Inyo County",2003-07-01,29,8,29,11,77
"3623","Inyo County",2003-08-01,40,7,29,10,86
"3624","Inyo County",2003-09-01,37,4,33,8,82
"3625","Inyo County",2003-10-01,35,4,31,8,78
"3626","Inyo County",2003-11-01,31,9,38,9,87
"3627","Inyo County",2003-12-01,20,5,31,8,64
"3628","Inyo County",2004-01-01,26,4,38,11,79
"3629","Inyo County",2004-02-01,27,5,38,14,84
"3630","Inyo County",2004-03-01,33,5,32,12,82
"3631","Inyo County",2004-04-01,36,2,31,9,78
"3632","Inyo County",2004-05-01,33,2,26,7,68
"3633","Inyo County",2004-06-01,36,4,30,8,78
"3634","Inyo County",2004-07-01,30,6,38,7,81
"3635","Inyo County",2004-08-01,33,3,33,9,78
"3636","Inyo County",2004-09-01,31,4,34,6,75
"3637","Inyo County",2004-10-01,27,3,39,9,78
"3638","Inyo County",2004-11-01,23,4,43,7,77
"3639","Inyo County",2004-12-01,26,4,38,6,74
"3640","Inyo County",2005-01-01,36,7,36,7,86
"3641","Inyo County",2005-02-01,37,9,32,4,82
"3642","Inyo County",2005-03-01,41,10,33,6,90
"3643","Inyo County",2005-04-01,35,8,39,5,87
"3644","Inyo County",2005-05-01,32,8,34,8,82
"3645","Inyo County",2005-06-01,32,8,37,11,88
"3646","Inyo County",2005-07-01,31,4,38,12,85
"3647","Inyo County",2005-08-01,36,5,33,10,84
"3648","Inyo County",2005-09-01,38,6,35,12,91
"3649","Inyo County",2005-10-01,32,7,41,10,90
"3650","Inyo County",2005-11-01,32,6,40,8,86
"3651","Inyo County",2005-12-01,28,4,40,8,80
"3652","Inyo County",2006-01-01,32,6,41,8,87
"3653","Inyo County",2006-02-01,28,8,46,9,91
"3654","Inyo County",2006-03-01,31,6,45,9,91
"3655","Inyo County",2006-04-01,35,9,39,10,93
"3656","Inyo County",2006-05-01,28,8,45,13,94
"3657","Inyo County",2006-06-01,26,5,46,16,93
"3658","Inyo County",2006-07-01,29,3,46,13,91
"3659","Inyo County",2006-08-01,31,4,43,12,90
"3660","Inyo County",2006-09-01,30,10,38,11,89
"3661","Inyo County",2006-10-01,31,11,43,7,92
"3662","Inyo County",2006-11-01,30,8,42,11,91
"3663","Inyo County",2006-12-01,29,4,40,13,86
"3664","Inyo County",2007-01-01,32,4,35,14,85
"3665","Inyo County",2007-02-01,31,3,40,11,85
"3666","Inyo County",2007-03-01,25,3,38,7,73
"3667","Inyo County",2007-04-01,23,4,40,6,73
"3668","Inyo County",2007-05-01,28,2,36,7,73
"3669","Inyo County",2007-06-01,34,3,36,8,81
"3670","Inyo County",2007-07-01,38,5,36,10,89
"3671","Inyo County",2007-08-01,34,3,43,12,92
"3672","Inyo County",2007-09-01,35,5,37,15,92
"3673","Inyo County",2007-10-01,26,6,43,12,87
"3674","Inyo County",2007-11-01,20,6,52,9,87
"3675","Inyo County",2007-12-01,20,10,46,7,83
"3676","Inyo County",2008-01-01,18,8,40,10,76
"3677","Inyo County",2008-02-01,22,2,37,11,72
"3678","Inyo County",2008-03-01,27,4,37,12,80
"3679","Inyo County",2008-04-01,32,5,42,14,93
"3680","Inyo County",2008-05-01,28,4,34,12,78
"3681","Inyo County",2008-06-01,31,2,29,12,74
"3682","Inyo County",2008-07-01,34,4,33,11,82
"3683","Inyo County",2008-08-01,34,7,35,8,84
"3684","Inyo County",2008-09-01,35,8,37,5,85
"3685","Inyo County",2008-10-01,32,8,34,6,80
"3686","Inyo County",2008-11-01,37,10,34,7,88
"3687","Inyo County",2008-12-01,40,11,31,7,89
"3688","Inyo County",2009-01-01,41,11,40,8,100
"3689","Inyo County",2009-02-01,26,8,43,10,87
"3690","Inyo County",2009-03-01,22,8,47,9,86
"3691","Inyo County",2009-04-01,25,3,44,6,78
"3692","Inyo County",2009-05-01,33,4,44,9,90
"3693","Inyo County",2009-06-01,33,3,44,6,86
"3694","Inyo County",2009-07-01,38,3,35,6,82
"3695","Inyo County",2009-08-01,37,5,36,8,86
"3696","Inyo County",2009-09-01,30,5,32,10,77
"3697","Inyo County",2009-10-01,34,6,33,11,84
"3698","Inyo County",2009-11-01,32,3,34,9,78
"3699","Inyo County",2009-12-01,38,5,23,6,72
"3700","Inyo County",2010-01-01,41,5,31,9,86
"3701","Inyo County",2010-02-01,40,3,31,8,82
"3702","Inyo County",2010-03-01,24,1,28,8,61
"3703","Inyo County",2010-04-01,22,4,31,7,64
"3704","Inyo County",2010-05-01,26,4,34,7,71
"3705","Inyo County",2010-06-01,29,1,36,5,71
"3706","Inyo County",2010-07-01,28,2,28,4,62
"3707","Inyo County",2010-08-01,25,3,29,5,62
"3708","Inyo County",2010-09-01,26,4,35,3,68
"3709","Inyo County",2010-10-01,33,4,27,6,70
"3710","Inyo County",2010-11-01,40,4,25,8,77
"3711","Inyo County",2010-12-01,33,3,29,7,72
"3712","Inyo County",2011-01-01,33,3,29,11,76
"3713","Inyo County",2011-02-01,34,4,29,9,76
"3714","Inyo County",2011-03-01,34,4,32,8,78
"3715","Inyo County",2011-04-01,29,4,34,11,78
"3716","Inyo County",2011-05-01,31,2,36,10,79
"3717","Inyo County",2011-06-01,27,1,32,6,66
"3718","Inyo County",2011-07-01,25,4,25,6,60
"3719","Inyo County",2011-08-01,25,18,18,7,68
"3720","Inyo County",2011-09-01,26,4,17,7,54
"3721","Inyo County",2011-10-01,21,4,22,7,54
"3722","Inyo County",2011-11-01,22,4,24,7,57
"3723","Inyo County",2011-12-01,22,4,21,4,51
"3724","Inyo County",2012-01-01,25,6,24,4,59
"3725","Inyo County",2012-02-01,25,4,27,6,62
"3726","Inyo County",2012-03-01,25,5,28,6,64
"3727","Inyo County",2012-04-01,26,4,33,6,69
"3728","Inyo County",2012-05-01,22,1,31,10,64
"3729","Inyo County",2012-06-01,20,1,31,9,61
"3730","Inyo County",2012-07-01,20,3,31,7,61
"3731","Inyo County",2012-08-01,27,4,34,6,71
"3732","Inyo County",2012-09-01,34,5,32,4,75
"3733","Inyo County",2012-10-01,33,5,31,5,74
"3734","Inyo County",2012-11-01,34,4,29,6,73
"3735","Inyo County",2012-12-01,31,6,33,3,73
"3736","Inyo County",2013-01-01,33,6,33,4,76
"3737","Inyo County",2013-02-01,33,6,31,5,75
"3738","Inyo County",2013-03-01,31,6,30,3,70
"3739","Inyo County",2013-04-01,26,1,37,6,70
"3740","Inyo County",2013-05-01,26,0,41,8,75
"3741","Inyo County",2013-06-01,27,2,39,6,74
"3742","Inyo County",2013-07-01,22,4,35,6,67
"3743","Inyo County",2013-08-01,23,2,34,8,67
"3744","Inyo County",2013-09-01,22,3,41,8,74
"3745","Inyo County",2013-10-01,20,5,36,6,67
"3746","Inyo County",2013-11-01,24,2,35,8,69
"3747","Inyo County",2013-12-01,30,1,35,8,74
"3748","Inyo County",2014-01-01,33,5,34,7,79
"3749","Inyo County",2014-02-01,37,5,29,8,79
"3750","Inyo County",2014-03-01,26,3,37,8,74
"3751","Inyo County",2014-04-01,21,3,35,8,67
"3752","Inyo County",2014-05-01,19,2,35,8,64
"3753","Inyo County",2014-06-01,17,3,37,5,62
"3754","Inyo County",2014-07-01,16,3,31,5,55
"3755","Inyo County",2014-08-01,19,4,33,3,59
"3756","Inyo County",2014-09-01,21,2,35,4,62
"3757","Inyo County",2014-10-01,25,4,30,6,65
"3758","Inyo County",2014-11-01,28,3,27,11,69
"3759","Inyo County",2014-12-01,22,2,30,12,66
"3760","Inyo County",2015-01-01,21,1,32,12,66
"3761","Inyo County",2015-02-01,20,2,37,10,69
"3762","Inyo County",2015-03-01,23,2,40,9,74
"3763","Inyo County",2015-04-01,29,2,37,7,75
"3764","Inyo County",2015-05-01,28,3,32,6,69
"3765","Inyo County",2015-06-01,25,2,34,7,68
"3766","Inyo County",2015-07-01,28,3,35,6,72
"3767","Inyo County",2015-08-01,25,3,30,5,63
"3768","Inyo County",2015-09-01,24,4,34,7,69
"3769","Inyo County",2015-10-01,21,4,34,8,67
"3770","Inyo County",2015-11-01,20,3,32,11,66
"3771","Inyo County",2015-12-01,25,2,27,11,65
"3772","Inyo County",2016-01-01,23,2,32,13,70
"3773","Inyo County",2016-02-01,23,4,34,11,72
"3774","Inyo County",2016-03-01,21,3,33,11,68
"3775","Inyo County",2016-04-01,22,3,36,11,72
"3776","Inyo County",2016-05-01,19,4,39,10,72
"3777","Inyo County",2016-06-01,20,4,38,8,70
"3778","Inyo County",2016-07-01,21,6,30,5,62
"3779","Inyo County",2016-08-01,16,5,28,5,54
"3780","Inyo County",2016-09-01,0,0,0,0,0
"3781","Inyo County",2016-10-01,16,4,27,9,56
"3782","Inyo County",2016-11-01,18,2,21,9,50
"3783","Inyo County",2016-12-01,22,2,20,8,52
"3784","Inyo County",2017-01-01,19,5,24,5,53
"3785","Inyo County",2017-02-01,22,2,28,6,58
"3786","Inyo County",2017-03-01,23,6,27,7,63
"3787","Inyo County",2017-04-01,18,5,27,6,56
"3788","Inyo County",2017-05-01,18,6,26,6,56
"3789","Inyo County",2017-06-01,21,3,23,3,50
"3790","Inyo County",2017-07-01,21,2,20,3,46
"3791","Inyo County",2017-08-01,24,3,29,5,61
"3792","Inyo County",2017-09-01,27,3,30,4,64
"3793","Inyo County",2017-10-01,26,3,31,2,62
"3794","Inyo County",2017-11-01,26,5,25,3,59
"3795","Inyo County",2017-12-01,20,7,21,3,51
"3796","Inyo County",2018-01-01,24,8,23,4,59
"3797","Inyo County",2018-02-01,23,4,21,5,53
"3798","Inyo County",2018-03-01,23,2,21,8,54
"3799","Inyo County",2018-04-01,25,3,21,5,54
"3800","Inyo County",2018-05-01,31,4,22,5,62
"3801","Inyo County",2018-06-01,24,6,23,3,56
"3802","Inyo County",2018-07-01,19,5,21,6,51
"3803","Inyo County",2018-08-01,23,4,20,5,52
"3804","Inyo County",2018-09-01,20,5,20,4,49
"3805","Inyo County",2018-10-01,19,6,21,5,51
"3806","Inyo County",2018-11-01,21,3,19,7,50
"3807","Inyo County",2018-12-01,16,6,18,6,46
"3808","Inyo County",2019-01-01,22,4,14,4,44
"3809","Inyo County",2019-02-01,21,1,12,4,38
"3810","Inyo County",2019-03-01,19,2,13,4,38
"3811","Inyo County",2019-04-01,20,2,16,2,40
"3812","Inyo County",2019-05-01,15,3,23,1,42
"3813","Inyo County",2019-06-01,20,2,20,3,45
"3814","Inyo County",2019-07-01,19,3,20,3,45
"3815","Inyo County",2019-08-01,25,4,18,3,50
"3816","Inyo County",2019-09-01,26,4,20,5,55
"3817","Inyo County",2019-10-01,24,3,24,6,57
"3818","Inyo County",2019-11-01,22,1,20,3,46
"3819","Inyo County",2019-12-01,17,1,18,3,39
"3820","Inyo County",2020-01-01,18,3,19,2,42
"3821","Inyo County",2020-02-01,19,7,16,2,44
"3822","Inyo County",2020-03-01,15,5,18,2,40
"3823","Kern County",1995-10-01,1101,168,658,137,2064
"3824","Kern County",1995-11-01,878,153,886,135,2052
"3825","Kern County",1995-12-01,1062,136,709,129,2036
"3826","Kern County",1996-01-01,1096,130,696,143,2065
"3827","Kern County",1996-02-01,1095,120,689,151,2055
"3828","Kern County",1996-03-01,1040,123,689,181,2033
"3829","Kern County",1996-04-01,1302,200,446,116,2064
"3830","Kern County",1996-05-01,1285,190,480,108,2063
"3831","Kern County",1996-06-01,1290,190,457,107,2044
"3832","Kern County",1996-07-01,1280,185,455,119,2039
"3833","Kern County",1996-08-01,1283,184,454,119,2040
"3834","Kern County",1996-09-01,1291,160,491,110,2052
"3835","Kern County",1996-10-01,1300,248,424,130,2102
"3836","Kern County",1996-11-01,1299,245,424,128,2096
"3837","Kern County",1996-12-01,1280,250,447,131,2108
"3838","Kern County",1997-01-01,1304,195,445,111,2055
"3839","Kern County",1997-02-01,1302,202,428,124,2056
"3840","Kern County",1997-03-01,1308,206,429,124,2067
"3841","Kern County",1997-04-01,1304,208,430,126,2068
"3842","Kern County",1997-05-01,1312,208,434,126,2080
"3843","Kern County",1997-06-01,1325,208,439,126,2098
"3844","Kern County",1997-07-01,1279,190,426,122,2017
"3845","Kern County",1997-08-01,1270,200,424,124,2018
"3846","Kern County",1997-09-01,1286,187,428,124,2025
"3847","Kern County",1997-10-01,1280,190,426,122,2018
"3848","Kern County",1997-11-01,1270,201,426,125,2022
"3849","Kern County",1997-12-01,1253,175,418,124,1970
"3850","Kern County",1998-01-01,1285,190,433,122,2030
"3851","Kern County",1998-02-01,1276,188,424,122,2010
"3852","Kern County",1998-03-01,1287,190,434,127,2038
"3853","Kern County",1998-04-01,1282,185,422,124,2013
"3854","Kern County",1998-05-01,1305,190,437,126,2058
"3855","Kern County",1998-06-01,1312,195,445,131,2083
"3856","Kern County",1998-07-01,1278,188,437,125,2028
"3857","Kern County",1998-08-01,1277,186,439,127,2029
"3858","Kern County",1998-09-01,1275,157,441,124,1997
"3859","Kern County",1998-10-01,988,176,776,142,2082
"3860","Kern County",1998-11-01,978,184,755,146,2063
"3861","Kern County",1998-12-01,931,172,724,137,1964
"3862","Kern County",1999-01-01,988,176,776,142,2082
"3863","Kern County",1999-02-01,978,184,755,146,2063
"3864","Kern County",1999-03-01,931,172,724,137,1964
"3865","Kern County",1999-04-01,1169,130,537,199,2035
"3866","Kern County",1999-05-01,1147,126,514,196,1983
"3867","Kern County",1999-06-01,1179,125,514,201,2019
"3868","Kern County",1999-07-01,1154,140,489,181,1964
"3869","Kern County",1999-08-01,1162,147,494,176,1979
"3870","Kern County",1999-09-01,1177,141,506,174,1998
"3871","Kern County",1999-10-01,1188,137,505,176,2006
"3872","Kern County",1999-11-01,1160,136,490,174,1960
"3873","Kern County",1999-12-01,1130,136,475,175,1916
"3874","Kern County",2000-01-01,1149,150,467,174,1940
"3875","Kern County",2000-02-01,1173,130,489,184,1976
"3876","Kern County",2000-03-01,1188,146,502,212,2048
"3877","Kern County",2000-04-01,1171,160,500,225,2056
"3878","Kern County",2000-05-01,1177,154,503,220,2054
"3879","Kern County",2000-06-01,1154,145,503,214,2016
"3880","Kern County",2000-07-01,1218,149,516,214,2097
"3881","Kern County",2000-08-01,1249,145,519,215,2128
"3882","Kern County",2000-09-01,1218,143,513,211,2085
"3883","Kern County",2000-10-01,1202,137,510,208,2057
"3884","Kern County",2000-11-01,1192,143,504,210,2049
"3885","Kern County",2000-12-01,1179,134,499,205,2017
"3886","Kern County",2001-01-01,1199,135,513,203,2050
"3887","Kern County",2001-02-01,1172,140,507,207,2026
"3888","Kern County",2001-03-01,1188,139,509,207,2043
"3889","Kern County",2001-04-01,1416,153,518,212,2299
"3890","Kern County",2001-05-01,1397,157,521,210,2285
"3891","Kern County",2001-06-01,1411,153,525,210,2299
"3892","Kern County",2001-07-01,1419,168,499,204,2290
"3893","Kern County",2001-08-01,1236,151,600,168,2155
"3894","Kern County",2001-09-01,1394,131,499,193,2217
"3895","Kern County",2001-10-01,1378,127,489,190,2184
"3896","Kern County",2001-11-01,1371,222,495,101,2189
"3897","Kern County",2001-12-01,1263,221,514,120,2118
"3898","Kern County",2002-01-01,1175,178,665,147,2165
"3899","Kern County",2002-02-01,1145,186,641,148,2120
"3900","Kern County",2002-03-01,1157,188,646,141,2132
"3901","Kern County",2002-04-01,1211,206,650,141,2208
"3902","Kern County",2002-05-01,1144,193,695,164,2196
"3903","Kern County",2002-06-01,1094,183,732,172,2181
"3904","Kern County",2002-07-01,1243,195,639,166,2243
"3905","Kern County",2002-08-01,1257,206,622,162,2247
"3906","Kern County",2002-09-01,1276,195,599,168,2238
"3907","Kern County",2002-10-01,1258,164,642,186,2250
"3908","Kern County",2002-11-01,1219,174,645,182,2220
"3909","Kern County",2002-12-01,1223,173,635,178,2209
"3910","Kern County",2003-01-01,1250,181,606,170,2207
"3911","Kern County",2003-02-01,1197,170,640,176,2183
"3912","Kern County",2003-03-01,1237,188,632,165,2222
"3913","Kern County",2003-04-01,1262,195,611,155,2223
"3914","Kern County",2003-05-01,1292,207,568,143,2210
"3915","Kern County",2003-06-01,1282,196,565,156,2199
"3916","Kern County",2003-07-01,1334,205,546,151,2236
"3917","Kern County",2003-08-01,1281,198,608,154,2241
"3918","Kern County",2003-09-01,1325,204,563,146,2238
"3919","Kern County",2003-10-01,1289,195,577,162,2223
"3920","Kern County",2003-11-01,1187,163,643,179,2172
"3921","Kern County",2003-12-01,1139,167,681,165,2152
"3922","Kern County",2004-01-01,1229,176,628,159,2192
"3923","Kern County",2004-02-01,1327,182,537,163,2209
"3924","Kern County",2004-03-01,1281,174,567,166,2188
"3925","Kern County",2004-04-01,1257,181,584,140,2162
"3926","Kern County",2004-05-01,1212,187,606,131,2136
"3927","Kern County",2004-06-01,1245,175,568,151,2139
"3928","Kern County",2004-07-01,1238,188,562,149,2137
"3929","Kern County",2004-08-01,1237,186,606,151,2180
"3930","Kern County",2004-09-01,1303,186,561,148,2198
"3931","Kern County",2004-10-01,1340,175,571,152,2238
"3932","Kern County",2004-11-01,1320,158,582,157,2217
"3933","Kern County",2004-12-01,1320,155,558,152,2185
"3934","Kern County",2005-01-01,1384,172,532,135,2223
"3935","Kern County",2005-02-01,1423,185,503,122,2233
"3936","Kern County",2005-03-01,1421,185,484,125,2215
"3937","Kern County",2005-04-01,1435,211,490,110,2246
"3938","Kern County",2005-05-01,1393,196,489,120,2198
"3939","Kern County",2005-06-01,1508,198,458,113,2277
"3940","Kern County",2005-07-01,1536,209,468,111,2324
"3941","Kern County",2005-08-01,1431,208,497,118,2254
"3942","Kern County",2005-09-01,1449,214,466,130,2259
"3943","Kern County",2005-10-01,1423,187,459,152,2221
"3944","Kern County",2005-11-01,1414,181,471,156,2222
"3945","Kern County",2005-12-01,1323,179,542,152,2196
"3946","Kern County",2006-01-01,1364,206,523,139,2232
"3947","Kern County",2006-02-01,1359,203,535,140,2237
"3948","Kern County",2006-03-01,1348,191,537,148,2224
"3949","Kern County",2006-04-01,1504,197,463,146,2310
"3950","Kern County",2006-05-01,1458,205,472,140,2275
"3951","Kern County",2006-06-01,1440,196,502,140,2278
"3952","Kern County",2006-07-01,1465,191,477,144,2277
"3953","Kern County",2006-08-01,1481,212,442,127,2262
"3954","Kern County",2006-09-01,1496,227,425,120,2268
"3955","Kern County",2006-10-01,1558,225,424,117,2324
"3956","Kern County",2006-11-01,1525,219,413,117,2274
"3957","Kern County",2006-12-01,1516,208,419,125,2268
"3958","Kern County",2007-01-01,1522,222,417,125,2286
"3959","Kern County",2007-02-01,1599,207,386,116,2308
"3960","Kern County",2007-03-01,1687,214,306,117,2324
"3961","Kern County",2007-04-01,1637,219,341,97,2294
"3962","Kern County",2007-05-01,1663,226,333,90,2312
"3963","Kern County",2007-06-01,1635,230,344,79,2288
"3964","Kern County",2007-07-01,1538,223,409,94,2264
"3965","Kern County",2007-08-01,1542,235,406,78,2261
"3966","Kern County",2007-09-01,1585,251,376,74,2286
"3967","Kern County",2007-10-01,1491,227,454,111,2283
"3968","Kern County",2007-11-01,1547,229,414,105,2295
"3969","Kern County",2007-12-01,1573,209,362,119,2263
"3970","Kern County",2008-01-01,1631,228,323,111,2293
"3971","Kern County",2008-02-01,1583,217,353,121,2274
"3972","Kern County",2008-03-01,1542,206,377,126,2251
"3973","Kern County",2008-04-01,1633,233,333,110,2309
"3974","Kern County",2008-05-01,1676,225,318,110,2329
"3975","Kern County",2008-06-01,1640,233,336,106,2315
"3976","Kern County",2008-07-01,1596,218,328,112,2254
"3977","Kern County",2008-08-01,1633,217,350,116,2316
"3978","Kern County",2008-09-01,1665,226,327,117,2335
"3979","Kern County",2008-10-01,1676,243,304,100,2323
"3980","Kern County",2008-11-01,1632,210,327,118,2287
"3981","Kern County",2008-12-01,1521,194,434,140,2289
"3982","Kern County",2009-01-01,1516,210,451,134,2311
"3983","Kern County",2009-02-01,1482,207,410,118,2217
"3984","Kern County",2009-03-01,1515,219,425,118,2277
"3985","Kern County",2009-04-01,1600,207,364,121,2292
"3986","Kern County",2009-05-01,1611,204,342,125,2282
"3987","Kern County",2009-06-01,1588,205,345,123,2261
"3988","Kern County",2009-07-01,1589,222,339,113,2263
"3989","Kern County",2009-08-01,1590,214,369,119,2292
"3990","Kern County",2009-09-01,1587,220,382,121,2310
"3991","Kern County",2009-10-01,1526,208,398,130,2262
"3992","Kern County",2009-11-01,1543,200,408,129,2280
"3993","Kern County",2009-12-01,1523,192,430,140,2285
"3994","Kern County",2010-01-01,1518,171,448,152,2289
"3995","Kern County",2010-02-01,1558,160,425,113,2256
"3996","Kern County",2010-03-01,1651,183,378,91,2303
"3997","Kern County",2010-04-01,1644,191,336,78,2249
"3998","Kern County",2010-05-01,1682,187,330,79,2278
"3999","Kern County",2010-06-01,1790,185,278,83,2336
"4000","Kern County",2010-07-01,1852,186,236,86,2360
"4001","Kern County",2010-08-01,1848,197,238,86,2369
"4002","Kern County",2010-09-01,1810,203,266,75,2354
"4003","Kern County",2010-10-01,1788,189,315,87,2379
"4004","Kern County",2010-11-01,1746,193,303,80,2322
"4005","Kern County",2010-12-01,1701,189,344,79,2313
"4006","Kern County",2011-01-01,1739,190,351,85,2365
"4007","Kern County",2011-02-01,1781,178,335,87,2381
"4008","Kern County",2011-03-01,1763,185,317,87,2352
"4009","Kern County",2011-04-01,1756,200,324,78,2358
"4010","Kern County",2011-05-01,1726,196,343,81,2346
"4011","Kern County",2011-06-01,1773,193,317,88,2371
"4012","Kern County",2011-07-01,1805,217,297,71,2390
"4013","Kern County",2011-08-01,1862,219,267,60,2408
"4014","Kern County",2011-09-01,1829,199,290,76,2394
"4015","Kern County",2011-10-01,1778,191,368,85,2422
"4016","Kern County",2011-11-01,1713,188,464,87,2452
"4017","Kern County",2011-12-01,1615,172,577,92,2456
"4018","Kern County",2012-01-01,1660,161,575,108,2504
"4019","Kern County",2012-02-01,1628,155,617,112,2512
"4020","Kern County",2012-03-01,1594,164,650,108,2516
"4021","Kern County",2012-04-01,1627,171,633,98,2529
"4022","Kern County",2012-05-01,1669,188,611,95,2563
"4023","Kern County",2012-06-01,1741,213,539,76,2569
"4024","Kern County",2012-07-01,1715,202,596,95,2608
"4025","Kern County",2012-08-01,1729,182,573,118,2602
"4026","Kern County",2012-09-01,1761,191,555,109,2616
"4027","Kern County",2012-10-01,1795,200,528,104,2627
"4028","Kern County",2012-11-01,1810,201,524,103,2638
"4029","Kern County",2012-12-01,1825,204,474,90,2593
"4030","Kern County",2013-01-01,1846,202,472,93,2613
"4031","Kern County",2013-02-01,1861,220,471,80,2632
"4032","Kern County",2013-03-01,1839,227,482,81,2629
"4033","Kern County",2013-04-01,1824,231,511,77,2643
"4034","Kern County",2013-05-01,1781,231,520,74,2606
"4035","Kern County",2013-06-01,1771,234,531,72,2608
"4036","Kern County",2013-07-01,1775,231,488,73,2567
"4037","Kern County",2013-08-01,1748,229,461,62,2500
"4038","Kern County",2013-09-01,1661,203,652,91,2607
"4039","Kern County",2013-10-01,1549,215,756,95,2615
"4040","Kern County",2013-11-01,1567,190,722,115,2594
"4041","Kern County",2013-12-01,1516,176,721,122,2535
"4042","Kern County",2014-01-01,1449,197,830,112,2588
"4043","Kern County",2014-02-01,1466,206,786,96,2554
"4044","Kern County",2014-03-01,1484,197,763,110,2554
"4045","Kern County",2014-04-01,1497,184,762,117,2560
"4046","Kern County",2014-05-01,1509,188,749,120,2566
"4047","Kern County",2014-06-01,1586,218,684,94,2582
"4048","Kern County",2014-07-01,1508,227,761,84,2580
"4049","Kern County",2014-08-01,1489,219,786,94,2588
"4050","Kern County",2014-09-01,1478,216,799,99,2592
"4051","Kern County",2014-10-01,1463,206,818,100,2587
"4052","Kern County",2014-11-01,1400,197,833,111,2541
"4053","Kern County",2014-12-01,1211,155,977,139,2482
"4054","Kern County",2015-01-01,1224,158,947,139,2468
"4055","Kern County",2015-02-01,1249,166,900,120,2435
"4056","Kern County",2015-03-01,1235,156,844,127,2362
"4057","Kern County",2015-04-01,1159,156,814,112,2241
"4058","Kern County",2015-05-01,1203,151,798,104,2256
"4059","Kern County",2015-06-01,1218,154,752,125,2249
"4060","Kern County",2015-07-01,1241,173,804,127,2345
"4061","Kern County",2015-08-01,1228,181,858,121,2388
"4062","Kern County",2015-09-01,1238,182,838,127,2385
"4063","Kern County",2015-10-01,1318,171,767,134,2390
"4064","Kern County",2015-11-01,1344,156,789,138,2427
"4065","Kern County",2015-12-01,1288,147,750,124,2309
"4066","Kern County",2016-01-01,1247,150,710,121,2228
"4067","Kern County",2016-02-01,1263,151,676,58,2148
"4068","Kern County",2016-03-01,1271,160,665,121,2217
"4069","Kern County",2016-04-01,1286,170,731,120,2307
"4070","Kern County",2016-05-01,1307,181,741,120,2349
"4071","Kern County",2016-06-01,1241,144,768,126,2279
"4072","Kern County",2016-07-01,1382,174,711,106,2373
"4073","Kern County",2016-08-01,1399,183,649,90,2321
"4074","Kern County",2016-09-01,1365,184,585,74,2208
"4075","Kern County",2016-10-01,1359,168,594,91,2212
"4076","Kern County",2016-11-01,1424,167,546,83,2220
"4077","Kern County",2016-12-01,1305,163,586,101,2155
"4078","Kern County",2017-01-01,1267,156,604,107,2134
"4079","Kern County",2017-02-01,1273,167,624,99,2163
"4080","Kern County",2017-03-01,1304,175,606,91,2176
"4081","Kern County",2017-04-01,1303,183,623,83,2192
"4082","Kern County",2017-05-01,1268,189,625,68,2150
"4083","Kern County",2017-06-01,1253,181,592,83,2109
"4084","Kern County",2017-07-01,1265,206,576,83,2130
"4085","Kern County",2017-08-01,1260,186,591,75,2112
"4086","Kern County",2017-09-01,1230,175,587,91,2083
"4087","Kern County",2017-10-01,1228,183,578,83,2072
"4088","Kern County",2017-11-01,1216,208,587,77,2088
"4089","Kern County",2017-12-01,1157,179,569,77,1982
"4090","Kern County",2018-01-01,1162,174,572,90,1998
"4091","Kern County",2018-02-01,1213,182,573,75,2043
"4092","Kern County",2018-03-01,1222,184,559,79,2044
"4093","Kern County",2018-04-01,1233,181,540,79,2033
"4094","Kern County",2018-05-01,1475,185,335,77,2072
"4095","Kern County",2018-06-01,1473,201,226,87,1987
"4096","Kern County",2018-07-01,1448,212,215,60,1935
"4097","Kern County",2018-08-01,1466,210,250,47,1973
"4098","Kern County",2018-09-01,1462,203,239,48,1952
"4099","Kern County",2018-10-01,1481,200,249,53,1983
"4100","Kern County",2018-11-01,1459,186,196,61,1902
"4101","Kern County",2018-12-01,1413,199,318,47,1977
"4102","Kern County",2019-01-01,1512,208,214,34,1968
"4103","Kern County",2019-02-01,1476,216,192,18,1902
"4104","Kern County",2019-03-01,1517,220,184,16,1937
"4105","Kern County",2019-04-01,1537,215,181,19,1952
"4106","Kern County",2019-05-01,1492,200,229,27,1948
"4107","Kern County",2019-06-01,1490,198,228,33,1949
"4108","Kern County",2019-07-01,1440,190,260,38,1928
"4109","Kern County",2019-08-01,1458,205,249,29,1941
"4110","Kern County",2019-09-01,1484,213,198,15,1910
"4111","Kern County",2019-10-01,1495,194,201,28,1918
"4112","Kern County",2019-11-01,1475,204,145,27,1851
"4113","Kern County",2019-12-01,1494,191,130,34,1849
"4114","Kern County",2020-01-01,1538,201,108,32,1879
"4115","Kern County",2020-02-01,1512,205,124,21,1862
"4116","Kern County",2020-03-01,1414,183,110,11,1718
"4117","Kings County",1995-10-01,126,14,142,23,305
"4118","Kings County",1995-11-01,136,17,135,19,307
"4119","Kings County",1995-12-01,136,12,115,23,286
"4120","Kings County",1996-01-01,182,17,103,17,319
"4121","Kings County",1996-02-01,161,17,130,18,326
"4122","Kings County",1996-03-01,163,16,122,19,320
"4123","Kings County",1996-04-01,155,14,124,18,311
"4124","Kings County",1996-05-01,151,10,127,19,307
"4125","Kings County",1996-06-01,169,15,124,19,327
"4126","Kings County",1996-07-01,155,15,155,18,343
"4127","Kings County",1996-08-01,158,26,140,20,344
"4128","Kings County",1996-09-01,188,10,133,22,353
"4129","Kings County",1996-10-01,156,20,135,24,335
"4130","Kings County",1996-11-01,148,24,141,27,340
"4131","Kings County",1996-12-01,148,24,141,27,340
"4132","Kings County",1997-01-01,146,16,147,25,334
"4133","Kings County",1997-02-01,161,19,152,20,352
"4134","Kings County",1997-03-01,180,16,127,17,340
"4135","Kings County",1997-04-01,146,16,147,25,334
"4136","Kings County",1997-05-01,161,19,152,20,352
"4137","Kings County",1997-06-01,180,16,127,17,340
"4138","Kings County",1997-07-01,188,18,123,16,345
"4139","Kings County",1997-08-01,188,18,123,16,345
"4140","Kings County",1997-09-01,188,18,123,16,345
"4141","Kings County",1997-10-01,85,14,193,28,320
"4142","Kings County",1997-11-01,165,16,123,20,324
"4143","Kings County",1997-12-01,133,22,143,23,321
"4144","Kings County",1998-01-01,133,18,150,33,334
"4145","Kings County",1998-02-01,153,23,135,36,347
"4146","Kings County",1998-03-01,92,13,189,36,330
"4147","Kings County",1998-04-01,160,27,121,18,326
"4148","Kings County",1998-05-01,147,25,146,23,341
"4149","Kings County",1998-06-01,139,26,155,29,349
"4150","Kings County",1998-07-01,83,13,217,38,351
"4151","Kings County",1998-08-01,132,23,150,25,330
"4152","Kings County",1998-09-01,73,10,197,33,313
"4153","Kings County",1998-10-01,75,11,192,39,317
"4154","Kings County",1998-11-01,58,8,199,46,311
"4155","Kings County",1998-12-01,66,7,190,35,298
"4156","Kings County",1999-01-01,113,9,153,23,298
"4157","Kings County",1999-02-01,64,7,210,27,308
"4158","Kings County",1999-03-01,92,4,197,33,326
"4159","Kings County",1999-04-01,80,12,193,33,318
"4160","Kings County",1999-05-01,71,10,215,33,329
"4161","Kings County",1999-06-01,122,16,161,27,326
"4162","Kings County",1999-07-01,84,4,202,41,331
"4163","Kings County",1999-08-01,90,7,217,25,339
"4164","Kings County",1999-09-01,100,12,216,27,355
"4165","Kings County",1999-10-01,82,13,213,34,342
"4166","Kings County",1999-11-01,87,14,221,32,354
"4167","Kings County",1999-12-01,130,10,170,37,347
"4168","Kings County",2000-01-01,126,16,160,42,344
"4169","Kings County",2000-02-01,121,13,182,35,351
"4170","Kings County",2000-03-01,142,21,180,44,387
"4171","Kings County",2000-04-01,153,23,149,39,364
"4172","Kings County",2000-05-01,126,13,202,50,391
"4173","Kings County",2000-06-01,119,14,234,43,410
"4174","Kings County",2000-07-01,174,25,152,25,376
"4175","Kings County",2000-08-01,175,24,173,30,402
"4176","Kings County",2000-09-01,111,7,234,48,400
"4177","Kings County",2000-10-01,69,12,256,32,369
"4178","Kings County",2000-11-01,76,10,233,46,365
"4179","Kings County",2000-12-01,63,9,219,42,333
"4180","Kings County",2001-01-01,124,24,120,30,298
"4181","Kings County",2001-02-01,129,28,125,38,320
"4182","Kings County",2001-03-01,111,22,147,43,323
"4183","Kings County",2001-04-01,127,27,122,37,313
"4184","Kings County",2001-05-01,99,17,176,51,343
"4185","Kings County",2001-06-01,119,21,146,28,314
"4186","Kings County",2001-07-01,108,18,152,28,306
"4187","Kings County",2001-08-01,120,13,144,27,304
"4188","Kings County",2001-09-01,142,6,121,25,294
"4189","Kings County",2001-10-01,114,9,138,32,293
"4190","Kings County",2001-11-01,92,7,162,34,295
"4191","Kings County",2001-12-01,154,20,133,21,328
"4192","Kings County",2002-01-01,85,7,184,32,308
"4193","Kings County",2002-02-01,85,7,184,32,308
"4194","Kings County",2002-03-01,74,6,208,30,318
"4195","Kings County",2002-04-01,117,16,147,26,306
"4196","Kings County",2002-05-01,129,15,151,29,324
"4197","Kings County",2002-06-01,94,16,188,31,329
"4198","Kings County",2002-07-01,93,17,168,27,305
"4199","Kings County",2002-08-01,107,13,140,26,286
"4200","Kings County",2002-09-01,104,12,147,29,292
"4201","Kings County",2002-10-01,117,17,147,21,302
"4202","Kings County",2002-11-01,122,16,134,23,295
"4203","Kings County",2002-12-01,123,15,122,22,282
"4204","Kings County",2003-01-01,137,16,108,27,288
"4205","Kings County",2003-02-01,121,15,147,26,309
"4206","Kings County",2003-03-01,96,17,156,27,296
"4207","Kings County",2003-04-01,79,13,166,26,284
"4208","Kings County",2003-05-01,103,15,145,29,292
"4209","Kings County",2003-06-01,91,14,168,27,300
"4210","Kings County",2003-07-01,96,12,150,29,287
"4211","Kings County",2003-08-01,123,19,130,23,295
"4212","Kings County",2003-09-01,121,19,149,25,314
"4213","Kings County",2003-10-01,109,17,141,23,290
"4214","Kings County",2003-11-01,127,16,122,24,289
"4215","Kings County",2003-12-01,138,15,123,21,297
"4216","Kings County",2004-01-01,118,13,128,29,288
"4217","Kings County",2004-02-01,124,19,114,21,278
"4218","Kings County",2004-03-01,115,17,123,23,278
"4219","Kings County",2004-04-01,105,18,133,26,282
"4220","Kings County",2004-05-01,108,21,137,22,288
"4221","Kings County",2004-06-01,105,18,138,30,291
"4222","Kings County",2004-07-01,107,16,145,25,293
"4223","Kings County",2004-08-01,100,11,151,32,294
"4224","Kings County",2004-09-01,99,15,144,30,288
"4225","Kings County",2004-10-01,93,9,129,31,262
"4226","Kings County",2004-11-01,121,15,124,25,285
"4227","Kings County",2004-12-01,123,16,116,25,280
"4228","Kings County",2005-01-01,109,17,140,27,293
"4229","Kings County",2005-02-01,117,19,139,24,299
"4230","Kings County",2005-03-01,131,20,124,24,299
"4231","Kings County",2005-04-01,130,15,118,28,291
"4232","Kings County",2005-05-01,123,15,122,25,285
"4233","Kings County",2005-06-01,118,19,132,27,296
"4234","Kings County",2005-07-01,126,27,115,23,291
"4235","Kings County",2005-08-01,129,22,127,32,310
"4236","Kings County",2005-09-01,137,21,129,33,320
"4237","Kings County",2005-10-01,141,19,118,27,305
"4238","Kings County",2005-11-01,152,13,113,35,313
"4239","Kings County",2005-12-01,154,18,122,25,319
"4240","Kings County",2006-01-01,145,17,121,29,312
"4241","Kings County",2006-02-01,140,12,112,32,296
"4242","Kings County",2006-03-01,132,16,134,30,312
"4243","Kings County",2006-04-01,141,17,115,28,301
"4244","Kings County",2006-05-01,128,20,126,28,302
"4245","Kings County",2006-06-01,126,18,123,27,294
"4246","Kings County",2006-07-01,120,19,136,26,301
"4247","Kings County",2006-08-01,121,19,139,25,304
"4248","Kings County",2006-09-01,128,15,127,30,300
"4249","Kings County",2006-10-01,131,17,130,29,307
"4250","Kings County",2006-11-01,125,11,96,20,252
"4251","Kings County",2006-12-01,140,17,123,23,303
"4252","Kings County",2007-01-01,137,14,122,31,304
"4253","Kings County",2007-02-01,139,14,126,31,310
"4254","Kings County",2007-03-01,128,17,146,30,321
"4255","Kings County",2007-04-01,142,13,131,39,325
"4256","Kings County",2007-05-01,145,16,134,29,324
"4257","Kings County",2007-06-01,141,17,135,30,323
"4258","Kings County",2007-07-01,131,24,146,37,338
"4259","Kings County",2007-08-01,134,28,159,44,365
"4260","Kings County",2007-09-01,157,31,142,43,373
"4261","Kings County",2007-10-01,146,28,148,39,361
"4262","Kings County",2007-11-01,147,22,137,43,349
"4263","Kings County",2007-12-01,160,26,128,37,351
"4264","Kings County",2008-01-01,148,24,138,38,348
"4265","Kings County",2008-02-01,158,25,134,36,353
"4266","Kings County",2008-03-01,157,23,134,37,351
"4267","Kings County",2008-04-01,176,24,124,35,359
"4268","Kings County",2008-05-01,195,21,113,35,364
"4269","Kings County",2008-06-01,194,21,108,38,361
"4270","Kings County",2008-07-01,195,28,108,29,360
"4271","Kings County",2008-08-01,195,27,107,30,359
"4272","Kings County",2008-09-01,189,26,112,29,356
"4273","Kings County",2008-10-01,195,24,113,30,362
"4274","Kings County",2008-11-01,194,33,108,27,362
"4275","Kings County",2008-12-01,200,33,98,27,358
"4276","Kings County",2009-01-01,193,28,109,30,360
"4277","Kings County",2009-02-01,185,30,114,27,356
"4278","Kings County",2009-03-01,197,28,103,31,359
"4279","Kings County",2009-04-01,189,32,112,27,360
"4280","Kings County",2009-05-01,187,34,108,27,356
"4281","Kings County",2009-06-01,191,31,107,28,357
"4282","Kings County",2009-07-01,175,26,119,34,354
"4283","Kings County",2009-08-01,188,23,105,37,353
"4284","Kings County",2009-09-01,194,17,110,36,357
"4285","Kings County",2009-10-01,185,19,113,36,353
"4286","Kings County",2009-11-01,198,16,110,29,353
"4287","Kings County",2009-12-01,198,21,108,24,351
"4288","Kings County",2010-01-01,190,22,114,31,357
"4289","Kings County",2010-02-01,188,30,105,27,350
"4290","Kings County",2010-03-01,181,24,105,28,338
"4291","Kings County",2010-04-01,178,27,110,31,346
"4292","Kings County",2010-05-01,186,22,106,36,350
"4293","Kings County",2010-06-01,202,27,103,33,365
"4294","Kings County",2010-07-01,215,23,89,30,357
"4295","Kings County",2010-08-01,211,23,94,34,362
"4296","Kings County",2010-09-01,209,21,99,36,365
"4297","Kings County",2010-10-01,181,24,124,27,356
"4298","Kings County",2010-11-01,180,21,115,36,352
"4299","Kings County",2010-12-01,172,17,113,34,336
"4300","Kings County",2011-01-01,153,11,116,36,316
"4301","Kings County",2011-02-01,150,16,123,32,321
"4302","Kings County",2011-03-01,157,14,131,31,333
"4303","Kings County",2011-04-01,162,17,124,33,336
"4304","Kings County",2011-05-01,153,14,126,38,331
"4305","Kings County",2011-06-01,149,18,127,37,331
"4306","Kings County",2011-07-01,179,20,111,35,345
"4307","Kings County",2011-08-01,185,20,132,35,372
"4308","Kings County",2011-09-01,188,23,139,37,387
"4309","Kings County",2011-10-01,202,19,137,41,399
"4310","Kings County",2011-11-01,205,16,163,37,421
"4311","Kings County",2011-12-01,228,24,148,33,433
"4312","Kings County",2012-01-01,230,24,157,37,448
"4313","Kings County",2012-02-01,246,29,173,38,486
"4314","Kings County",2012-03-01,227,22,194,38,481
"4315","Kings County",2012-04-01,230,20,191,45,486
"4316","Kings County",2012-05-01,239,20,186,46,491
"4317","Kings County",2012-06-01,231,29,179,41,480
"4318","Kings County",2012-07-01,253,28,186,44,511
"4319","Kings County",2012-08-01,238,26,191,45,500
"4320","Kings County",2012-09-01,219,27,206,42,494
"4321","Kings County",2012-10-01,213,30,206,45,494
"4322","Kings County",2012-11-01,230,40,183,35,488
"4323","Kings County",2012-12-01,236,30,175,50,491
"4324","Kings County",2013-01-01,233,31,184,49,497
"4325","Kings County",2013-02-01,227,25,193,54,499
"4326","Kings County",2013-03-01,197,19,220,52,488
"4327","Kings County",2013-04-01,199,19,222,53,493
"4328","Kings County",2013-05-01,199,29,219,56,503
"4329","Kings County",2013-06-01,226,32,193,52,503
"4330","Kings County",2013-07-01,212,21,173,36,442
"4331","Kings County",2013-08-01,241,31,197,56,525
"4332","Kings County",2013-09-01,241,38,220,57,556
"4333","Kings County",2013-10-01,236,43,233,57,569
"4334","Kings County",2013-11-01,248,41,247,63,599
"4335","Kings County",2013-12-01,243,43,253,64,603
"4336","Kings County",2014-01-01,235,40,270,72,617
"4337","Kings County",2014-02-01,231,43,259,71,604
"4338","Kings County",2014-03-01,231,38,266,76,611
"4339","Kings County",2014-04-01,404,73,120,33,630
"4340","Kings County",2014-05-01,423,84,94,22,623
"4341","Kings County",2014-06-01,433,91,73,19,616
"4342","Kings County",2014-07-01,456,82,58,17,613
"4343","Kings County",2014-08-01,455,90,50,16,611
"4344","Kings County",2014-09-01,400,149,28,32,609
"4345","Kings County",2014-10-01,416,90,39,13,558
"4346","Kings County",2014-11-01,411,89,32,10,542
"4347","Kings County",2014-12-01,400,86,31,9,526
"4348","Kings County",2015-01-01,358,78,29,11,476
"4349","Kings County",2015-02-01,396,72,26,11,505
"4350","Kings County",2015-03-01,397,73,26,8,504
"4351","Kings County",2015-04-01,392,76,23,6,497
"4352","Kings County",2015-05-01,387,74,21,5,487
"4353","Kings County",2015-06-01,407,77,23,5,512
"4354","Kings County",2015-07-01,411,75,22,8,516
"4355","Kings County",2015-08-01,420,79,25,9,533
"4356","Kings County",2015-09-01,427,76,25,8,536
"4357","Kings County",2015-10-01,401,69,25,10,505
"4358","Kings County",2015-11-01,380,63,21,11,475
"4359","Kings County",2015-12-01,370,60,16,5,451
"4360","Kings County",2016-01-01,354,62,16,2,434
"4361","Kings County",2016-02-01,397,58,12,2,469
"4362","Kings County",2016-03-01,278,41,101,23,443
"4363","Kings County",2016-04-01,280,49,94,21,444
"4364","Kings County",2016-05-01,289,41,69,54,453
"4365","Kings County",2016-06-01,297,45,115,27,484
"4366","Kings County",2016-07-01,272,42,130,26,470
"4367","Kings County",2016-08-01,259,44,128,27,458
"4368","Kings County",2016-09-01,267,50,110,26,453
"4369","Kings County",2016-10-01,290,40,76,35,441
"4370","Kings County",2016-11-01,299,40,62,33,434
"4371","Kings County",2016-12-01,311,42,61,23,437
"4372","Kings County",2017-01-01,313,42,62,18,435
"4373","Kings County",2017-02-01,323,41,61,22,447
"4374","Kings County",2017-03-01,342,43,66,29,480
"4375","Kings County",2017-04-01,322,52,77,22,473
"4376","Kings County",2017-05-01,323,53,74,25,475
"4377","Kings County",2017-06-01,317,49,69,25,460
"4378","Kings County",2017-07-01,314,53,73,19,459
"4379","Kings County",2017-08-01,316,66,74,18,474
"4380","Kings County",2017-09-01,325,73,63,25,486
"4381","Kings County",2017-10-01,314,62,58,26,460
"4382","Kings County",2017-11-01,304,62,66,25,457
"4383","Kings County",2017-12-01,307,60,63,20,450
"4384","Kings County",2018-01-01,333,70,70,23,496
"4385","Kings County",2018-02-01,320,65,76,23,484
"4386","Kings County",2018-03-01,319,56,61,22,458
"4387","Kings County",2018-04-01,329,52,70,22,473
"4388","Kings County",2018-05-01,337,57,81,25,500
"4389","Kings County",2018-06-01,337,61,84,23,505
"4390","Kings County",2018-07-01,365,72,85,25,547
"4391","Kings County",2018-08-01,369,79,101,32,581
"4392","Kings County",2018-09-01,379,87,96,26,588
"4393","Kings County",2018-10-01,338,53,158,49,598
"4394","Kings County",2018-11-01,333,48,165,53,599
"4395","Kings County",2018-12-01,305,45,161,49,560
"4396","Kings County",2019-01-01,325,49,139,39,552
"4397","Kings County",2019-02-01,330,48,172,32,582
"4398","Kings County",2019-03-01,312,51,178,33,574
"4399","Kings County",2019-04-01,328,54,165,40,587
"4400","Kings County",2019-05-01,337,56,168,43,604
"4401","Kings County",2019-06-01,357,57,157,45,616
"4402","Kings County",2019-07-01,350,58,164,44,616
"4403","Kings County",2019-08-01,363,57,153,45,618
"4404","Kings County",2019-09-01,359,50,139,43,591
"4405","Kings County",2019-10-01,354,44,127,44,569
"4406","Kings County",2019-11-01,353,48,127,36,564
"4407","Kings County",2019-12-01,353,53,124,31,561
"4408","Kings County",2020-01-01,367,47,114,30,558
"4409","Kings County",2020-02-01,358,54,127,37,576
"4410","Kings County",2020-03-01,352,52,131,29,564
"4411","Lake County",1995-10-01,64,16,89,4,173
"4412","Lake County",1995-11-01,65,17,89,4,175
"4413","Lake County",1995-12-01,58,21,86,2,167
"4414","Lake County",1996-01-01,63,15,83,4,165
"4415","Lake County",1996-02-01,64,26,83,3,176
"4416","Lake County",1996-03-01,68,22,83,4,177
"4417","Lake County",1996-04-01,67,25,83,5,180
"4418","Lake County",1996-05-01,68,9,101,15,193
"4419","Lake County",1996-06-01,66,11,90,16,183
"4420","Lake County",1996-07-01,49,20,59,32,160
"4421","Lake County",1996-08-01,69,9,74,18,170
"4422","Lake County",1996-09-01,70,16,70,23,179
"4423","Lake County",1996-10-01,70,14,64,21,169
"4424","Lake County",1996-11-01,73,11,55,22,161
"4425","Lake County",1996-12-01,81,8,58,24,171
"4426","Lake County",1997-01-01,78,5,70,28,181
"4427","Lake County",1997-02-01,104,10,78,18,210
"4428","Lake County",1997-03-01,106,8,83,16,213
"4429","Lake County",1997-04-01,100,2,91,11,204
"4430","Lake County",1997-05-01,84,0,83,9,176
"4431","Lake County",1997-06-01,65,11,79,17,172
"4432","Lake County",1997-07-01,74,10,75,18,177
"4433","Lake County",1997-08-01,77,9,65,24,175
"4434","Lake County",1997-09-01,77,11,63,24,175
"4435","Lake County",1997-10-01,76,7,71,19,173
"4436","Lake County",1997-11-01,80,9,74,15,178
"4437","Lake County",1997-12-01,83,9,76,15,183
"4438","Lake County",1998-01-01,78,10,89,18,195
"4439","Lake County",1998-02-01,76,7,95,17,195
"4440","Lake County",1998-03-01,85,10,91,14,200
"4441","Lake County",1998-04-01,79,8,83,18,188
"4442","Lake County",1998-05-01,89,10,82,22,203
"4443","Lake County",1998-06-01,89,11,77,23,200
"4444","Lake County",1998-07-01,86,9,76,24,195
"4445","Lake County",1998-08-01,80,10,76,27,193
"4446","Lake County",1998-09-01,79,8,78,30,195
"4447","Lake County",1998-10-01,78,10,84,27,199
"4448","Lake County",1998-11-01,78,8,80,21,187
"4449","Lake County",1998-12-01,71,6,79,17,173
"4450","Lake County",1999-01-01,80,9,78,16,183
"4451","Lake County",1999-02-01,70,10,82,20,182
"4452","Lake County",1999-03-01,80,9,72,18,179
"4453","Lake County",1999-04-01,80,9,78,16,183
"4454","Lake County",1999-05-01,70,10,82,20,182
"4455","Lake County",1999-06-01,80,9,72,18,179
"4456","Lake County",1999-07-01,104,19,70,11,204
"4457","Lake County",1999-08-01,78,8,69,18,173
"4458","Lake County",1999-09-01,83,6,71,23,183
"4459","Lake County",1999-10-01,93,8,81,22,204
"4460","Lake County",1999-11-01,92,4,86,23,205
"4461","Lake County",1999-12-01,108,11,69,20,208
"4462","Lake County",2000-01-01,108,11,69,20,208
"4463","Lake County",2000-02-01,114,16,69,15,214
"4464","Lake County",2000-03-01,123,22,68,17,230
"4465","Lake County",2000-04-01,93,19,112,20,244
"4466","Lake County",2000-05-01,83,23,99,17,222
"4467","Lake County",2000-06-01,75,20,110,14,219
"4468","Lake County",2000-07-01,74,20,104,17,215
"4469","Lake County",2000-08-01,73,23,101,18,215
"4470","Lake County",2000-09-01,78,21,118,22,239
"4471","Lake County",2000-10-01,91,30,96,20,237
"4472","Lake County",2000-11-01,75,27,93,14,209
"4473","Lake County",2000-12-01,64,24,81,21,190
"4474","Lake County",2001-01-01,71,30,85,12,198
"4475","Lake County",2001-02-01,74,29,93,20,216
"4476","Lake County",2001-03-01,70,27,105,16,218
"4477","Lake County",2001-04-01,67,26,103,25,221
"4478","Lake County",2001-05-01,72,34,100,12,218
"4479","Lake County",2001-06-01,68,30,107,21,226
"4480","Lake County",2001-07-01,61,23,105,24,213
"4481","Lake County",2001-08-01,64,21,93,15,193
"4482","Lake County",2001-09-01,51,15,88,13,167
"4483","Lake County",2001-10-01,61,12,99,16,188
"4484","Lake County",2001-11-01,56,10,100,16,182
"4485","Lake County",2001-12-01,99,14,56,13,182
"4486","Lake County",2002-01-01,97,19,60,14,190
"4487","Lake County",2002-02-01,118,19,66,12,215
"4488","Lake County",2002-03-01,99,23,72,15,209
"4489","Lake County",2002-04-01,98,22,71,17,208
"4490","Lake County",2002-05-01,105,18,63,10,196
"4491","Lake County",2002-06-01,108,16,57,11,192
"4492","Lake County",2002-07-01,110,16,50,14,190
"4493","Lake County",2002-08-01,123,14,44,12,193
"4494","Lake County",2002-09-01,123,18,43,12,196
"4495","Lake County",2002-10-01,127,15,37,12,191
"4496","Lake County",2002-11-01,114,18,60,12,204
"4497","Lake County",2002-12-01,103,13,59,10,185
"4498","Lake County",2003-01-01,105,16,59,16,196
"4499","Lake County",2003-02-01,109,17,53,17,196
"4500","Lake County",2003-03-01,112,20,57,13,202
"4501","Lake County",2003-04-01,111,23,51,15,200
"4502","Lake County",2003-05-01,121,22,50,15,208
"4503","Lake County",2003-06-01,131,22,41,10,204
"4504","Lake County",2003-07-01,135,23,38,13,209
"4505","Lake County",2003-08-01,137,18,33,12,200
"4506","Lake County",2003-09-01,145,20,40,11,216
"4507","Lake County",2003-10-01,151,20,42,12,225
"4508","Lake County",2003-11-01,153,21,41,12,227
"4509","Lake County",2003-12-01,148,8,48,30,234
"4510","Lake County",2004-01-01,154,9,66,36,265
"4511","Lake County",2004-02-01,134,14,86,37,271
"4512","Lake County",2004-03-01,154,3,56,44,257
"4513","Lake County",2004-04-01,114,5,79,40,238
"4514","Lake County",2004-05-01,140,7,76,39,262
"4515","Lake County",2004-06-01,123,11,85,40,259
"4516","Lake County",2004-07-01,95,12,92,32,231
"4517","Lake County",2004-08-01,155,5,61,40,261
"4518","Lake County",2004-09-01,130,8,97,32,267
"4519","Lake County",2004-10-01,161,2,40,42,245
"4520","Lake County",2004-11-01,146,5,53,39,243
"4521","Lake County",2004-12-01,122,9,70,43,244
"4522","Lake County",2005-01-01,124,5,56,36,221
"4523","Lake County",2005-02-01,125,12,85,36,258
"4524","Lake County",2005-03-01,151,6,64,42,263
"4525","Lake County",2005-04-01,163,8,58,39,268
"4526","Lake County",2005-05-01,116,13,95,38,262
"4527","Lake County",2005-06-01,143,29,64,22,258
"4528","Lake County",2005-07-01,140,24,71,25,260
"4529","Lake County",2005-08-01,145,25,77,24,271
"4530","Lake County",2005-09-01,152,23,74,18,267
"4531","Lake County",2005-10-01,147,23,87,20,277
"4532","Lake County",2005-11-01,133,23,98,19,273
"4533","Lake County",2005-12-01,131,25,87,16,259
"4534","Lake County",2006-01-01,145,25,89,16,275
"4535","Lake County",2006-02-01,156,26,87,18,287
"4536","Lake County",2006-03-01,152,31,81,19,283
"4537","Lake County",2006-04-01,152,36,85,24,297
"4538","Lake County",2006-05-01,148,39,97,26,310
"4539","Lake County",2006-06-01,137,35,88,30,290
"4540","Lake County",2006-07-01,137,29,93,25,284
"4541","Lake County",2006-08-01,136,27,96,21,280
"4542","Lake County",2006-09-01,153,28,107,19,307
"4543","Lake County",2006-10-01,147,29,99,24,299
"4544","Lake County",2006-11-01,140,26,107,23,296
"4545","Lake County",2006-12-01,126,24,96,20,266
"4546","Lake County",2007-01-01,140,25,90,25,280
"4547","Lake County",2007-02-01,129,24,85,27,265
"4548","Lake County",2007-03-01,149,20,77,25,271
"4549","Lake County",2007-04-01,153,21,86,28,288
"4550","Lake County",2007-05-01,153,20,86,29,288
"4551","Lake County",2007-06-01,148,19,82,21,270
"4552","Lake County",2007-07-01,151,18,75,24,268
"4553","Lake County",2007-08-01,144,16,73,25,258
"4554","Lake County",2007-09-01,130,22,69,22,243
"4555","Lake County",2007-10-01,128,21,68,24,241
"4556","Lake County",2007-11-01,129,20,76,22,247
"4557","Lake County",2007-12-01,117,13,74,19,223
"4558","Lake County",2008-01-01,120,16,78,23,237
"4559","Lake County",2008-02-01,117,17,79,24,237
"4560","Lake County",2008-03-01,115,18,85,21,239
"4561","Lake County",2008-04-01,121,23,64,17,225
"4562","Lake County",2008-05-01,122,26,66,16,230
"4563","Lake County",2008-06-01,125,26,71,18,240
"4564","Lake County",2008-07-01,114,21,72,22,229
"4565","Lake County",2008-08-01,121,17,65,19,222
"4566","Lake County",2008-09-01,127,21,59,19,226
"4567","Lake County",2008-10-01,131,18,72,23,244
"4568","Lake County",2008-11-01,114,15,79,20,228
"4569","Lake County",2008-12-01,112,16,62,13,203
"4570","Lake County",2009-01-01,116,20,65,12,213
"4571","Lake County",2009-02-01,110,23,72,15,220
"4572","Lake County",2009-03-01,112,18,78,14,222
"4573","Lake County",2009-04-01,119,21,76,15,231
"4574","Lake County",2009-05-01,120,21,74,12,227
"4575","Lake County",2009-06-01,114,19,73,17,223
"4576","Lake County",2009-07-01,126,19,71,18,234
"4577","Lake County",2009-08-01,131,22,81,18,252
"4578","Lake County",2009-09-01,138,21,82,25,266
"4579","Lake County",2009-10-01,128,15,78,25,246
"4580","Lake County",2009-11-01,110,14,68,18,210
"4581","Lake County",2009-12-01,117,20,57,13,207
"4582","Lake County",2010-01-01,122,25,57,13,217
"4583","Lake County",2010-02-01,126,21,40,11,198
"4584","Lake County",2010-03-01,142,17,41,14,214
"4585","Lake County",2010-04-01,143,20,53,17,233
"4586","Lake County",2010-05-01,131,17,49,21,218
"4587","Lake County",2010-06-01,128,17,57,17,219
"4588","Lake County",2010-07-01,139,21,52,20,232
"4589","Lake County",2010-08-01,141,18,49,14,222
"4590","Lake County",2010-09-01,136,18,57,13,224
"4591","Lake County",2010-10-01,121,13,52,10,196
"4592","Lake County",2010-11-01,137,13,52,8,210
"4593","Lake County",2010-12-01,135,14,42,9,200
"4594","Lake County",2011-01-01,130,15,58,12,215
"4595","Lake County",2011-02-01,121,13,58,12,204
"4596","Lake County",2011-03-01,124,12,56,16,208
"4597","Lake County",2011-04-01,124,13,63,14,214
"4598","Lake County",2011-05-01,119,14,72,19,224
"4599","Lake County",2011-06-01,116,18,81,21,236
"4600","Lake County",2011-07-01,114,17,74,26,231
"4601","Lake County",2011-08-01,116,17,73,20,226
"4602","Lake County",2011-09-01,133,20,86,24,263
"4603","Lake County",2011-10-01,140,25,83,22,270
"4604","Lake County",2011-11-01,144,23,80,22,269
"4605","Lake County",2011-12-01,141,22,82,19,264
"4606","Lake County",2012-01-01,144,15,101,33,293
"4607","Lake County",2012-02-01,146,12,107,38,303
"4608","Lake County",2012-03-01,135,14,122,30,301
"4609","Lake County",2012-04-01,128,18,123,29,298
"4610","Lake County",2012-05-01,122,17,116,31,286
"4611","Lake County",2012-06-01,138,16,86,28,268
"4612","Lake County",2012-07-01,182,27,54,21,284
"4613","Lake County",2012-08-01,160,28,77,27,292
"4614","Lake County",2012-09-01,159,23,90,33,305
"4615","Lake County",2012-10-01,159,19,106,34,318
"4616","Lake County",2012-11-01,161,17,104,30,312
"4617","Lake County",2012-12-01,148,15,107,23,293
"4618","Lake County",2013-01-01,148,18,116,26,308
"4619","Lake County",2013-02-01,146,19,116,22,303
"4620","Lake County",2013-03-01,148,19,111,23,301
"4621","Lake County",2013-04-01,155,21,108,21,305
"4622","Lake County",2013-05-01,164,25,112,18,319
"4623","Lake County",2013-06-01,158,31,104,19,312
"4624","Lake County",2013-07-01,151,30,111,21,313
"4625","Lake County",2013-08-01,151,31,113,26,321
"4626","Lake County",2013-09-01,147,25,116,25,313
"4627","Lake County",2013-10-01,150,28,116,27,321
"4628","Lake County",2013-11-01,152,21,126,31,330
"4629","Lake County",2013-12-01,138,22,128,29,317
"4630","Lake County",2014-01-01,155,21,121,25,322
"4631","Lake County",2014-02-01,152,28,135,25,340
"4632","Lake County",2014-03-01,150,30,145,30,355
"4633","Lake County",2014-04-01,154,30,147,29,360
"4634","Lake County",2014-05-01,153,27,153,32,365
"4635","Lake County",2014-06-01,149,26,154,31,360
"4636","Lake County",2014-07-01,155,29,153,32,369
"4637","Lake County",2014-08-01,158,25,149,34,366
"4638","Lake County",2014-09-01,164,28,145,31,368
"4639","Lake County",2014-10-01,147,27,146,34,354
"4640","Lake County",2014-11-01,114,17,136,26,293
"4641","Lake County",2014-12-01,107,18,124,23,272
"4642","Lake County",2015-01-01,111,20,108,25,264
"4643","Lake County",2015-02-01,115,16,95,29,255
"4644","Lake County",2015-03-01,117,16,95,32,260
"4645","Lake County",2015-04-01,119,14,95,30,258
"4646","Lake County",2015-05-01,134,20,88,29,271
"4647","Lake County",2015-06-01,146,23,92,31,292
"4648","Lake County",2015-07-01,143,25,100,27,295
"4649","Lake County",2015-08-01,134,27,108,26,295
"4650","Lake County",2015-09-01,142,25,107,23,297
"4651","Lake County",2015-10-01,149,23,102,23,297
"4652","Lake County",2015-11-01,131,21,107,24,283
"4653","Lake County",2015-12-01,125,18,99,21,263
"4654","Lake County",2016-01-01,127,22,91,22,262
"4655","Lake County",2016-02-01,125,18,94,23,260
"4656","Lake County",2016-03-01,108,16,105,21,250
"4657","Lake County",2016-04-01,123,14,96,18,251
"4658","Lake County",2016-05-01,139,15,97,20,271
"4659","Lake County",2016-06-01,148,18,101,21,288
"4660","Lake County",2016-07-01,155,24,94,26,299
"4661","Lake County",2016-08-01,159,24,103,21,307
"4662","Lake County",2016-09-01,158,22,94,25,299
"4663","Lake County",2016-10-01,155,29,84,21,289
"4664","Lake County",2016-11-01,156,29,80,19,284
"4665","Lake County",2016-12-01,154,22,78,21,275
"4666","Lake County",2017-01-01,159,23,84,21,287
"4667","Lake County",2017-02-01,163,28,80,20,291
"4668","Lake County",2017-03-01,158,25,91,19,293
"4669","Lake County",2017-04-01,159,24,84,19,286
"4670","Lake County",2017-05-01,158,23,94,21,296
"4671","Lake County",2017-06-01,160,27,88,20,295
"4672","Lake County",2017-07-01,159,34,90,19,302
"4673","Lake County",2017-08-01,147,32,94,24,297
"4674","Lake County",2017-09-01,138,26,94,29,287
"4675","Lake County",2017-10-01,140,25,92,29,286
"4676","Lake County",2017-11-01,164,25,89,28,306
"4677","Lake County",2017-12-01,165,23,81,29,298
"4678","Lake County",2018-01-01,172,26,86,27,311
"4679","Lake County",2018-02-01,175,33,92,25,325
"4680","Lake County",2018-03-01,165,25,99,26,315
"4681","Lake County",2018-04-01,150,28,96,28,302
"4682","Lake County",2018-05-01,150,26,101,30,307
"4683","Lake County",2018-06-01,162,30,103,33,328
"4684","Lake County",2018-07-01,165,30,102,28,325
"4685","Lake County",2018-08-01,155,25,93,24,297
"4686","Lake County",2018-09-01,130,22,98,22,272
"4687","Lake County",2018-10-01,107,22,111,27,267
"4688","Lake County",2018-11-01,120,22,106,27,275
"4689","Lake County",2018-12-01,126,18,114,27,285
"4690","Lake County",2019-01-01,121,19,122,32,294
"4691","Lake County",2019-02-01,122,15,107,31,275
"4692","Lake County",2019-03-01,111,13,107,25,256
"4693","Lake County",2019-04-01,130,19,101,22,272
"4694","Lake County",2019-05-01,131,25,90,22,268
"4695","Lake County",2019-06-01,134,25,97,17,273
"4696","Lake County",2019-07-01,144,28,87,22,281
"4697","Lake County",2019-08-01,161,26,89,19,295
"4698","Lake County",2019-09-01,154,29,94,19,296
"4699","Lake County",2019-10-01,141,28,96,22,287
"4700","Lake County",2019-11-01,127,25,91,22,265
"4701","Lake County",2019-12-01,120,25,84,20,249
"4702","Lake County",2020-01-01,108,21,88,20,237
"4703","Lake County",2020-02-01,121,27,92,21,261
"4704","Lake County",2020-03-01,109,25,87,22,243
"4705","Lassen County",1995-10-01,45,6,43,14,108
"4706","Lassen County",1995-11-01,44,7,44,12,107
"4707","Lassen County",1995-12-01,43,8,45,10,106
"4708","Lassen County",1996-01-01,44,7,39,9,99
"4709","Lassen County",1996-02-01,43,8,47,9,107
"4710","Lassen County",1996-03-01,31,8,54,9,102
"4711","Lassen County",1996-04-01,26,8,47,9,90
"4712","Lassen County",1996-05-01,24,7,49,9,89
"4713","Lassen County",1996-06-01,24,6,46,9,85
"4714","Lassen County",1996-07-01,26,8,47,9,90
"4715","Lassen County",1996-08-01,24,7,49,9,89
"4716","Lassen County",1996-09-01,24,6,46,9,85
"4717","Lassen County",1996-10-01,33,8,47,8,96
"4718","Lassen County",1996-11-01,30,4,47,9,90
"4719","Lassen County",1996-12-01,29,5,49,8,91
"4720","Lassen County",1997-01-01,27,2,42,12,83
"4721","Lassen County",1997-02-01,27,3,38,12,80
"4722","Lassen County",1997-03-01,29,2,33,12,76
"4723","Lassen County",1997-04-01,26,3,32,7,68
"4724","Lassen County",1997-05-01,24,5,42,9,80
"4725","Lassen County",1997-06-01,27,7,39,15,88
"4726","Lassen County",1997-07-01,27,7,39,15,88
"4727","Lassen County",1997-08-01,26,4,38,18,86
"4728","Lassen County",1997-09-01,28,4,32,18,82
"4729","Lassen County",1997-10-01,35,7,30,21,93
"4730","Lassen County",1997-11-01,35,7,29,20,91
"4731","Lassen County",1997-12-01,34,7,26,19,86
"4732","Lassen County",1998-01-01,44,8,32,19,103
"4733","Lassen County",1998-02-01,53,10,31,17,111
"4734","Lassen County",1998-03-01,47,12,36,14,109
"4735","Lassen County",1998-04-01,47,12,43,15,117
"4736","Lassen County",1998-05-01,47,10,42,17,116
"4737","Lassen County",1998-06-01,50,8,43,18,119
"4738","Lassen County",1998-07-01,51,7,44,15,117
"4739","Lassen County",1998-08-01,53,11,46,17,127
"4740","Lassen County",1998-09-01,55,12,49,17,133
"4741","Lassen County",1998-10-01,55,11,45,14,125
"4742","Lassen County",1998-11-01,53,14,46,13,126
"4743","Lassen County",1998-12-01,51,13,41,16,121
"4744","Lassen County",1999-01-01,42,10,45,19,116
"4745","Lassen County",1999-02-01,44,9,47,14,114
"4746","Lassen County",1999-03-01,53,10,51,14,128
"4747","Lassen County",1999-04-01,44,9,55,15,123
"4748","Lassen County",1999-05-01,34,8,71,14,127
"4749","Lassen County",1999-06-01,38,14,64,14,130
"4750","Lassen County",1999-07-01,40,14,59,15,128
"4751","Lassen County",1999-08-01,35,8,51,19,113
"4752","Lassen County",1999-09-01,42,7,48,20,117
"4753","Lassen County",1999-10-01,47,8,45,17,117
"4754","Lassen County",1999-11-01,50,10,44,13,117
"4755","Lassen County",1999-12-01,52,11,40,11,114
"4756","Lassen County",2000-01-01,56,9,45,16,126
"4757","Lassen County",2000-02-01,50,4,49,17,120
"4758","Lassen County",2000-03-01,49,5,46,16,116
"4759","Lassen County",2000-04-01,49,4,42,17,112
"4760","Lassen County",2000-05-01,48,4,41,15,108
"4761","Lassen County",2000-06-01,48,5,38,18,109
"4762","Lassen County",2000-07-01,43,4,30,17,94
"4763","Lassen County",2000-08-01,43,6,28,13,90
"4764","Lassen County",2000-09-01,50,9,30,13,102
"4765","Lassen County",2000-10-01,58,17,33,14,122
"4766","Lassen County",2000-11-01,55,13,41,17,126
"4767","Lassen County",2000-12-01,52,9,41,21,123
"4768","Lassen County",2001-01-01,48,16,53,7,125
"4769","Lassen County",2001-02-01,51,15,52,10,128
"4770","Lassen County",2001-03-01,51,13,60,7,131
"4771","Lassen County",2001-04-01,44,9,58,12,123
"4772","Lassen County",2001-05-01,31,8,58,14,111
"4773","Lassen County",2001-06-01,32,13,59,10,115
"4774","Lassen County",2001-07-01,31,16,49,9,105
"4775","Lassen County",2001-08-01,43,19,41,8,111
"4776","Lassen County",2001-09-01,44,15,43,11,113
"4777","Lassen County",2001-10-01,44,14,36,10,104
"4778","Lassen County",2001-11-01,44,17,32,8,101
"4779","Lassen County",2001-12-01,39,12,39,6,96
"4780","Lassen County",2002-01-01,45,11,52,11,119
"4781","Lassen County",2002-02-01,45,11,52,11,119
"4782","Lassen County",2002-03-01,44,11,52,15,122
"4783","Lassen County",2002-04-01,48,10,45,10,113
"4784","Lassen County",2002-05-01,48,13,43,13,117
"4785","Lassen County",2002-06-01,48,11,37,9,105
"4786","Lassen County",2002-07-01,48,10,53,16,127
"4787","Lassen County",2002-08-01,49,11,50,19,129
"4788","Lassen County",2002-09-01,48,13,48,20,129
"4789","Lassen County",2002-10-01,46,11,49,17,123
"4790","Lassen County",2002-11-01,45,6,31,18,100
"4791","Lassen County",2002-12-01,36,5,51,15,107
"4792","Lassen County",2003-01-01,33,8,54,14,109
"4793","Lassen County",2003-02-01,45,8,52,15,120
"4794","Lassen County",2003-03-01,50,14,47,15,126
"4795","Lassen County",2003-04-01,44,15,53,15,127
"4796","Lassen County",2003-05-01,44,12,40,17,113
"4797","Lassen County",2003-06-01,50,10,41,20,121
"4798","Lassen County",2003-07-01,50,14,36,21,121
"4799","Lassen County",2003-08-01,51,16,32,22,121
"4800","Lassen County",2003-09-01,45,6,67,12,130
"4801","Lassen County",2003-10-01,38,8,64,10,120
"4802","Lassen County",2003-11-01,42,9,43,10,104
"4803","Lassen County",2003-12-01,40,21,32,8,101
"4804","Lassen County",2004-01-01,44,12,39,5,100
"4805","Lassen County",2004-02-01,35,11,35,5,86
"4806","Lassen County",2004-03-01,38,9,35,9,91
"4807","Lassen County",2004-04-01,27,9,39,8,83
"4808","Lassen County",2004-05-01,40,11,33,10,94
"4809","Lassen County",2004-06-01,45,11,31,8,95
"4810","Lassen County",2004-07-01,45,11,30,6,92
"4811","Lassen County",2004-08-01,41,14,35,8,98
"4812","Lassen County",2004-09-01,29,11,35,6,81
"4813","Lassen County",2004-10-01,32,8,30,4,74
"4814","Lassen County",2004-11-01,28,8,27,4,67
"4815","Lassen County",2004-12-01,26,6,23,7,62
"4816","Lassen County",2005-01-01,28,7,30,7,72
"4817","Lassen County",2005-02-01,40,8,25,8,81
"4818","Lassen County",2005-03-01,43,11,25,9,88
"4819","Lassen County",2005-04-01,27,9,39,8,83
"4820","Lassen County",2005-05-01,37,5,53,10,105
"4821","Lassen County",2005-06-01,33,7,35,13,88
"4822","Lassen County",2005-07-01,29,5,32,12,78
"4823","Lassen County",2005-08-01,29,7,32,6,74
"4824","Lassen County",2005-09-01,28,10,29,6,73
"4825","Lassen County",2005-10-01,29,7,31,7,74
"4826","Lassen County",2005-11-01,41,6,31,6,84
"4827","Lassen County",2005-12-01,34,7,24,6,71
"4828","Lassen County",2006-01-01,48,8,27,8,91
"4829","Lassen County",2006-02-01,41,6,30,10,87
"4830","Lassen County",2006-03-01,42,6,31,11,90
"4831","Lassen County",2006-04-01,42,9,40,7,98
"4832","Lassen County",2006-05-01,47,8,36,6,97
"4833","Lassen County",2006-06-01,46,7,31,10,94
"4834","Lassen County",2006-07-01,40,4,33,3,80
"4835","Lassen County",2006-08-01,44,9,37,7,97
"4836","Lassen County",2006-09-01,40,8,29,9,86
"4837","Lassen County",2006-10-01,46,9,27,10,92
"4838","Lassen County",2006-11-01,43,8,26,14,91
"4839","Lassen County",2006-12-01,40,3,24,14,81
"4840","Lassen County",2007-01-01,46,10,29,6,91
"4841","Lassen County",2007-02-01,50,10,30,6,96
"4842","Lassen County",2007-03-01,50,10,32,12,104
"4843","Lassen County",2007-04-01,34,17,50,19,120
"4844","Lassen County",2007-05-01,41,12,36,18,107
"4845","Lassen County",2007-06-01,36,22,42,13,113
"4846","Lassen County",2007-07-01,41,13,36,20,110
"4847","Lassen County",2007-08-01,39,12,37,14,102
"4848","Lassen County",2007-09-01,35,7,38,14,94
"4849","Lassen County",2007-10-01,37,8,37,16,98
"4850","Lassen County",2007-11-01,34,9,36,15,94
"4851","Lassen County",2007-12-01,41,8,26,9,84
"4852","Lassen County",2008-01-01,30,10,38,9,87
"4853","Lassen County",2008-02-01,20,3,61,8,92
"4854","Lassen County",2008-03-01,38,8,32,12,90
"4855","Lassen County",2008-04-01,35,6,28,12,81
"4856","Lassen County",2008-05-01,32,9,33,12,86
"4857","Lassen County",2008-06-01,33,10,34,12,89
"4858","Lassen County",2008-07-01,36,13,42,17,108
"4859","Lassen County",2008-08-01,35,8,32,12,87
"4860","Lassen County",2008-09-01,39,7,24,8,78
"4861","Lassen County",2008-10-01,40,8,24,9,81
"4862","Lassen County",2008-11-01,38,10,28,9,85
"4863","Lassen County",2008-12-01,37,7,22,10,76
"4864","Lassen County",2009-01-01,36,7,24,11,78
"4865","Lassen County",2009-02-01,23,16,40,8,87
"4866","Lassen County",2009-03-01,44,12,29,14,99
"4867","Lassen County",2009-04-01,51,11,23,14,99
"4868","Lassen County",2009-05-01,36,11,25,14,86
"4869","Lassen County",2009-06-01,38,10,22,9,79
"4870","Lassen County",2009-07-01,21,7,32,8,68
"4871","Lassen County",2009-08-01,33,7,21,11,72
"4872","Lassen County",2009-09-01,41,6,18,10,75
"4873","Lassen County",2009-10-01,26,10,39,8,83
"4874","Lassen County",2009-11-01,40,7,22,9,78
"4875","Lassen County",2009-12-01,25,7,26,7,65
"4876","Lassen County",2010-01-01,35,8,20,8,71
"4877","Lassen County",2010-02-01,22,6,29,9,66
"4878","Lassen County",2010-03-01,27,6,16,3,52
"4879","Lassen County",2010-04-01,18,4,36,6,64
"4880","Lassen County",2010-05-01,31,5,18,6,60
"4881","Lassen County",2010-06-01,27,6,20,7,60
"4882","Lassen County",2010-07-01,29,8,26,7,70
"4883","Lassen County",2010-08-01,35,11,16,5,67
"4884","Lassen County",2010-09-01,35,11,16,7,69
"4885","Lassen County",2010-10-01,39,5,17,3,64
"4886","Lassen County",2010-11-01,40,6,23,4,73
"4887","Lassen County",2010-12-01,43,5,16,3,67
"4888","Lassen County",2011-01-01,40,10,25,7,82
"4889","Lassen County",2011-02-01,40,10,34,12,96
"4890","Lassen County",2011-03-01,42,11,25,8,86
"4891","Lassen County",2011-04-01,30,12,25,8,75
"4892","Lassen County",2011-05-01,32,15,21,5,73
"4893","Lassen County",2011-06-01,46,14,19,7,86
"4894","Lassen County",2011-07-01,43,12,27,6,88
"4895","Lassen County",2011-08-01,45,12,22,7,86
"4896","Lassen County",2011-09-01,43,11,18,5,77
"4897","Lassen County",2011-10-01,36,8,20,6,70
"4898","Lassen County",2011-11-01,34,12,28,5,79
"4899","Lassen County",2011-12-01,35,10,26,3,74
"4900","Lassen County",2012-01-01,37,15,30,5,87
"4901","Lassen County",2012-02-01,38,14,39,9,100
"4902","Lassen County",2012-03-01,29,14,50,15,108
"4903","Lassen County",2012-04-01,47,10,36,10,103
"4904","Lassen County",2012-05-01,38,9,44,13,104
"4905","Lassen County",2012-06-01,32,8,52,16,108
"4906","Lassen County",2012-07-01,27,10,54,13,104
"4907","Lassen County",2012-08-01,36,14,54,11,115
"4908","Lassen County",2012-09-01,40,18,59,8,125
"4909","Lassen County",2012-10-01,43,14,63,9,129
"4910","Lassen County",2012-11-01,45,16,55,10,126
"4911","Lassen County",2012-12-01,42,11,58,11,122
"4912","Lassen County",2013-01-01,45,11,65,13,134
"4913","Lassen County",2013-02-01,43,11,66,15,135
"4914","Lassen County",2013-03-01,38,11,56,18,123
"4915","Lassen County",2013-04-01,31,8,50,17,106
"4916","Lassen County",2013-05-01,33,10,52,16,111
"4917","Lassen County",2013-06-01,37,13,59,20,129
"4918","Lassen County",2013-07-01,35,11,60,17,123
"4919","Lassen County",2013-08-01,36,10,60,18,124
"4920","Lassen County",2013-09-01,34,8,61,18,121
"4921","Lassen County",2013-10-01,44,11,72,13,140
"4922","Lassen County",2013-11-01,41,12,73,14,140
"4923","Lassen County",2013-12-01,32,9,69,15,125
"4924","Lassen County",2014-01-01,34,10,73,14,131
"4925","Lassen County",2014-02-01,37,6,62,14,119
"4926","Lassen County",2014-03-01,41,11,59,11,122
"4927","Lassen County",2014-04-01,41,13,52,13,119
"4928","Lassen County",2014-05-01,48,11,53,13,125
"4929","Lassen County",2014-06-01,41,8,57,15,121
"4930","Lassen County",2014-07-01,28,8,61,14,111
"4931","Lassen County",2014-08-01,36,9,53,13,111
"4932","Lassen County",2014-09-01,27,12,62,13,114
"4933","Lassen County",2014-10-01,28,15,57,14,114
"4934","Lassen County",2014-11-01,28,14,50,14,106
"4935","Lassen County",2014-12-01,26,10,34,15,84
"4936","Lassen County",2015-01-01,32,12,29,15,87
"4937","Lassen County",2015-02-01,39,14,24,15,92
"4938","Lassen County",2015-03-01,38,13,40,14,105
"4939","Lassen County",2015-04-01,37,14,41,13,105
"4940","Lassen County",2015-05-01,38,8,35,16,97
"4941","Lassen County",2015-06-01,37,6,27,14,84
"4942","Lassen County",2015-07-01,42,8,26,12,89
"4943","Lassen County",2015-08-01,42,10,28,10,90
"4944","Lassen County",2015-09-01,40,10,33,9,92
"4945","Lassen County",2015-10-01,42,11,35,10,98
"4946","Lassen County",2015-11-01,33,6,37,12,89
"4947","Lassen County",2015-12-01,39,7,43,14,103
"4948","Lassen County",2016-01-01,48,7,35,14,104
"4949","Lassen County",2016-02-01,56,9,36,16,117
"4950","Lassen County",2016-03-01,54,7,46,13,120
"4951","Lassen County",2016-04-01,47,8,54,14,123
"4952","Lassen County",2016-05-01,47,6,46,12,112
"4953","Lassen County",2016-06-01,45,9,46,11,112
"4954","Lassen County",2016-07-01,42,6,44,14,106
"4955","Lassen County",2016-08-01,44,5,32,13,94
"4956","Lassen County",2016-09-01,41,4,23,9,77
"4957","Lassen County",2016-10-01,43,4,26,5,78
"4958","Lassen County",2016-11-01,47,6,29,6,89
"4959","Lassen County",2016-12-01,43,5,29,6,83
"4960","Lassen County",2017-01-01,44,5,26,9,84
"4961","Lassen County",2017-02-01,46,8,27,8,89
"4962","Lassen County",2017-03-01,44,5,28,8,85
"4963","Lassen County",2017-04-01,46,4,23,5,78
"4964","Lassen County",2017-05-01,47,7,20,4,78
"4965","Lassen County",2017-06-01,36,7,18,4,65
"4966","Lassen County",2017-07-01,47,5,20,4,76
"4967","Lassen County",2017-08-01,50,6,24,5,85
"4968","Lassen County",2017-09-01,49,7,18,7,81
"4969","Lassen County",2017-10-01,49,9,17,5,80
"4970","Lassen County",2017-11-01,49,9,18,5,81
"4971","Lassen County",2017-12-01,52,9,31,7,99
"4972","Lassen County",2018-01-01,57,12,34,6,109
"4973","Lassen County",2018-02-01,54,11,38,6,109
"4974","Lassen County",2018-03-01,54,9,39,7,109
"4975","Lassen County",2018-04-01,60,10,43,7,120
"4976","Lassen County",2018-05-01,51,8,46,6,111
"4977","Lassen County",2018-06-01,54,13,43,6,116
"4978","Lassen County",2018-07-01,52,22,40,5,118
"4979","Lassen County",2018-08-01,49,15,44,9,117
"4980","Lassen County",2018-09-01,45,13,51,12,121
"4981","Lassen County",2018-10-01,57,17,45,11,130
"4982","Lassen County",2018-11-01,50,15,58,12,135
"4983","Lassen County",2018-12-01,35,14,63,12,124
"4984","Lassen County",2019-01-01,34,14,50,12,110
"4985","Lassen County",2019-02-01,44,9,55,17,125
"4986","Lassen County",2019-03-01,41,10,54,16,121
"4987","Lassen County",2019-04-01,39,10,42,14,105
"4988","Lassen County",2019-05-01,33,14,36,15,98
"4989","Lassen County",2019-06-01,32,11,33,18,94
"4990","Lassen County",2019-07-01,35,12,40,21,108
"4991","Lassen County",2019-08-01,38,10,42,18,108
"4992","Lassen County",2019-09-01,35,8,40,21,104
"4993","Lassen County",2019-10-01,30,7,41,17,95
"4994","Lassen County",2019-11-01,31,9,39,18,97
"4995","Lassen County",2019-12-01,35,9,35,15,94
"4996","Lassen County",2020-01-01,47,11,27,12,97
"4997","Lassen County",2020-02-01,47,6,33,15,101
"4998","Lassen County",2020-03-01,51,4,34,11,100
"4999","Los Angeles County",1995-10-01,10973,1399,4848,771,17991
"5000","Los Angeles County",1995-11-01,10912,1358,4762,814,17846
"5001","Los Angeles County",1995-12-01,10769,1318,4821,820,17728
"5002","Los Angeles County",1996-01-01,10808,1381,4903,735,17827
"5003","Los Angeles County",1996-02-01,10982,1492,4740,660,17874
"5004","Los Angeles County",1996-03-01,11198,1441,4830,689,18158
"5005","Los Angeles County",1996-04-01,11172,1460,4823,669,18124
"5006","Los Angeles County",1996-05-01,10719,1451,5282,619,18071
"5007","Los Angeles County",1996-06-01,10628,1485,5716,554,18383
"5008","Los Angeles County",1996-07-01,10651,1504,6149,592,18896
"5009","Los Angeles County",1996-08-01,10412,1507,5954.4,531,18404.4
"5010","Los Angeles County",1996-09-01,10685,1609,6354,464,19112
"5011","Los Angeles County",1996-10-01,10806,1289,6188,941,19224
"5012","Los Angeles County",1996-11-01,10890,1243,6150,835,19118
"5013","Los Angeles County",1996-12-01,10951,1176,6463,847,19437
"5014","Los Angeles County",1997-01-01,10908,1175,7615,812,20510
"5015","Los Angeles County",1997-02-01,10280,1246,7849,819,20194
"5016","Los Angeles County",1997-03-01,10986,1294,8029,913,21222
"5017","Los Angeles County",1997-04-01,10374,1235,7959,820,20388
"5018","Los Angeles County",1997-05-01,10115,1231,8433,853,20632
"5019","Los Angeles County",1997-06-01,10249,1302,9391,917,21859
"5020","Los Angeles County",1997-07-01,10455,1240,8686,1035,21416
"5021","Los Angeles County",1997-08-01,10222,2031,7318,1013,20584
"5022","Los Angeles County",1997-09-01,10460,2111,7419,1006,20996
"5023","Los Angeles County",1997-10-01,10448,1181,8355,1020,21004
"5024","Los Angeles County",1997-11-01,10403,1144,8219,1136,20902
"5025","Los Angeles County",1997-12-01,10230,1116,8315,1191,20852
"5026","Los Angeles County",1998-01-01,9013,1700,9311,1244,21268
"5027","Los Angeles County",1998-02-01,10115,2121,8182,1219,21637
"5028","Los Angeles County",1998-03-01,10173,1250,9363,1342,22128
"5029","Los Angeles County",1998-04-01,10097,1235,9063,1441,21836
"5030","Los Angeles County",1998-05-01,10100,1197,9011,1455,21763
"5031","Los Angeles County",1998-06-01,9987,1198,9099,1372,21656
"5032","Los Angeles County",1998-07-01,10727,1195,8336,1336,21594
"5033","Los Angeles County",1998-08-01,11053,1215,8094,1274,21636
"5034","Los Angeles County",1998-09-01,11308,1193,7869,1266,21636
"5035","Los Angeles County",1998-10-01,10678,1195,8282,1317,21472
"5036","Los Angeles County",1998-11-01,10677,1210,7751,1276,20914
"5037","Los Angeles County",1998-12-01,10233,1179,7556,1206,20174
"5038","Los Angeles County",1999-01-01,10226,1198,7835,1204,20463
"5039","Los Angeles County",1999-02-01,10462,1163,7867,1315,20807
"5040","Los Angeles County",1999-03-01,10206,1181,8008,1299,20694
"5041","Los Angeles County",1999-04-01,9458,1206,8412,1264,20340
"5042","Los Angeles County",1999-05-01,10110,1242,7754,1269,20375
"5043","Los Angeles County",1999-06-01,10264,1189,7680,1206,20339
"5044","Los Angeles County",1999-07-01,10440,1233,7799,1152,20624
"5045","Los Angeles County",1999-08-01,10430,1266,7907,1203,20806
"5046","Los Angeles County",1999-09-01,10595,1234,7849,1196,20874
"5047","Los Angeles County",1999-10-01,10445,1236,7818,1187,20686
"5048","Los Angeles County",1999-11-01,10076,1269,7467,1155,19967
"5049","Los Angeles County",1999-12-01,9858,1190,7011,1081,19140
"5050","Los Angeles County",2000-01-01,9693,1136,7313,1081,19223
"5051","Los Angeles County",2000-02-01,10483,1187,6733,1087,19490
"5052","Los Angeles County",2000-03-01,9876,1159,7348,1064,19447
"5053","Los Angeles County",2000-04-01,9834,1147,7477,1073,19531
"5054","Los Angeles County",2000-05-01,9551,1120,7550,1032,19253
"5055","Los Angeles County",2000-06-01,9655,1189,7369,1020,19233
"5056","Los Angeles County",2000-07-01,9839,1185,7244,1025,19293
"5057","Los Angeles County",2000-08-01,9792,1159,7389,1079,19419
"5058","Los Angeles County",2000-09-01,10130,1208,7106,1091,19535
"5059","Los Angeles County",2000-10-01,10294,1287,7647,1090,20318
"5060","Los Angeles County",2000-11-01,10184,1201,7439,1110,19934
"5061","Los Angeles County",2000-12-01,9973,1186,7007,1058,19224
"5062","Los Angeles County",2001-01-01,9924,1184,6942,1042,19092
"5063","Los Angeles County",2001-02-01,10026,1148,7242,1129,19545
"5064","Los Angeles County",2001-03-01,9795,1199,7486,1154,19634
"5065","Los Angeles County",2001-04-01,9704,1235,7273,1133,19345
"5066","Los Angeles County",2001-05-01,9913,1257,7211,1083,19464
"5067","Los Angeles County",2001-06-01,9925,1203,7160,1086,19374
"5068","Los Angeles County",2001-07-01,9890,1260,7038,1011,19199
"5069","Los Angeles County",2001-08-01,9912,1288,7289,975,19464
"5070","Los Angeles County",2001-09-01,9995,1276,7175,937,19383
"5071","Los Angeles County",2001-10-01,9813,1215,7021,995,19044
"5072","Los Angeles County",2001-11-01,9686,1206,7071,926,18889
"5073","Los Angeles County",2001-12-01,9512,1188,6877,911,18488
"5074","Los Angeles County",2002-01-01,9597,1231,6667,930,18425
"5075","Los Angeles County",2002-02-01,9755,1244,6824,982,18805
"5076","Los Angeles County",2002-03-01,10010,1304,6933,974,19221
"5077","Los Angeles County",2002-04-01,10157,1312,7168,998,19635
"5078","Los Angeles County",2002-05-01,10168,1311,7475,1011,19965
"5079","Los Angeles County",2002-06-01,10244,1293,7535,970,20042
"5080","Los Angeles County",2002-07-01,10338,1259,6947,891,19435
"5081","Los Angeles County",2002-08-01,10285,1285,6532,889,18991
"5082","Los Angeles County",2002-09-01,10215,1273,6693,915,19096
"5083","Los Angeles County",2002-10-01,10084,1294,6925,924,19227
"5084","Los Angeles County",2002-11-01,10251,1358,6991,1040,19640
"5085","Los Angeles County",2002-12-01,10236,1317,6472,911,18936
"5086","Los Angeles County",2003-01-01,10239,1369,6915,957,19480
"5087","Los Angeles County",2003-02-01,10448,1380,5869,900,18597
"5088","Los Angeles County",2003-03-01,9864,1289,4776,615,16544
"5089","Los Angeles County",2003-04-01,10697,1271,4912,684,17564
"5090","Los Angeles County",2003-05-01,10975,1361,4389,597,17322
"5091","Los Angeles County",2003-06-01,10833,1433,3966,490,16722
"5092","Los Angeles County",2003-07-01,10702,1500,4137,478,16817
"5093","Los Angeles County",2003-08-01,10640,1529,4019,530,16718
"5094","Los Angeles County",2003-09-01,10525,1514,4185,538,16762
"5095","Los Angeles County",2003-10-01,10597,1446,4506,490,17039
"5096","Los Angeles County",2003-11-01,10489,1435,4378,471,16773
"5097","Los Angeles County",2003-12-01,10386,1407,4243,531,16567
"5098","Los Angeles County",2004-01-01,9911,1450,4315,473,16149
"5099","Los Angeles County",2004-02-01,10254,1482,4501,456,16693
"5100","Los Angeles County",2004-03-01,10282,1476,4658,446,16862
"5101","Los Angeles County",2004-04-01,10490,1421,4540,445,16896
"5102","Los Angeles County",2004-05-01,10861,1378,4184,417,16840
"5103","Los Angeles County",2004-06-01,11083,1453,4181,395,17112
"5104","Los Angeles County",2004-07-01,11545,1480,3729,374,17128
"5105","Los Angeles County",2004-08-01,11706,1567,3592,286,17151
"5106","Los Angeles County",2004-09-01,11529,1531,3773,260,17093
"5107","Los Angeles County",2004-10-01,11433,1377,3685,347,16842
"5108","Los Angeles County",2004-11-01,11318,1434,3761,331,16844
"5109","Los Angeles County",2004-12-01,11106,1424,3477,315,16322
"5110","Los Angeles County",2005-01-01,10976,1331,4108,384,16799
"5111","Los Angeles County",2005-02-01,11828,1435,3895,330,17488
"5112","Los Angeles County",2005-03-01,11079,1486,3920,366,16851
"5113","Los Angeles County",2005-04-01,11151,1542,4020,397,17110
"5114","Los Angeles County",2005-05-01,11319,1570,4037,398,17324
"5115","Los Angeles County",2005-06-01,11409,1664,4165,389,17627
"5116","Los Angeles County",2005-07-01,11977,1653,4420,383,18433
"5117","Los Angeles County",2005-08-01,12149,1629,4400,405,18583
"5118","Los Angeles County",2005-09-01,12202,1639,4645,393,18879
"5119","Los Angeles County",2005-10-01,12347,1675,4549,406,18977
"5120","Los Angeles County",2005-11-01,12301,1687,4474,418,18880
"5121","Los Angeles County",2005-12-01,12087,1613,4082,447,18229
"5122","Los Angeles County",2006-01-01,11838,1565,4217,553,18173
"5123","Los Angeles County",2006-02-01,11644,1587,4052,527,17810
"5124","Los Angeles County",2006-03-01,11869,1472,4109,227,17677
"5125","Los Angeles County",2006-04-01,11438,1536,3924,625,17523
"5126","Los Angeles County",2006-05-01,11547,1639,4271,582,18039
"5127","Los Angeles County",2006-06-01,11263,1487,4027,692,17469
"5128","Los Angeles County",2006-07-01,11519,1447,4573,714,18253
"5129","Los Angeles County",2006-08-01,11846,1558,4513,688,18605
"5130","Los Angeles County",2006-09-01,11334,1540,4062,707,17643
"5131","Los Angeles County",2006-10-01,12086,1501,4089,727,18403
"5132","Los Angeles County",2006-11-01,12139,1574,4256,669,18638
"5133","Los Angeles County",2006-12-01,12444,1504,3661,675,18284
"5134","Los Angeles County",2007-01-01,11584,1566,4282,653,18085
"5135","Los Angeles County",2007-02-01,11497,1469,4579,712,18257
"5136","Los Angeles County",2007-03-01,11581,1430,4547,691,18249
"5137","Los Angeles County",2007-04-01,11776,1444,4546,745,18511
"5138","Los Angeles County",2007-05-01,11556,1481,4671,735,18443
"5139","Los Angeles County",2007-06-01,11515,1488,4977,754,18734
"5140","Los Angeles County",2007-07-01,12068,1445,4508,740,18761
"5141","Los Angeles County",2007-08-01,11798,1528,4694,676,18696
"5142","Los Angeles County",2007-09-01,11849,1600,4895,693,19037
"5143","Los Angeles County",2007-10-01,11696,1549,5464,786,19495
"5144","Los Angeles County",2007-11-01,12090,1532,5135,653,19410
"5145","Los Angeles County",2007-12-01,11821,1411,5087,660,18979
"5146","Los Angeles County",2008-01-01,11910,1476,5131,691,19208
"5147","Los Angeles County",2008-02-01,11793,1542,5203,680,19218
"5148","Los Angeles County",2008-03-01,12368,1547,4975,681,19571
"5149","Los Angeles County",2008-04-01,11741,1540,5231,698,19210
"5150","Los Angeles County",2008-05-01,11916,1637,4706,616,18875
"5151","Los Angeles County",2008-06-01,11904,1603,5231,596,19334
"5152","Los Angeles County",2008-07-01,11787,1675,5322,585,19369
"5153","Los Angeles County",2008-08-01,11903,1555,5235,645,19338
"5154","Los Angeles County",2008-09-01,10505,1603,4829,579,17516
"5155","Los Angeles County",2008-10-01,11760,1510,5264,584,19118
"5156","Los Angeles County",2008-11-01,11384,1402,5047,583,18416
"5157","Los Angeles County",2008-12-01,11051,1276,5126,550,18003
"5158","Los Angeles County",2009-01-01,11242,1282,5033,544,18101
"5159","Los Angeles County",2009-02-01,10841,1328,5316,520,18005
"5160","Los Angeles County",2009-03-01,10542,1284,6225,611,18662
"5161","Los Angeles County",2009-04-01,10604,1290,6944,648,19486
"5162","Los Angeles County",2009-05-01,10830,1324,6677,564,19395
"5163","Los Angeles County",2009-06-01,10316,1288,6996,587,19187
"5164","Los Angeles County",2009-07-01,10274,1289,6831,603,18997
"5165","Los Angeles County",2009-08-01,10357,1355,6679,607,18998
"5166","Los Angeles County",2009-09-01,11031,1367,5823,642,18863
"5167","Los Angeles County",2009-10-01,10536,1302,5601,742,18181
"5168","Los Angeles County",2009-11-01,11056,1367,5177,634,18234
"5169","Los Angeles County",2009-12-01,10847,1260,5104,643,17854
"5170","Los Angeles County",2010-01-01,10263,1248,4971,654,17136
"5171","Los Angeles County",2010-02-01,9685,1198,5191,672,16746
"5172","Los Angeles County",2010-03-01,9341,1216,5141,694,16392
"5173","Los Angeles County",2010-04-01,9984,1126,5155,768,17033
"5174","Los Angeles County",2010-05-01,10215,1577,4546,409,16747
"5175","Los Angeles County",2010-06-01,10130,1122,4603,831,16686
"5176","Los Angeles County",2010-07-01,9871,1148,4659,805,16483
"5177","Los Angeles County",2010-08-01,10137,1220,3950,794,16101
"5178","Los Angeles County",2010-09-01,7816,1152,6286,687,15941
"5179","Los Angeles County",2010-10-01,9454,1075,4063,613,15205
"5180","Los Angeles County",2010-11-01,9834,1171,3880,552,15437
"5181","Los Angeles County",2010-12-01,9685,1027,3801,606,15119
"5182","Los Angeles County",2011-01-01,9698,1018,3610,540,14866
"5183","Los Angeles County",2011-02-01,10003,1082,3436,567,15088
"5184","Los Angeles County",2011-03-01,9228,1061,3270,541,14100
"5185","Los Angeles County",2011-04-01,8883,1034,3124,536,13577
"5186","Los Angeles County",2011-05-01,8788,1086,3133,507,13514
"5187","Los Angeles County",2011-06-01,8933,1093,3271,558,13855
"5188","Los Angeles County",2011-07-01,8863,1124,3752,531,14270
"5189","Los Angeles County",2011-08-01,9446,1085,3725,608,14864
"5190","Los Angeles County",2011-09-01,9518,1102,3572,934,15126
"5191","Los Angeles County",2011-10-01,9289,966,4339,673,15267
"5192","Los Angeles County",2011-11-01,8527,971,4599,764,14861
"5193","Los Angeles County",2011-12-01,8596,947,5075,866,15484
"5194","Los Angeles County",2012-01-01,8644,916,5279,956,15795
"5195","Los Angeles County",2012-02-01,8557,1066,5756,956,16335
"5196","Los Angeles County",2012-03-01,8596,947,5075,866,15484
"5197","Los Angeles County",2012-04-01,8956,1032,5751,1238,16977
"5198","Los Angeles County",2012-05-01,7855,1051,7102,1283,17291
"5199","Los Angeles County",2012-06-01,8538,1110,6801,1267,17716
"5200","Los Angeles County",2012-07-01,8117,1253,6067,1185,16622
"5201","Los Angeles County",2012-08-01,8204,1218,6714,1348,17484
"5202","Los Angeles County",2012-09-01,8942,1235,7311,1378,18866
"5203","Los Angeles County",2012-10-01,8504,1152,7716,1412,18784
"5204","Los Angeles County",2012-11-01,9604,1516,6591,933,18644
"5205","Los Angeles County",2012-12-01,8709,1140,7014,1291,18154
"5206","Los Angeles County",2013-01-01,8540,1174,7059,1258,18031
"5207","Los Angeles County",2013-02-01,8600,1180,7277,1285,18342
"5208","Los Angeles County",2013-03-01,8889,1203,6884,1270,18246
"5209","Los Angeles County",2013-04-01,9111,1218,6706,1231,18266
"5210","Los Angeles County",2013-05-01,8986,1213,6741,1235,18175
"5211","Los Angeles County",2013-06-01,9185,1229,6656,1263,18333
"5212","Los Angeles County",2013-07-01,8784,1259,6871,1231,18145
"5213","Los Angeles County",2013-08-01,8787,1218,6961,1291,18257
"5214","Los Angeles County",2013-09-01,8835,1228,7207,1304,18574
"5215","Los Angeles County",2013-10-01,8832,1189,7205,1328,18554
"5216","Los Angeles County",2013-11-01,8623,1165,7312,1406,18506
"5217","Los Angeles County",2013-12-01,8838,1200,7082,1366,18486
"5218","Los Angeles County",2014-01-01,8686,1191,7262,1340,18479
"5219","Los Angeles County",2014-02-01,8687,1161,7420,1405,18673
"5220","Los Angeles County",2014-03-01,8771,1167,7352,1393,18683
"5221","Los Angeles County",2014-04-01,8552,1173,7525,1420,18670
"5222","Los Angeles County",2014-05-01,8862,1223,7263,1365,18713
"5223","Los Angeles County",2014-06-01,8651,1197,7469,1376,18693
"5224","Los Angeles County",2014-07-01,8501,1201,7446,1375,18523
"5225","Los Angeles County",2014-08-01,8713,1265,7249,1322,18549
"5226","Los Angeles County",2014-09-01,8756,1368,7096,1269,18489
"5227","Los Angeles County",2014-10-01,8431,1363,7072,1238,18104
"5228","Los Angeles County",2014-11-01,8167,1170,7110,1222,17669
"5229","Los Angeles County",2014-12-01,7970,1038,6014,1034,16056
"5230","Los Angeles County",2015-01-01,7558,1059,6549,1158,16324
"5231","Los Angeles County",2015-02-01,7888,1065,6574,1160,16687
"5232","Los Angeles County",2015-03-01,8049,1021,6454,1158,16682
"5233","Los Angeles County",2015-04-01,8181,1046,6293,1114,16634
"5234","Los Angeles County",2015-05-01,8079,1161,6333,1045,16618
"5235","Los Angeles County",2015-06-01,8295,1139,6172,1098,16704
"5236","Los Angeles County",2015-07-01,8183,1125,6242,1087,16637
"5237","Los Angeles County",2015-08-01,8262,1144,6124,1066,16596
"5238","Los Angeles County",2015-09-01,8364,852,6021,1347,16584
"5239","Los Angeles County",2015-10-01,8437,1184,6027,1019,16667
"5240","Los Angeles County",2015-11-01,7360,1080,6679,1026,16145
"5241","Los Angeles County",2015-12-01,8489,1147,5535,904,16075
"5242","Los Angeles County",2016-01-01,8480,1167,5530,881,16058
"5243","Los Angeles County",2016-02-01,8714,1144,5544,825,16227
"5244","Los Angeles County",2016-03-01,8333,1138,5903,902,16276
"5245","Los Angeles County",2016-04-01,8544,1196,5578,852,16170
"5246","Los Angeles County",2016-05-01,8892,1268,5336,832,16328
"5247","Los Angeles County",2016-06-01,8639,1253,5362,871,16125
"5248","Los Angeles County",2016-07-01,8465,1192,5593,886,16136
"5249","Los Angeles County",2016-08-01,8756,1184,5346,876,16162
"5250","Los Angeles County",2016-09-01,8401,1165,5703,908,16177
"5251","Los Angeles County",2016-10-01,8630,1203,5514,866,16213
"5252","Los Angeles County",2016-11-01,8649,1206,5466,856,16177
"5253","Los Angeles County",2016-12-01,8703,1204,5020,821,15748
"5254","Los Angeles County",2017-01-01,8543,1199,5307,890,15939
"5255","Los Angeles County",2017-02-01,8885,1301,5251,853,16290
"5256","Los Angeles County",2017-03-01,8562,1241,5756,925,16484
"5257","Los Angeles County",2017-04-01,8783,1254,5602,923,16562
"5258","Los Angeles County",2017-05-01,8914,1317,5588,904,16723
"5259","Los Angeles County",2017-06-01,8850,1324,5645,886,16705
"5260","Los Angeles County",2017-07-01,9206,1386,5284,905,16781
"5261","Los Angeles County",2017-08-01,8847,1367,5509,938,16661
"5262","Los Angeles County",2017-09-01,9079,1466,5519,884,16948
"5263","Los Angeles County",2017-10-01,9117,1395,5500,953,16965
"5264","Los Angeles County",2017-11-01,8979,1392,5494,920,16785
"5265","Los Angeles County",2017-12-01,8770,1350,5409,930,16459
"5266","Los Angeles County",2018-01-01,8813,1348,5357,927,16445
"5267","Los Angeles County",2018-02-01,8956,1288,5596,980,16820
"5268","Los Angeles County",2018-03-01,8958,1272,5554,883,16667
"5269","Los Angeles County",2018-04-01,8763,1296,5349,873,16281
"5270","Los Angeles County",2018-05-01,8683,1236,5573,930,16422
"5271","Los Angeles County",2018-06-01,8752,1277,5581,912,16522
"5272","Los Angeles County",2018-07-01,9285,1328,4954,829,16396
"5273","Los Angeles County",2018-08-01,9376,1360,5190,815,16741
"5274","Los Angeles County",2018-09-01,9232,1367,5263,824,16686
"5275","Los Angeles County",2018-10-01,9049,1299,5243,856,16447
"5276","Los Angeles County",2018-11-01,9156,1337,5175,839,16507
"5277","Los Angeles County",2018-12-01,9194,1239,4811,858,16102
"5278","Los Angeles County",2019-01-01,8872,1225,5124,843,16064
"5279","Los Angeles County",2019-02-01,9008,1225,5124,843,16200
"5280","Los Angeles County",2019-03-01,8969,1284,5290,844,16387
"5281","Los Angeles County",2019-04-01,9076,1322,5248,862,16508
"5282","Los Angeles County",2019-05-01,9028,1230,5475,904,16637
"5283","Los Angeles County",2019-06-01,9291,1379,5398,890,16958
"5284","Los Angeles County",2019-07-01,9513,1422,5238,811,16984
"5285","Los Angeles County",2019-08-01,9650,1418,5192,839,17099
"5286","Los Angeles County",2019-09-01,9720,1455,5189,786,17150
"5287","Los Angeles County",2019-10-01,9743,1396,5190,784,17113
"5288","Los Angeles County",2019-11-01,9346,1350,5490,824,17010
"5289","Los Angeles County",2019-12-01,9159,1351,5379,814,16703
"5290","Los Angeles County",2020-01-01,9089,1350,5336,825,16600
"5291","Los Angeles County",2020-02-01,9149,1350,5385,856,16740
"5292","Los Angeles County",2020-03-01,8868,1207,4942,790,15807
"5293","Madera County",1995-10-01,141.9,20.23,146.55,13.58,322.26
"5294","Madera County",1995-11-01,145.1,10.83,142.6,14.77,313.3
"5295","Madera County",1995-12-01,128.39,13.61,141.1,11.9,295
"5296","Madera County",1996-01-01,127.29,12.81,125.61,12.52,278.23
"5297","Madera County",1996-02-01,144.91,19.31,143.14,12.72,320.08
"5298","Madera County",1996-03-01,140.55,16.13,147.1,9.81,313.59
"5299","Madera County",1996-04-01,147.34,15.11,132.06,10.1,304.61
"5300","Madera County",1996-05-01,142.65,13.9,117.32,10.13,284
"5301","Madera County",1996-06-01,134.37,19.43,119.37,11.8,284.97
"5302","Madera County",1996-07-01,151,13.58,122.58,10.16,297.32
"5303","Madera County",1996-08-01,149.32,17.52,157.42,13.74,338
"5304","Madera County",1996-09-01,147.47,17.33,158.63,18.17,341.6
"5305","Madera County",1996-10-01,145.39,16.42,164.13,15.9,341.84
"5306","Madera County",1996-11-01,152.23,17.5,156.7,11.1,337.53
"5307","Madera County",1996-12-01,156.03,20.42,157.48,11.97,345.9
"5308","Madera County",1997-01-01,142.52,21.19,127.77,9.65,301.13
"5309","Madera County",1997-02-01,150.72,24.14,135.36,9.46,319.68
"5310","Madera County",1997-03-01,169.51,26.97,142.65,11.58,350.71
"5311","Madera County",1997-04-01,153,26,143.23,12.77,335
"5312","Madera County",1997-05-01,161.06,21.42,125.42,12.23,320.13
"5313","Madera County",1997-06-01,147.07,13.77,147.27,13.5,321.61
"5314","Madera County",1997-07-01,162.58,17.52,152.39,11.03,343.52
"5315","Madera County",1997-08-01,169.68,22.61,160,13.39,365.68
"5316","Madera County",1997-09-01,146.43,17.77,174.07,16.63,354.9
"5317","Madera County",1997-10-01,162.58,17.52,152.39,11.03,343.52
"5318","Madera County",1997-11-01,169.68,22.61,160,13.39,365.68
"5319","Madera County",1997-12-01,146.43,17.77,174.07,16.63,354.9
"5320","Madera County",1998-01-01,116.58,12.94,145.61,13.52,288.65
"5321","Madera County",1998-02-01,141.04,16.07,135.57,8.71,301.39
"5322","Madera County",1998-03-01,138.13,15.19,138.87,14.29,306.48
"5323","Madera County",1998-04-01,127.77,18.53,146.47,15,307.77
"5324","Madera County",1998-05-01,138.53,12.4,145.67,15.87,312.47
"5325","Madera County",1998-06-01,138.53,12.4,145.67,15.87,312.47
"5326","Madera County",1998-07-01,148.13,14.45,150.09,10.23,322.9
"5327","Madera County",1998-08-01,137.1,16.55,152.36,11.03,317.04
"5328","Madera County",1998-09-01,125.3,15,133.4,12.9,286.6
"5329","Madera County",1998-10-01,113.47,16.6,126.9,14.53,271.5
"5330","Madera County",1998-11-01,113.47,16.6,126.9,14.53,271.5
"5331","Madera County",1998-12-01,97.42,14.94,124.52,8.31,245.19
"5332","Madera County",1999-01-01,83.26,13.68,128.26,10.8,236
"5333","Madera County",1999-02-01,98.79,15.04,108.35,8.57,230.75
"5334","Madera County",1999-03-01,97.81,13.36,115.03,9.06,235.26
"5335","Madera County",1999-04-01,116.8,16.23,110.91,6.73,250.67
"5336","Madera County",1999-05-01,126.45,21.1,120.74,10.81,279.1
"5337","Madera County",1999-06-01,133.47,19.63,130.07,15.87,299.04
"5338","Madera County",1999-07-01,131.39,16.81,139.84,14,302.04
"5339","Madera County",1999-08-01,121.29,17.29,132.65,15.1,286.33
"5340","Madera County",1999-09-01,139.8,17.27,132,14.73,303.8
"5341","Madera County",1999-10-01,146.03,15,135.87,10.52,307.42
"5342","Madera County",1999-11-01,129.6,19.67,133.6,7.2,290.07
"5343","Madera County",1999-12-01,134.23,18.13,138.87,11.74,302.97
"5344","Madera County",2000-01-01,119.48,17.29,131.65,15.1,283.52
"5345","Madera County",2000-02-01,129.6,18.67,132.6,7.13,288
"5346","Madera County",2000-03-01,129.6,19.67,132.79,7.2,289.26
"5347","Madera County",2000-04-01,141.04,16.07,130.01,8.71,295.83
"5348","Madera County",2000-05-01,131.39,16.81,137.99,14,300.19
"5349","Madera County",2000-06-01,146.03,15,133.85,10.52,305.4
"5350","Madera County",2000-07-01,131.6,21.41,133.6,7.2,293.81
"5351","Madera County",2000-08-01,138,18.27,132,14.73,303
"5352","Madera County",2000-09-01,190,29,61,8,288
"5353","Madera County",2000-10-01,208,28,65,7,308
"5354","Madera County",2000-11-01,210,27,46,7,290
"5355","Madera County",2000-12-01,198,27,54,6,285
"5356","Madera County",2001-01-01,180,24,120,12,336
"5357","Madera County",2001-02-01,162,29,115,10,316
"5358","Madera County",2001-03-01,186,36,100,5,327
"5359","Madera County",2001-04-01,158,27,122,9,316
"5360","Madera County",2001-05-01,181,24,71,8,284
"5361","Madera County",2001-06-01,185,19,86,8,298
"5362","Madera County",2001-07-01,190,22,95,11,318
"5363","Madera County",2001-08-01,183,27,86,6,302
"5364","Madera County",2001-09-01,192,25,96,8,321
"5365","Madera County",2001-10-01,195,28,98,4,325
"5366","Madera County",2001-11-01,202,27,104,5,338
"5367","Madera County",2001-12-01,179,26,95,3,303
"5368","Madera County",2002-01-01,270,26,28,4,328
"5369","Madera County",2002-02-01,272,36,22,5,335
"5370","Madera County",2002-03-01,254,33,36,7,330
"5371","Madera County",2002-04-01,229,32,58,7,326
"5372","Madera County",2002-05-01,210,22,79,12,323
"5373","Madera County",2002-06-01,222,20,68,15,325
"5374","Madera County",2002-07-01,228,18,57,10,313
"5375","Madera County",2002-08-01,223,19,95,10,347
"5376","Madera County",2002-09-01,213,21,99,9,342
"5377","Madera County",2002-10-01,206,23,130,16,375
"5378","Madera County",2002-11-01,199,19,113,20,351
"5379","Madera County",2002-12-01,169,25,120,19,333
"5380","Madera County",2003-01-01,177,26,115,16,334
"5381","Madera County",2003-02-01,244,30,74,13,361
"5382","Madera County",2003-03-01,250,31,77,11,369
"5383","Madera County",2003-04-01,247,28,81,11,367
"5384","Madera County",2003-05-01,229,20,76,16,341
"5385","Madera County",2003-06-01,239,22,79,17,357
"5386","Madera County",2003-07-01,217,26,70,15,328
"5387","Madera County",2003-08-01,215,21,75,9,320
"5388","Madera County",2003-09-01,180,18,94,10,302
"5389","Madera County",2003-10-01,191,37,102,12,342
"5390","Madera County",2003-11-01,201,41,106,15,363
"5391","Madera County",2003-12-01,193,35,109,10,347
"5392","Madera County",2004-01-01,188,24,100,16,328
"5393","Madera County",2004-02-01,170,20,101,12,303
"5394","Madera County",2004-03-01,176,22,107,15,320
"5395","Madera County",2004-04-01,195,23,109,13,340
"5396","Madera County",2004-05-01,175,25,138,18,356
"5397","Madera County",2004-06-01,183,28,143,16,370
"5398","Madera County",2004-07-01,185,29,145,15,374
"5399","Madera County",2004-08-01,179,31,138,8,356
"5400","Madera County",2004-09-01,191,33,141,10,375
"5401","Madera County",2004-10-01,202,38,140,13,393
"5402","Madera County",2004-11-01,185,37,145,7,374
"5403","Madera County",2004-12-01,178,34,144,8,364
"5404","Madera County",2005-01-01,204,39,133,9,385
"5405","Madera County",2005-02-01,198,34,132,7,371
"5406","Madera County",2005-03-01,204,38,131,9,382
"5407","Madera County",2005-04-01,201,39,123,3,366
"5408","Madera County",2005-05-01,225,26,101,18,370
"5409","Madera County",2005-06-01,229,32,102,17,380
"5410","Madera County",2005-07-01,224,34,97,11,366
"5411","Madera County",2005-08-01,227,40,93,8,368
"5412","Madera County",2005-09-01,230,41,92,7,370
"5413","Madera County",2005-10-01,233,42,95,6,376
"5414","Madera County",2005-11-01,231,44,94,9,378
"5415","Madera County",2005-12-01,223,39,98,7,367
"5416","Madera County",2006-01-01,222,35,102,10,369
"5417","Madera County",2006-02-01,237,37,108,8,390
"5418","Madera County",2006-03-01,243,34,103,6,386
"5419","Madera County",2006-04-01,244,32,101,6,383
"5420","Madera County",2006-05-01,241,30,103,7,381
"5421","Madera County",2006-06-01,252,34,103,8,397
"5422","Madera County",2006-07-01,254,31,105,7,397
"5423","Madera County",2006-08-01,255,33,104,9,401
"5424","Madera County",2006-09-01,264,41,81,15,401
"5425","Madera County",2006-10-01,276,42,80,18,416
"5426","Madera County",2006-11-01,290,48,61,14,413
"5427","Madera County",2006-12-01,277,49,71,10,407
"5428","Madera County",2007-01-01,275,41,73,8,397
"5429","Madera County",2007-02-01,283,43,80,3,409
"5430","Madera County",2007-03-01,292,45,86,2,425
"5431","Madera County",2007-04-01,311,45,79,11,446
"5432","Madera County",2007-05-01,299,41,77,5,422
"5433","Madera County",2007-06-01,298,39,81,6,424
"5434","Madera County",2007-07-01,296,36,79,7,418
"5435","Madera County",2007-08-01,312,41,56,6,415
"5436","Madera County",2007-09-01,317,39,55,4,415
"5437","Madera County",2007-10-01,313,49,34,3,399
"5438","Madera County",2007-11-01,313,50,29,11,403
"5439","Madera County",2007-12-01,309,42,33,6,390
"5440","Madera County",2008-01-01,281,43,38,10,372
"5441","Madera County",2008-02-01,268,62,40,8,378
"5442","Madera County",2008-03-01,291,51,69,23,434
"5443","Madera County",2008-04-01,260,44,94,28,426
"5444","Madera County",2008-05-01,225,40,126,27,418
"5445","Madera County",2008-06-01,242,43,113,22,420
"5446","Madera County",2008-07-01,191,36,175,22,424
"5447","Madera County",2008-08-01,252,39,108,20,419
"5448","Madera County",2008-09-01,250,49,144,27,470
"5449","Madera County",2008-10-01,231,46,147,29,453
"5450","Madera County",2008-11-01,221,48,149,26,444
"5451","Madera County",2008-12-01,226,45,126,25,422
"5452","Madera County",2009-01-01,193,49,158,21,421
"5453","Madera County",2009-02-01,218,61,168,22,469
"5454","Madera County",2009-03-01,223,61,158,22,464
"5455","Madera County",2009-04-01,211,48,157,26,442
"5456","Madera County",2009-05-01,214,47,162,30,453
"5457","Madera County",2009-06-01,209,55,154,30,448
"5458","Madera County",2009-07-01,214,54,149,31,448
"5459","Madera County",2009-08-01,214,48,130,32,424
"5460","Madera County",2009-09-01,230,45,124,23,422
"5461","Madera County",2009-10-01,209,45,128,30,412
"5462","Madera County",2009-11-01,202,31,122,25,380
"5463","Madera County",2009-12-01,214,31,71,15,331
"5464","Madera County",2010-01-01,192,30,90,7,319
"5465","Madera County",2010-02-01,229,32,78,15,354
"5466","Madera County",2010-03-01,216,36,68,11,331
"5467","Madera County",2010-04-01,252,33,45,19,349
"5468","Madera County",2010-05-01,203,39,106,20,368
"5469","Madera County",2010-06-01,221,41,109,19,390
"5470","Madera County",2010-07-01,259,44,87,11,401
"5471","Madera County",2010-08-01,247,38,103,12,400
"5472","Madera County",2010-09-01,239,37,80,14,370
"5473","Madera County",2010-10-01,214,30,122,11,377
"5474","Madera County",2010-11-01,212,32,122,12,378
"5475","Madera County",2010-12-01,208,34,113,14,369
"5476","Madera County",2011-01-01,219,34,118,15,386
"5477","Madera County",2011-02-01,233,33,134,16,416
"5478","Madera County",2011-03-01,240,35,119,14,408
"5479","Madera County",2011-04-01,220,25,106,14,365
"5480","Madera County",2011-05-01,226,33,98,9,366
"5481","Madera County",2011-06-01,249,45,112,6,412
"5482","Madera County",2011-07-01,270,42,108,8,428
"5483","Madera County",2011-08-01,261,44,106,12,423
"5484","Madera County",2011-09-01,257,39,107,14,417
"5485","Madera County",2011-10-01,262,44,119,12,437
"5486","Madera County",2011-11-01,244,43,131,14,432
"5487","Madera County",2011-12-01,229,38,61,14,342
"5488","Madera County",2012-01-01,246,34,106,14,400
"5489","Madera County",2012-02-01,254,36,130,15,435
"5490","Madera County",2012-03-01,265,42,124,15,446
"5491","Madera County",2012-04-01,267,41,110,13,431
"5492","Madera County",2012-05-01,261,35,115,17,428
"5493","Madera County",2012-06-01,265,37,116,15,433
"5494","Madera County",2012-07-01,292,39,112,20,463
"5495","Madera County",2012-08-01,305,42,107,15,469
"5496","Madera County",2012-09-01,302,39,100,9,450
"5497","Madera County",2012-10-01,288,41,100,11,440
"5498","Madera County",2012-11-01,298,48,92,13,451
"5499","Madera County",2012-12-01,300,43,90,14,447
"5500","Madera County",2013-01-01,284,43,107,17,451
"5501","Madera County",2013-02-01,291,42,106,22,461
"5502","Madera County",2013-03-01,315,45,92,17,469
"5503","Madera County",2013-04-01,303,41,88,16,448
"5504","Madera County",2013-05-01,294,42,70,11,417
"5505","Madera County",2013-06-01,277,39,75,11,402
"5506","Madera County",2013-07-01,295,42,72,14,423
"5507","Madera County",2013-08-01,311,41,78,21,451
"5508","Madera County",2013-09-01,300,44,84,23,451
"5509","Madera County",2013-10-01,334,53,57,9,453
"5510","Madera County",2013-11-01,344,57,48,8,457
"5511","Madera County",2013-12-01,345,54,46,5,450
"5512","Madera County",2014-01-01,335,53,47,6,441
"5513","Madera County",2014-02-01,328,53,63,8,452
"5514","Madera County",2014-03-01,342,57,57,5,461
"5515","Madera County",2014-04-01,347,58,58,7,470
"5516","Madera County",2014-05-01,342,57,57,5,461
"5517","Madera County",2014-06-01,346,56,60,9,471
"5518","Madera County",2014-07-01,341,53,63,7,464
"5519","Madera County",2014-08-01,350,57,61,6,474
"5520","Madera County",2014-09-01,347,56,54,6,463
"5521","Madera County",2014-10-01,346,52,48,6,452
"5522","Madera County",2014-11-01,342,48,53,7,450
"5523","Madera County",2014-12-01,315,40,51,5,411
"5524","Madera County",2015-01-01,325,37,44,9,415
"5525","Madera County",2015-02-01,326,44,48,7,425
"5526","Madera County",2015-03-01,318,36,52,7,413
"5527","Madera County",2015-04-01,317,37,57,5,416
"5528","Madera County",2015-05-01,289,35,47,6,377
"5529","Madera County",2015-06-01,292,40,53,9,394
"5530","Madera County",2015-07-01,289,41,60,13,403
"5531","Madera County",2015-08-01,269,37,75,10,391
"5532","Madera County",2015-09-01,276,39,70,12,397
"5533","Madera County",2015-10-01,261,39,68,10,378
"5534","Madera County",2015-11-01,254,41,64,11,370
"5535","Madera County",2015-12-01,248,35,70,12,365
"5536","Madera County",2016-01-01,253,36,71,11,371
"5537","Madera County",2016-02-01,247,37,77,9,370
"5538","Madera County",2016-03-01,256,39,75,12,382
"5539","Madera County",2016-04-01,249,42,72,8,371
"5540","Madera County",2016-05-01,271,42,78,5,396
"5541","Madera County",2016-06-01,309,43,94,3,449
"5542","Madera County",2016-07-01,303,44,65,9,421
"5543","Madera County",2016-08-01,288,39,77,12,416
"5544","Madera County",2016-09-01,290,41,96,11,438
"5545","Madera County",2016-10-01,291,41,95,9,436
"5546","Madera County",2016-11-01,254,41,117,10,422
"5547","Madera County",2016-12-01,253,36,101,12,402
"5548","Madera County",2017-01-01,277,35,94,12,418
"5549","Madera County",2017-02-01,296,40,106,11,453
"5550","Madera County",2017-03-01,306,38,105,14,463
"5551","Madera County",2017-04-01,310,47,99,11,467
"5552","Madera County",2017-05-01,318,50,90,11,469
"5553","Madera County",2017-06-01,261,39,64,2,366
"5554","Madera County",2017-07-01,280,37,74,8,399
"5555","Madera County",2017-08-01,288,42,82,10,422
"5556","Madera County",2017-09-01,294,46,81,11,432
"5557","Madera County",2017-10-01,319,46,68,9,442
"5558","Madera County",2017-11-01,335,53,78,7,473
"5559","Madera County",2017-12-01,311,54,57,9,431
"5560","Madera County",2018-01-01,311,48,64,10,433
"5561","Madera County",2018-02-01,334,40,75,12,461
"5562","Madera County",2018-03-01,336,39,76,12,463
"5563","Madera County",2018-04-01,304,38,68,13,423
"5564","Madera County",2018-05-01,307,38,68,13,426
"5565","Madera County",2018-06-01,315,48,66,9,438
"5566","Madera County",2018-07-01,332,41,74,14,461
"5567","Madera County",2018-08-01,331,50,69,9,459
"5568","Madera County",2018-09-01,330,41,73,14,458
"5569","Madera County",2018-10-01,322,35,71,13,441
"5570","Madera County",2018-11-01,315,48,66,9,438
"5571","Madera County",2018-12-01,318,49,66,9,442
"5572","Madera County",2019-01-01,321,50,63,7,441
"5573","Madera County",2019-02-01,323,48,76,9,456
"5574","Madera County",2019-03-01,341,49,71,12,473
"5575","Madera County",2019-04-01,334,46,79,14,473
"5576","Madera County",2019-05-01,325,51,81,14,471
"5577","Madera County",2019-06-01,308,59,92,15,474
"5578","Madera County",2019-07-01,302,57,99,13,471
"5579","Madera County",2019-08-01,293,54,109,14,470
"5580","Madera County",2019-09-01,289,54,121,16,480
"5581","Madera County",2019-10-01,291,50,113,15,469
"5582","Madera County",2019-11-01,287,51,112,15,465
"5583","Madera County",2019-12-01,283,53,109,15,460
"5584","Madera County",2020-01-01,293,53,94,12,452
"5585","Madera County",2020-02-01,288,59,107,12,466
"5586","Madera County",2020-03-01,243,50,94,9,396
"5587","Marin County",1995-10-01,164,27,78,13,282
"5588","Marin County",1995-11-01,164,23,67,21,275
"5589","Marin County",1995-12-01,164,20,57,20,261
"5590","Marin County",1996-01-01,176,20,48,9,253
"5591","Marin County",1996-02-01,182,25,42,5,254
"5592","Marin County",1996-03-01,176,26,53,5,260
"5593","Marin County",1996-04-01,185,28,52,10,275
"5594","Marin County",1996-05-01,203,31,54,16,304
"5595","Marin County",1996-06-01,186,33,56,13,288
"5596","Marin County",1996-07-01,197,30,54,10,291
"5597","Marin County",1996-08-01,196,30,53,15,294
"5598","Marin County",1996-09-01,210,29,49,12,300
"5599","Marin County",1996-10-01,191,30,54,14,289
"5600","Marin County",1996-11-01,187,35,50,15,287
"5601","Marin County",1996-12-01,177,34,58,12,281
"5602","Marin County",1997-01-01,185,34,49,13,281
"5603","Marin County",1997-02-01,195,28,56,11,290
"5604","Marin County",1997-03-01,204,29,61,14,308
"5605","Marin County",1997-04-01,208,31,55,9,303
"5606","Marin County",1997-05-01,208,30,48,11,297
"5607","Marin County",1997-06-01,194,26,53,9,282
"5608","Marin County",1997-07-01,197,28,64,8,297
"5609","Marin County",1997-08-01,197,28,58,9,292
"5610","Marin County",1997-09-01,213,24,48,10,295
"5611","Marin County",1997-10-01,198,30,48,12,288
"5612","Marin County",1997-11-01,182,26,59,11,278
"5613","Marin County",1997-12-01,181,21,49,12,263
"5614","Marin County",1998-01-01,195,18,47,10,270
"5615","Marin County",1998-02-01,204,25,49,9,287
"5616","Marin County",1998-03-01,197,30,51,8,286
"5617","Marin County",1998-04-01,179,31,60,6,276
"5618","Marin County",1998-05-01,182,30,49,5,266
"5619","Marin County",1998-06-01,179,30,50,9,268
"5620","Marin County",1998-07-01,175,29,46,6,256
"5621","Marin County",1998-08-01,171,25,41,7,244
"5622","Marin County",1998-09-01,181,27,41,7,256
"5623","Marin County",1998-10-01,166,24,41,9,240
"5624","Marin County",1998-11-01,162,24,39,9,234
"5625","Marin County",1998-12-01,183,31,37,8,259
"5626","Marin County",1999-01-01,188,32,46,10,276
"5627","Marin County",1999-02-01,183,28,47,19,277
"5628","Marin County",1999-03-01,183,31,50,13,277
"5629","Marin County",1999-04-01,181,35,52,13,281
"5630","Marin County",1999-05-01,183,40,54,13,290
"5631","Marin County",1999-06-01,184,47,43,9,283
"5632","Marin County",1999-07-01,195,53,37,5,290
"5633","Marin County",1999-08-01,198,47,34,5,284
"5634","Marin County",1999-09-01,203,44,38,5,290
"5635","Marin County",1999-10-01,214,43,35,7,299
"5636","Marin County",1999-11-01,213,43,36,4,296
"5637","Marin County",1999-12-01,213,47,40,7,307
"5638","Marin County",2000-01-01,209,48,36,7,300
"5639","Marin County",2000-02-01,212,44,33,9,298
"5640","Marin County",2000-03-01,206,41,31,10,288
"5641","Marin County",2000-04-01,197,42,32,9,280
"5642","Marin County",2000-05-01,192,36,27,13,268
"5643","Marin County",2000-06-01,196,30,25,12,263
"5644","Marin County",2000-07-01,194,32,28,13,267
"5645","Marin County",2000-08-01,194,32,34,13,273
"5646","Marin County",2000-09-01,205,39,38,10,292
"5647","Marin County",2000-10-01,223,41,37,8,309
"5648","Marin County",2000-11-01,215,46,40,8,309
"5649","Marin County",2000-12-01,214,43,34,10,301
"5650","Marin County",2001-01-01,210,38,30,9,287
"5651","Marin County",2001-02-01,201,42,29,10,282
"5652","Marin County",2001-03-01,210,40,34,11,295
"5653","Marin County",2001-04-01,206,36,31,9,282
"5654","Marin County",2001-05-01,207,33,38,8,286
"5655","Marin County",2001-06-01,206,26,38,8,278
"5656","Marin County",2001-07-01,210,23,34,9,276
"5657","Marin County",2001-08-01,207,24,33,9,273
"5658","Marin County",2001-09-01,211,26,36,9,282
"5659","Marin County",2001-10-01,223,31,36,9,299
"5660","Marin County",2001-11-01,225,36,36,7,304
"5661","Marin County",2001-12-01,225,30,35,6,296
"5662","Marin County",2002-01-01,221,35,37,9,302
"5663","Marin County",2002-02-01,217,41,35,7,300
"5664","Marin County",2002-03-01,218,39,30,9,296
"5665","Marin County",2002-04-01,225,38,32,7,302
"5666","Marin County",2002-05-01,230,30,34,6,300
"5667","Marin County",2002-06-01,208,31,32,8,279
"5668","Marin County",2002-07-01,200,34,31,6,271
"5669","Marin County",2002-08-01,190,33,30,7,260
"5670","Marin County",2002-09-01,209,33,23,8,273
"5671","Marin County",2002-10-01,211,33,20,9,273
"5672","Marin County",2002-11-01,220,36,26,6,288
"5673","Marin County",2002-12-01,206,31,28,7,272
"5674","Marin County",2003-01-01,209,31,30,6,276
"5675","Marin County",2003-02-01,212,33,31,8,284
"5676","Marin County",2003-03-01,209,36,30,9,284
"5677","Marin County",2003-04-01,215,36,28,7,286
"5678","Marin County",2003-05-01,214,39,23,11,287
"5679","Marin County",2003-06-01,214,38,26,7,285
"5680","Marin County",2003-07-01,213,34,32,6,285
"5681","Marin County",2003-08-01,225,40,26,4,295
"5682","Marin County",2003-09-01,219,37,27,8,291
"5683","Marin County",2003-10-01,210,43,28,8,289
"5684","Marin County",2003-11-01,208,36,33,7,284
"5685","Marin County",2003-12-01,207,30,27,9,273
"5686","Marin County",2004-01-01,209,25,30,6,270
"5687","Marin County",2004-02-01,204,26,37,4,271
"5688","Marin County",2004-03-01,201,27,41,6,275
"5689","Marin County",2004-04-01,201,29,38,5,273
"5690","Marin County",2004-05-01,213,30,34,6,283
"5691","Marin County",2004-06-01,217,33,30,5,285
"5692","Marin County",2004-07-01,236,33,29,6,304
"5693","Marin County",2004-08-01,230,28,34,5,297
"5694","Marin County",2004-09-01,245,38,37,5,325
"5695","Marin County",2004-10-01,224,33,39,7,303
"5696","Marin County",2004-11-01,218,29,36,8,291
"5697","Marin County",2004-12-01,202,34,29,4,269
"5698","Marin County",2005-01-01,212,29,30,5,276
"5699","Marin County",2005-02-01,230,36,30,5,301
"5700","Marin County",2005-03-01,237,37,33,4,311
"5701","Marin County",2005-04-01,243,34,35,4,316
"5702","Marin County",2005-05-01,253,32,33,5,323
"5703","Marin County",2005-06-01,253,33,23,4,313
"5704","Marin County",2005-07-01,257,35,19,5,316
"5705","Marin County",2005-08-01,265,31,23,5,324
"5706","Marin County",2005-09-01,248,32,22,4,306
"5707","Marin County",2005-10-01,252,35,23,4,314
"5708","Marin County",2005-11-01,246,38,30,3,317
"5709","Marin County",2005-12-01,260,40,16,4,320
"5710","Marin County",2006-01-01,242,33,30,5,310
"5711","Marin County",2006-02-01,210,26,78,14,328
"5712","Marin County",2006-03-01,226,23,66,11,326
"5713","Marin County",2006-04-01,234,31,57,7,329
"5714","Marin County",2006-05-01,232,33,55,8,328
"5715","Marin County",2006-06-01,227,36,47,9,319
"5716","Marin County",2006-07-01,211,33,44,8,296
"5717","Marin County",2006-08-01,228,36,37,7,308
"5718","Marin County",2006-09-01,230,36,40,11,317
"5719","Marin County",2006-10-01,239,38,39,10,326
"5720","Marin County",2006-11-01,225,35,47,10,317
"5721","Marin County",2006-12-01,224,32,49,9,314
"5722","Marin County",2007-01-01,237,29,49,9,324
"5723","Marin County",2007-02-01,222,25,62,10,319
"5724","Marin County",2007-03-01,213,30,62,10,315
"5725","Marin County",2007-04-01,234,33,47,11,325
"5726","Marin County",2007-05-01,238,32,39,11,320
"5727","Marin County",2007-06-01,230,33,38,13,314
"5728","Marin County",2007-07-01,231,35,37,4,307
"5729","Marin County",2007-08-01,226,32,47,5,310
"5730","Marin County",2007-09-01,230,25,44,8,307
"5731","Marin County",2007-10-01,212,26,43,8,289
"5732","Marin County",2007-11-01,220,28,38,4,290
"5733","Marin County",2007-12-01,224,27,41,5,297
"5734","Marin County",2008-01-01,231,31,38,8,308
"5735","Marin County",2008-02-01,230,36,36,8,310
"5736","Marin County",2008-03-01,238,35,41,12,326
"5737","Marin County",2008-04-01,241,30,48,15,334
"5738","Marin County",2008-05-01,226,34,48,15,323
"5739","Marin County",2008-06-01,221,35,56,20,332
"5740","Marin County",2008-07-01,225,33,57,16,331
"5741","Marin County",2008-08-01,224,29,49,11,313
"5742","Marin County",2008-09-01,212,28,50,7,297
"5743","Marin County",2008-10-01,209,20,45,12,286
"5744","Marin County",2008-11-01,210,21,46,17,294
"5745","Marin County",2008-12-01,183,15,48,13,259
"5746","Marin County",2009-01-01,192,18,42,9,261
"5747","Marin County",2009-02-01,206,23,45,11,285
"5748","Marin County",2009-03-01,232,22,48,14,316
"5749","Marin County",2009-04-01,240,22,44,11,317
"5750","Marin County",2009-05-01,235,24,44,8,311
"5751","Marin County",2009-06-01,223,29,61,8,321
"5752","Marin County",2009-07-01,222,27,63,8,320
"5753","Marin County",2009-08-01,232,26,53,9,320
"5754","Marin County",2009-09-01,238,24,51,14,327
"5755","Marin County",2009-10-01,221,21,54,15,311
"5756","Marin County",2009-11-01,209,21,53,11,294
"5757","Marin County",2009-12-01,188,21,51,7,267
"5758","Marin County",2010-01-01,202,20,47,9,278
"5759","Marin County",2010-02-01,201,20,35,6,262
"5760","Marin County",2010-03-01,197,20,37,8,262
"5761","Marin County",2010-04-01,199,22,45,8,274
"5762","Marin County",2010-05-01,197,23,35,12,267
"5763","Marin County",2010-06-01,217,23,44,13,297
"5764","Marin County",2010-07-01,208,23,47,12,290
"5765","Marin County",2010-08-01,206,26,54,14,300
"5766","Marin County",2010-09-01,217,23,52,16,308
"5767","Marin County",2010-10-01,214,20,54,13,301
"5768","Marin County",2010-11-01,211,20,51,10,292
"5769","Marin County",2010-12-01,213,20,43,12,288
"5770","Marin County",2011-01-01,211,23,36,11,281
"5771","Marin County",2011-02-01,198,22,44,11,275
"5772","Marin County",2011-03-01,212,20,49,12,293
"5773","Marin County",2011-04-01,231,20,47,13,311
"5774","Marin County",2011-05-01,224,24,49,13,310
"5775","Marin County",2011-06-01,211,17,54,13,295
"5776","Marin County",2011-07-01,224,20,48,5,297
"5777","Marin County",2011-08-01,226,19,39,9,293
"5778","Marin County",2011-09-01,220,23,39,10,292
"5779","Marin County",2011-10-01,219,22,38,17,296
"5780","Marin County",2011-11-01,194,28,55,14,291
"5781","Marin County",2011-12-01,182,25,60,14,281
"5782","Marin County",2012-01-01,187,27,48,15,277
"5783","Marin County",2012-02-01,189,23,49,12,273
"5784","Marin County",2012-03-01,186,26,55,12,279
"5785","Marin County",2012-04-01,202,23,55,10,290
"5786","Marin County",2012-05-01,206,25,61,8,300
"5787","Marin County",2012-06-01,214,23,61,13,311
"5788","Marin County",2012-07-01,228,20,54,15,317
"5789","Marin County",2012-08-01,216,25,62,15,318
"5790","Marin County",2012-09-01,207,20,60,16,303
"5791","Marin County",2012-10-01,202,20,58,11,291
"5792","Marin County",2012-11-01,187,26,55,11,279
"5793","Marin County",2012-12-01,168,20,50,15,253
"5794","Marin County",2013-01-01,176,25,54,17,272
"5795","Marin County",2013-02-01,190,31,57,18,296
"5796","Marin County",2013-03-01,186,29,53,16,284
"5797","Marin County",2013-04-01,202,31,49,12,294
"5798","Marin County",2013-05-01,201,30,56,11,298
"5799","Marin County",2013-06-01,187,28,56,12,283
"5800","Marin County",2013-07-01,195,25,58,10,288
"5801","Marin County",2013-08-01,201,29,57,12,299
"5802","Marin County",2013-09-01,195,27,44,10,276
"5803","Marin County",2013-10-01,194,23,37,9,263
"5804","Marin County",2013-11-01,192,23,45,13,273
"5805","Marin County",2013-12-01,197,28,53,14,292
"5806","Marin County",2014-01-01,197,30,54,13,294
"5807","Marin County",2014-02-01,195,29,66,13,303
"5808","Marin County",2014-03-01,189,25,71,14,299
"5809","Marin County",2014-04-01,174,29,74,13,290
"5810","Marin County",2014-05-01,178,25,72,12,287
"5811","Marin County",2014-06-01,180,24,74,10,288
"5812","Marin County",2014-07-01,172,24,68,10,274
"5813","Marin County",2014-08-01,169,32,64,12,277
"5814","Marin County",2014-09-01,171,26,81,13,291
"5815","Marin County",2014-10-01,163,28,80,12,283
"5816","Marin County",2014-11-01,163,25,72,12,272
"5817","Marin County",2014-12-01,155,19,61,14,249
"5818","Marin County",2015-01-01,159,22,58,15,254
"5819","Marin County",2015-02-01,164,25,66,15,270
"5820","Marin County",2015-03-01,159,25,69,14,267
"5821","Marin County",2015-04-01,148,21,57,11,237
"5822","Marin County",2015-05-01,158,29,56,9,252
"5823","Marin County",2015-06-01,169,30,58,10,267
"5824","Marin County",2015-07-01,165,28,66,10,269
"5825","Marin County",2015-08-01,147,28,75,8,258
"5826","Marin County",2015-09-01,160,26,82,10,278
"5827","Marin County",2015-10-01,170,31,75,11,287
"5828","Marin County",2015-11-01,174,33,59,11,277
"5829","Marin County",2015-12-01,179,31,56,14,280
"5830","Marin County",2016-01-01,202,33,46,22,303
"5831","Marin County",2016-02-01,204,33,54,15,306
"5832","Marin County",2016-03-01,201,38,53,13,305
"5833","Marin County",2016-04-01,199,36,64,14,313
"5834","Marin County",2016-05-01,210,34,61,20,325
"5835","Marin County",2016-06-01,211,33,53,16,313
"5836","Marin County",2016-07-01,210,24,40,17,291
"5837","Marin County",2016-08-01,229,26,51,18,324
"5838","Marin County",2016-09-01,222,30,62,16,330
"5839","Marin County",2016-10-01,220,39,65,11,335
"5840","Marin County",2016-11-01,209,38,73,17,337
"5841","Marin County",2016-12-01,220,30,63,17,330
"5842","Marin County",2017-01-01,219,36,62,49,366
"5843","Marin County",2017-02-01,208,34,76,18,336
"5844","Marin County",2017-03-01,193,35,79,16,323
"5845","Marin County",2017-04-01,196,33,68,21,318
"5846","Marin County",2017-05-01,195,34,64,18,311
"5847","Marin County",2017-06-01,189,36,66,21,312
"5848","Marin County",2017-07-01,183,34,67,21,305
"5849","Marin County",2017-08-01,197,35,58,16,306
"5850","Marin County",2017-09-01,212,35,60,17,324
"5851","Marin County",2017-10-01,219,37,56,18,330
"5852","Marin County",2017-11-01,220,43,54,15,332
"5853","Marin County",2017-12-01,223,43,49,13,328
"5854","Marin County",2018-01-01,235,48,51,9,343
"5855","Marin County",2018-02-01,201,47,57,12,317
"5856","Marin County",2018-03-01,195,42,58,16,311
"5857","Marin County",2018-04-01,199,37,70,14,320
"5858","Marin County",2018-05-01,201,37,66,13,317
"5859","Marin County",2018-06-01,205,37,68,15,325
"5860","Marin County",2018-07-01,206,34,67,14,321
"5861","Marin County",2018-08-01,199,32,78,12,321
"5862","Marin County",2018-09-01,190,30,84,16,320
"5863","Marin County",2018-10-01,186,30,85,17,318
"5864","Marin County",2018-11-01,186,32,73,15,306
"5865","Marin County",2018-12-01,195,29,81,19,324
"5866","Marin County",2019-01-01,220,28,76,19,343
"5867","Marin County",2019-02-01,191,26,71,14,302
"5868","Marin County",2019-03-01,184,23,61,12,280
"5869","Marin County",2019-04-01,177,23,54,8,262
"5870","Marin County",2019-05-01,172,22,59,12,265
"5871","Marin County",2019-06-01,168,24,73,8,273
"5872","Marin County",2019-07-01,182,25,61,9,277
"5873","Marin County",2019-08-01,188,22,56,15,281
"5874","Marin County",2019-09-01,182,28,59,15,284
"5875","Marin County",2019-10-01,172,24,66,15,277
"5876","Marin County",2019-11-01,169,25,60,18,272
"5877","Marin County",2019-12-01,171,29,48,17,265
"5878","Marin County",2020-01-01,179,30,51,13,273
"5879","Marin County",2020-02-01,171,29,58,14,272
"5880","Marin County",2020-03-01,159,24,54,14,251
"5881","Mariposa County",1995-10-01,22.5,2.8,18.3,2.9,46.5
"5882","Mariposa County",1995-11-01,20.3,2.7,16.2,2.8,42
"5883","Mariposa County",1995-12-01,21.3,0.4,11.9,3.9,37.5
"5884","Mariposa County",1996-01-01,19.6,0.6,18.2,2.8,41.2
"5885","Mariposa County",1996-02-01,24.5,3.2,12.7,1.5,41.9
"5886","Mariposa County",1996-03-01,23.2,3.5,16.5,1.3,44.5
"5887","Mariposa County",1996-04-01,21.8,2.8,17.2,1,42.8
"5888","Mariposa County",1996-05-01,13.8,2.8,19.5,1.2,37.3
"5889","Mariposa County",1996-06-01,14.1,2.4,16.4,2.6,35.5
"5890","Mariposa County",1996-07-01,17.9,0.5,18,5.2,41.6
"5891","Mariposa County",1996-08-01,12.6,1.3,21,3.9,38.8
"5892","Mariposa County",1996-09-01,15,2.9,25.3,1.8,45
"5893","Mariposa County",1996-10-01,17.2,3.4,25.3,1.6,47.5
"5894","Mariposa County",1996-11-01,15.8,2,22.4,1.8,42
"5895","Mariposa County",1996-12-01,16.1,1.3,19,2.3,38.7
"5896","Mariposa County",1997-01-01,19.5,4.7,17.3,1.7,43.2
"5897","Mariposa County",1997-02-01,17.3,2.5,16.7,4.3,40.8
"5898","Mariposa County",1997-03-01,21.1,2,13.9,3.4,40.4
"5899","Mariposa County",1997-04-01,14,0.4,17,1.9,33.3
"5900","Mariposa County",1997-05-01,15.5,1.7,18,1.5,36.7
"5901","Mariposa County",1997-06-01,21.4,2.5,13.8,2.2,39.9
"5902","Mariposa County",1997-07-01,24.3,5.1,15.7,4,49.1
"5903","Mariposa County",1997-08-01,26.9,6.3,12.7,3.3,49.2
"5904","Mariposa County",1997-09-01,25.8,1.6,19.1,6.1,52.6
"5905","Mariposa County",1997-10-01,27.7,3.3,18.1,4,53.1
"5906","Mariposa County",1997-11-01,31,1.5,15,1.8,49.3
"5907","Mariposa County",1997-12-01,26.1,1.7,17.5,0.2,45.5
"5908","Mariposa County",1998-01-01,31.7,2,19,0.2,52.9
"5909","Mariposa County",1998-02-01,24.8,4.9,24.9,0.4,55
"5910","Mariposa County",1998-03-01,24.7,4.4,21.9,2.7,53.7
"5911","Mariposa County",1998-04-01,32,4.8,22,2.3,61.1
"5912","Mariposa County",1998-05-01,24.2,3.6,20.6,4.7,53.1
"5913","Mariposa County",1998-06-01,23.8,1.2,22.3,4.3,51.6
"5914","Mariposa County",1998-07-01,26,1.6,21,1.2,49.8
"5915","Mariposa County",1998-08-01,23.9,3.2,21.7,0.6,49.4
"5916","Mariposa County",1998-09-01,25.1,3.6,20,0.6,49.3
"5917","Mariposa County",1998-10-01,17.5,2.7,20.7,4.3,45.2
"5918","Mariposa County",1998-11-01,17.5,2.1,17.4,2.6,39.6
"5919","Mariposa County",1998-12-01,16.1,2.6,12.3,1.2,32.2
"5920","Mariposa County",1999-01-01,24.7,2.8,13.3,2.5,43.3
"5921","Mariposa County",1999-02-01,28.6,2.1,16.6,3.6,50.9
"5922","Mariposa County",1999-03-01,29.3,2.2,20,3,54.5
"5923","Mariposa County",1999-04-01,33.5,3.4,17.9,3.5,58.3
"5924","Mariposa County",1999-05-01,28.2,3.4,22.7,3.3,57.6
"5925","Mariposa County",1999-06-01,31.2,2.6,13.4,2.9,50.1
"5926","Mariposa County",1999-07-01,31.3,2.8,10.2,2.5,46.8
"5927","Mariposa County",1999-08-01,38.4,3.5,11.9,1.4,55.2
"5928","Mariposa County",1999-09-01,31.6,2.8,19,0.2,53.6
"5929","Mariposa County",1999-10-01,28.4,2.2,17.9,1,49.5
"5930","Mariposa County",1999-11-01,27.2,2.7,13.5,0.4,43.8
"5931","Mariposa County",1999-12-01,20.4,1.1,13.8,0.4,35.7
"5932","Mariposa County",2000-01-01,16.7,2,20.1,0.9,39.7
"5933","Mariposa County",2000-02-01,16.9,3.2,18.1,0.5,38.7
"5934","Mariposa County",2000-03-01,14.8,4.3,20.1,2.6,41.8
"5935","Mariposa County",2000-04-01,19.5,3.3,21.1,3.7,47.6
"5936","Mariposa County",2000-05-01,17.2,3.5,11.5,1.1,33.3
"5937","Mariposa County",2000-06-01,13.7,3.1,10.1,1.4,28.3
"5938","Mariposa County",2000-07-01,16.4,2.5,13.9,2.6,35.4
"5939","Mariposa County",2000-08-01,23.3,1.6,12.5,3,40.4
"5940","Mariposa County",2000-09-01,20.5,0.9,17.1,2.1,40.6
"5941","Mariposa County",2000-10-01,13.6,2.5,20.2,2.1,38.4
"5942","Mariposa County",2000-11-01,10.5,3.2,22.6,2.6,38.9
"5943","Mariposa County",2000-12-01,11.5,2,21.9,1.4,36.8
"5944","Mariposa County",2001-01-01,10,2,23,2,37
"5945","Mariposa County",2001-02-01,16,6,14,2,37
"5946","Mariposa County",2001-03-01,16,5,19,4,44
"5947","Mariposa County",2001-04-01,18,4,20,2,44
"5948","Mariposa County",2001-05-01,16,1,19,1,36
"5949","Mariposa County",2001-06-01,9,2,19,3,34
"5950","Mariposa County",2001-07-01,15,3,16,3,36
"5951","Mariposa County",2001-08-01,20,4,12,1,38
"5952","Mariposa County",2001-09-01,20,5,12,2,39
"5953","Mariposa County",2001-10-01,25,4,17,3,49
"5954","Mariposa County",2001-11-01,18,2,18,5,43
"5955","Mariposa County",2001-12-01,23,2,13,4,42
"5956","Mariposa County",2002-01-01,18,2,19,3,42
"5957","Mariposa County",2002-02-01,18,2,18,0,38
"5958","Mariposa County",2002-03-01,20,3,19,1,43
"5959","Mariposa County",2002-04-01,22,2,15,3,42
"5960","Mariposa County",2002-05-01,21,3,17,2,43
"5961","Mariposa County",2002-06-01,22,5,19,1,47
"5962","Mariposa County",2002-07-01,17,1,23,4,45
"5963","Mariposa County",2002-08-01,22,4,20,3,49
"5964","Mariposa County",2002-09-01,19,4,21,4,48
"5965","Mariposa County",2002-10-01,11,1,19,5,36
"5966","Mariposa County",2002-11-01,17,3,19,2,41
"5967","Mariposa County",2002-12-01,10,1,19,3,33
"5968","Mariposa County",2003-01-01,13,1,17,2,33
"5969","Mariposa County",2003-02-01,14,2,17,2,35
"5970","Mariposa County",2003-03-01,18,2,20,3,43
"5971","Mariposa County",2003-04-01,17,1,19,5,42
"5972","Mariposa County",2003-05-01,15,0,12,3,30
"5973","Mariposa County",2003-06-01,19,2,15,2,38
"5974","Mariposa County",2003-07-01,15,1,15,2,33
"5975","Mariposa County",2003-08-01,11,3,20,1,35
"5976","Mariposa County",2003-09-01,12,2,22,3,39
"5977","Mariposa County",2003-10-01,14,2,21,4,41
"5978","Mariposa County",2003-11-01,19,3,15,2,39
"5979","Mariposa County",2003-12-01,17,3,13,1,34
"5980","Mariposa County",2004-01-01,17,3,14,3,37
"5981","Mariposa County",2004-02-01,22,4,16,4,46
"5982","Mariposa County",2004-03-01,24,3,20,6,53
"5983","Mariposa County",2004-04-01,27,3,21,3,54
"5984","Mariposa County",2004-05-01,21,5,19,1,46
"5985","Mariposa County",2004-06-01,25,4,12,4,45
"5986","Mariposa County",2004-07-01,27,2,16,4,49
"5987","Mariposa County",2004-08-01,20,1,23,6,50
"5988","Mariposa County",2004-09-01,29,2,20,5,56
"5989","Mariposa County",2004-10-01,34,5,16,2,57
"5990","Mariposa County",2004-11-01,30,3,16,4,53
"5991","Mariposa County",2004-12-01,28,4,15,3,50
"5992","Mariposa County",2005-01-01,19,5,14,4,42
"5993","Mariposa County",2005-02-01,23,4,14,6,47
"5994","Mariposa County",2005-03-01,27,4,19,4,54
"5995","Mariposa County",2005-04-01,27,4,21,5,57
"5996","Mariposa County",2005-05-01,22,6,17,6,51
"5997","Mariposa County",2005-06-01,29,7,10,5,51
"5998","Mariposa County",2005-07-01,22,5,23,7,57
"5999","Mariposa County",2005-08-01,25,5,23,9,62
"6000","Mariposa County",2005-09-01,25,5,24,8,62
"6001","Mariposa County",2005-10-01,24,4,28,4,60
"6002","Mariposa County",2005-11-01,27,4,27,3,61
"6003","Mariposa County",2005-12-01,28,6,24,3,61
"6004","Mariposa County",2006-01-01,30,5,23,4,62
"6005","Mariposa County",2006-02-01,20,5,32,4,61
"6006","Mariposa County",2006-03-01,23,6,27,1,57
"6007","Mariposa County",2006-04-01,22,5,24,3,54
"6008","Mariposa County",2006-05-01,25,4,23,3,55
"6009","Mariposa County",2006-06-01,26,4,19,5,54
"6010","Mariposa County",2006-07-01,20,5,22,3,50
"6011","Mariposa County",2006-08-01,21,2,18,5,46
"6012","Mariposa County",2006-09-01,21,5,17,6,49
"6013","Mariposa County",2006-10-01,22,3,16,7,48
"6014","Mariposa County",2006-11-01,26,2,17,7,52
"6015","Mariposa County",2006-12-01,31,2,16,5,54
"6016","Mariposa County",2007-01-01,29,3,19,6,57
"6017","Mariposa County",2007-02-01,28,3,24,3,58
"6018","Mariposa County",2007-03-01,28,3,25,3,59
"6019","Mariposa County",2007-04-01,31,5,20,4,60
"6020","Mariposa County",2007-05-01,32,4,18,5,59
"6021","Mariposa County",2007-06-01,35,7,18,4,64
"6022","Mariposa County",2007-07-01,38,7,15,3,63
"6023","Mariposa County",2007-08-01,37,5,18,4,64
"6024","Mariposa County",2007-09-01,33,3,25,4,65
"6025","Mariposa County",2007-10-01,30,4,27,4,65
"6026","Mariposa County",2007-11-01,24,6,27,3,60
"6027","Mariposa County",2007-12-01,25,5,20,3,53
"6028","Mariposa County",2008-01-01,19,2,17,5,43
"6029","Mariposa County",2008-02-01,22,5,20,2,49
"6030","Mariposa County",2008-03-01,23,4,16,3,46
"6031","Mariposa County",2008-04-01,23,5,19,4,51
"6032","Mariposa County",2008-05-01,23,3,25,6,57
"6033","Mariposa County",2008-06-01,28,2,20,5,55
"6034","Mariposa County",2008-07-01,25,3,22,4,54
"6035","Mariposa County",2008-08-01,19,2,25,7,53
"6036","Mariposa County",2008-09-01,17,3,21,6,47
"6037","Mariposa County",2008-10-01,19,3,20,5,47
"6038","Mariposa County",2008-11-01,17,3,12,6,38
"6039","Mariposa County",2008-12-01,13,6,21,3,43
"6040","Mariposa County",2009-01-01,14,4,27,5,50
"6041","Mariposa County",2009-02-01,21,7,21,4,53
"6042","Mariposa County",2009-03-01,25,7,22,5,59
"6043","Mariposa County",2009-04-01,23,7,18,7,55
"6044","Mariposa County",2009-05-01,19,5,20,8,52
"6045","Mariposa County",2009-06-01,32,6,14,7,59
"6046","Mariposa County",2009-07-01,25,3,25,7,60
"6047","Mariposa County",2009-08-01,27,3,17,2,49
"6048","Mariposa County",2009-09-01,23,1,16,4,44
"6049","Mariposa County",2009-10-01,23,4,12,5,44
"6050","Mariposa County",2009-11-01,23,7,12,4,46
"6051","Mariposa County",2009-12-01,20,3,19,2,44
"6052","Mariposa County",2010-01-01,24,2,22,3,51
"6053","Mariposa County",2010-02-01,20,1,22,2,45
"6054","Mariposa County",2010-03-01,17,1,22,0,40
"6055","Mariposa County",2010-04-01,17,2,20,1,40
"6056","Mariposa County",2010-05-01,18,4,21,3,46
"6057","Mariposa County",2010-06-01,20,6,20,4,50
"6058","Mariposa County",2010-07-01,22,5,20,4,51
"6059","Mariposa County",2010-08-01,26,4,18,4,52
"6060","Mariposa County",2010-09-01,23,3,17,6,49
"6061","Mariposa County",2010-10-01,19,2,19,6,46
"6062","Mariposa County",2010-11-01,17,3,18,5,43
"6063","Mariposa County",2010-12-01,16,3,12,4,35
"6064","Mariposa County",2011-01-01,20,1,10,3,34
"6065","Mariposa County",2011-02-01,21,2,15,1,39
"6066","Mariposa County",2011-03-01,19,2,14,0,35
"6067","Mariposa County",2011-04-01,19,5,13,2,39
"6068","Mariposa County",2011-05-01,22,3,10,3,38
"6069","Mariposa County",2011-06-01,22,4,9,3,38
"6070","Mariposa County",2011-07-01,26,5,10,3,44
"6071","Mariposa County",2011-08-01,20,3,13,4,40
"6072","Mariposa County",2011-09-01,14,3,14,4,35
"6073","Mariposa County",2011-10-01,19,3,12,5,39
"6074","Mariposa County",2011-11-01,16,3,17,5,41
"6075","Mariposa County",2011-12-01,11,6,18,4,39
"6076","Mariposa County",2012-01-01,14,2,16,5,37
"6077","Mariposa County",2012-02-01,16,1,18,5,40
"6078","Mariposa County",2012-03-01,15,3,18,4,40
"6079","Mariposa County",2012-04-01,13,5,16,2,36
"6080","Mariposa County",2012-05-01,15,3,11,2,31
"6081","Mariposa County",2012-06-01,17,4,12,1,34
"6082","Mariposa County",2012-07-01,19,6,10,2,37
"6083","Mariposa County",2012-08-01,17,4,13,4,38
"6084","Mariposa County",2012-09-01,14,4,16,4,38
"6085","Mariposa County",2012-10-01,11,5,18,5,39
"6086","Mariposa County",2012-11-01,14,2,19,5,40
"6087","Mariposa County",2012-12-01,16,1,18,4,39
"6088","Mariposa County",2013-01-01,19,2,16,5,42
"6089","Mariposa County",2013-02-01,24,4,17,5,50
"6090","Mariposa County",2013-03-01,28,4,18,4,54
"6091","Mariposa County",2013-04-01,26,5,20,3,54
"6092","Mariposa County",2013-05-01,21,4,20,3,48
"6093","Mariposa County",2013-06-01,22,4,17,2,45
"6094","Mariposa County",2013-07-01,26,5,18,2,51
"6095","Mariposa County",2013-08-01,22,4,17,4,47
"6096","Mariposa County",2013-09-01,23,4,12,2,41
"6097","Mariposa County",2013-10-01,29,5,12,4,50
"6098","Mariposa County",2013-11-01,26,3,20,3,52
"6099","Mariposa County",2013-12-01,24,6,18,2,50
"6100","Mariposa County",2014-01-01,21,5,20,4,50
"6101","Mariposa County",2014-02-01,20,3,15,4,42
"6102","Mariposa County",2014-03-01,19,1,17,4,41
"6103","Mariposa County",2014-04-01,22,2,17,3,44
"6104","Mariposa County",2014-05-01,23,2,20,3,48
"6105","Mariposa County",2014-06-01,20,1,22,3,46
"6106","Mariposa County",2014-07-01,19,3,20,3,45
"6107","Mariposa County",2014-08-01,21,1,17,5,44
"6108","Mariposa County",2014-09-01,18,2,17,4,41
"6109","Mariposa County",2014-10-01,20,3,14,3,40
"6110","Mariposa County",2014-11-01,24,4,13,4,45
"6111","Mariposa County",2014-12-01,23,4,12,2,41
"6112","Mariposa County",2015-01-01,26,3,9,1,39
"6113","Mariposa County",2015-02-01,23,4,10,2,39
"6114","Mariposa County",2015-03-01,20,5,9,4,38
"6115","Mariposa County",2015-04-01,19,5,7,3,34
"6116","Mariposa County",2015-05-01,22,2,9,3,36
"6117","Mariposa County",2015-06-01,20,2,12,4,38
"6118","Mariposa County",2015-07-01,22,5,12,5,44
"6119","Mariposa County",2015-08-01,26,3,11,4,44
"6120","Mariposa County",2015-09-01,30,5,8,3,46
"6121","Mariposa County",2015-10-01,23,4,17,2,46
"6122","Mariposa County",2015-11-01,21,6,16,2,45
"6123","Mariposa County",2015-12-01,21,5,16,2,44
"6124","Mariposa County",2016-01-01,18,5,19,3,45
"6125","Mariposa County",2016-02-01,24,3,17,3,47
"6126","Mariposa County",2016-03-01,21,2,18,4,45
"6127","Mariposa County",2016-04-01,22,2,19,4,47
"6128","Mariposa County",2016-05-01,20,0,23,2,45
"6129","Mariposa County",2016-06-01,21,2,23,0,46
"6130","Mariposa County",2016-07-01,21,4,16,0,41
"6131","Mariposa County",2016-08-01,21,5,17,2,45
"6132","Mariposa County",2016-09-01,20,2,15,2,39
"6133","Mariposa County",2016-10-01,20,3,19,2,44
"6134","Mariposa County",2016-11-01,13,1,18,3,35
"6135","Mariposa County",2016-12-01,11,3,17,4,35
"6136","Mariposa County",2017-01-01,12,6,13,3,34
"6137","Mariposa County",2017-02-01,12,7,13,3,35
"6138","Mariposa County",2017-03-01,17,7,19,5,48
"6139","Mariposa County",2017-04-01,20,5,13,4,42
"6140","Mariposa County",2017-05-01,19,4,12,6,41
"6141","Mariposa County",2017-06-01,22,4,12,7,45
"6142","Mariposa County",2017-07-01,23,6,14,7,50
"6143","Mariposa County",2017-08-01,20,7,18,6,51
"6144","Mariposa County",2017-09-01,22,7,19,3,51
"6145","Mariposa County",2017-10-01,21,4,18,3,46
"6146","Mariposa County",2017-11-01,22,5,19,4,50
"6147","Mariposa County",2017-12-01,22,6,18,4,50
"6148","Mariposa County",2018-01-01,21,8,16,5,50
"6149","Mariposa County",2018-02-01,21,8,16,5,50
"6150","Mariposa County",2018-03-01,19,5,13,4,41
"6151","Mariposa County",2018-04-01,15,5,13,5,38
"6152","Mariposa County",2018-05-01,12,6,13,4,35
"6153","Mariposa County",2018-06-01,16,4,13,3,36
"6154","Mariposa County",2018-07-01,13,3,12,3,31
"6155","Mariposa County",2018-08-01,15,5,13,3,36
"6156","Mariposa County",2018-09-01,12,5,12,6,35
"6157","Mariposa County",2018-10-01,16,4,14,5,39
"6158","Mariposa County",2018-11-01,19,4,13,4,40
"6159","Mariposa County",2018-12-01,17,5,13,4,39
"6160","Mariposa County",2019-01-01,17,5,14,4,40
"6161","Mariposa County",2019-02-01,19,4,11,6,40
"6162","Mariposa County",2019-03-01,24,7,10,7,48
"6163","Mariposa County",2019-04-01,26,6,11,6,49
"6164","Mariposa County",2019-05-01,22,7,10,4,43
"6165","Mariposa County",2019-06-01,18,4,16,3,41
"6166","Mariposa County",2019-07-01,20,4,14,3,41
"6167","Mariposa County",2019-08-01,25,4,11,3,43
"6168","Mariposa County",2019-09-01,24,4,11,3,42
"6169","Mariposa County",2019-10-01,21,6,17,2,46
"6170","Mariposa County",2019-11-01,16,7,17,4,44
"6171","Mariposa County",2019-12-01,17,5,18,3,43
"6172","Mariposa County",2020-01-01,20,4,18,3,45
"6173","Mariposa County",2020-02-01,22,4,14,0,40
"6174","Mariposa County",2020-03-01,17,3,9,1,30
"6175","Mendocino County",1995-10-01,120,10,83,13,226
"6176","Mendocino County",1995-11-01,112,12,65,18,207
"6177","Mendocino County",1995-12-01,100,12,64,10,186
"6178","Mendocino County",1996-01-01,107,14,65,15,201
"6179","Mendocino County",1996-02-01,100,8,74,11,193
"6180","Mendocino County",1996-03-01,108,10,75,16,209
"6181","Mendocino County",1996-04-01,108,10,80,11,209
"6182","Mendocino County",1996-05-01,101,14,86,14,215
"6183","Mendocino County",1996-06-01,100,10,68,13,191
"6184","Mendocino County",1996-07-01,102,14,66,15,197
"6185","Mendocino County",1996-08-01,106,11,62,14,193
"6186","Mendocino County",1996-09-01,118,9,74,10,211
"6187","Mendocino County",1996-10-01,109,8,94,11,222
"6188","Mendocino County",1996-11-01,99,10,83,9,201
"6189","Mendocino County",1996-12-01,104,12,76,7,199
"6190","Mendocino County",1997-01-01,109,15,83,7,214
"6191","Mendocino County",1997-02-01,131,14,90,12,247
"6192","Mendocino County",1997-03-01,138,17,80,14,249
"6193","Mendocino County",1997-04-01,118,16,99,15,248
"6194","Mendocino County",1997-05-01,119,13,100,15,247
"6195","Mendocino County",1997-06-01,117,13,85,19,234
"6196","Mendocino County",1997-07-01,124,14,94,14,246
"6197","Mendocino County",1997-08-01,115,14,86,17,232
"6198","Mendocino County",1997-09-01,116,10,88,13,227
"6199","Mendocino County",1997-10-01,113,8,94,13,228
"6200","Mendocino County",1997-11-01,110,12,87,9,218
"6201","Mendocino County",1997-12-01,113,16,81,8,218
"6202","Mendocino County",1998-01-01,120,17,97,12,246
"6203","Mendocino County",1998-02-01,118,15,93,19,245
"6204","Mendocino County",1998-03-01,137,14,85,17,253
"6205","Mendocino County",1998-04-01,127,14,79,14,234
"6206","Mendocino County",1998-05-01,131,14,88,8,241
"6207","Mendocino County",1998-06-01,127,18,90,12,247
"6208","Mendocino County",1998-07-01,129,9,73,13,224
"6209","Mendocino County",1998-08-01,120,11,72,9,212
"6210","Mendocino County",1998-09-01,123,11,83,12,229
"6211","Mendocino County",1998-10-01,121,14,88,13,236
"6212","Mendocino County",1998-11-01,118,15,80,12,225
"6213","Mendocino County",1998-12-01,104,10,74,12,200
"6214","Mendocino County",1999-01-01,108,13,73,11,205
"6215","Mendocino County",1999-02-01,101,9,71,11,192
"6216","Mendocino County",1999-03-01,107,13,71,10,201
"6217","Mendocino County",1999-04-01,104,13,78,17,212
"6218","Mendocino County",1999-05-01,113,9,72,15,209
"6219","Mendocino County",1999-06-01,112,11,63,15,201
"6220","Mendocino County",1999-07-01,110,11,60,10,191
"6221","Mendocino County",1999-08-01,109,12,71,9,201
"6222","Mendocino County",1999-09-01,133,14,76,12,235
"6223","Mendocino County",1999-10-01,135,13,77,12,237
"6224","Mendocino County",1999-11-01,101,14,94,14,223
"6225","Mendocino County",1999-12-01,81,19,89,19,208
"6226","Mendocino County",2000-01-01,133,15,76,10,234
"6227","Mendocino County",2000-02-01,130,16,79,13,238
"6228","Mendocino County",2000-03-01,122,12,86,13,233
"6229","Mendocino County",2000-04-01,119,11,101,15,246
"6230","Mendocino County",2000-05-01,135,12,101,10,258
"6231","Mendocino County",2000-06-01,146,9,91,13,259
"6232","Mendocino County",2000-07-01,142,13,91,11,257
"6233","Mendocino County",2000-08-01,125,10,105,10,250
"6234","Mendocino County",2000-09-01,131,10,94,10,245
"6235","Mendocino County",2000-10-01,116,12,102,16,246
"6236","Mendocino County",2000-11-01,117,13,95,18,243
"6237","Mendocino County",2000-12-01,111,14,90,17,232
"6238","Mendocino County",2001-01-01,130,19,92,17,258
"6239","Mendocino County",2001-02-01,121,14,94,15,244
"6240","Mendocino County",2001-03-01,146,18,97,19,280
"6241","Mendocino County",2001-04-01,129,19,101,17,266
"6242","Mendocino County",2001-05-01,121,19,92,13,245
"6243","Mendocino County",2001-06-01,142,17,99,16,274
"6244","Mendocino County",2001-07-01,143,20,97,13,273
"6245","Mendocino County",2001-08-01,131,18,90,15,254
"6246","Mendocino County",2001-09-01,141,20,97,17,275
"6247","Mendocino County",2001-10-01,145,18,104,20,287
"6248","Mendocino County",2001-11-01,126,17,105,17,265
"6249","Mendocino County",2001-12-01,122,23,98,19,262
"6250","Mendocino County",2002-01-01,137,19,93,24,273
"6251","Mendocino County",2002-02-01,157,21,100,20,298
"6252","Mendocino County",2002-03-01,157,19,107,21,304
"6253","Mendocino County",2002-04-01,140,17,101,20,278
"6254","Mendocino County",2002-05-01,128,13,93,21,255
"6255","Mendocino County",2002-06-01,137,17,77,19,250
"6256","Mendocino County",2002-07-01,145,14,89,15,263
"6257","Mendocino County",2002-08-01,141,14,82,13,250
"6258","Mendocino County",2002-09-01,113,11,81,11,216
"6259","Mendocino County",2002-10-01,102,17,84,10,213
"6260","Mendocino County",2002-11-01,110,15,80,16,221
"6261","Mendocino County",2002-12-01,122,11,72,11,216
"6262","Mendocino County",2003-01-01,136,15,71,13,235
"6263","Mendocino County",2003-02-01,136,16,73,10,235
"6264","Mendocino County",2003-03-01,135,16,75,9,235
"6265","Mendocino County",2003-04-01,127,10,78,14,229
"6266","Mendocino County",2003-05-01,115,11,82,11,219
"6267","Mendocino County",2003-06-01,114,14,83,7,218
"6268","Mendocino County",2003-07-01,107,14,75,12,208
"6269","Mendocino County",2003-08-01,127,17,72,14,230
"6270","Mendocino County",2003-09-01,113,22,81,19,235
"6271","Mendocino County",2003-10-01,107,21,77,22,227
"6272","Mendocino County",2003-11-01,107,22,77,16,222
"6273","Mendocino County",2003-12-01,101,20,95,15,231
"6274","Mendocino County",2004-01-01,125,26,101,17,269
"6275","Mendocino County",2004-02-01,138,26,93,19,276
"6276","Mendocino County",2004-03-01,124,27,96,23,270
"6277","Mendocino County",2004-04-01,131,28,104,24,287
"6278","Mendocino County",2004-05-01,129,22,94,22,267
"6279","Mendocino County",2004-06-01,143,26,89,21,279
"6280","Mendocino County",2004-07-01,157,23,77,22,279
"6281","Mendocino County",2004-08-01,155,41,61,17,274
"6282","Mendocino County",2004-09-01,142,27,74,18,261
"6283","Mendocino County",2004-10-01,141,23,59,17,240
"6284","Mendocino County",2004-11-01,139,23,64,19,245
"6285","Mendocino County",2004-12-01,151,22,64,15,252
"6286","Mendocino County",2005-01-01,142,22,69,15,248
"6287","Mendocino County",2005-02-01,161,23,82,15,281
"6288","Mendocino County",2005-03-01,162,25,83,21,291
"6289","Mendocino County",2005-04-01,166,28,71,22,287
"6290","Mendocino County",2005-05-01,168,22,68,18,276
"6291","Mendocino County",2005-06-01,163,15,77,17,272
"6292","Mendocino County",2005-07-01,162,16,76,13,267
"6293","Mendocino County",2005-08-01,155,20,68,12,255
"6294","Mendocino County",2005-09-01,171,18,64,15,268
"6295","Mendocino County",2005-10-01,166,18,69,19,272
"6296","Mendocino County",2005-11-01,169,19,81,20,289
"6297","Mendocino County",2005-12-01,158,20,84,17,279
"6298","Mendocino County",2006-01-01,175,28,87,22,312
"6299","Mendocino County",2006-02-01,174,21,86,21,302
"6300","Mendocino County",2006-03-01,162,19,87,15,283
"6301","Mendocino County",2006-04-01,149,18,76,19,262
"6302","Mendocino County",2006-05-01,151,19,80,20,270
"6303","Mendocino County",2006-06-01,164,23,72,19,278
"6304","Mendocino County",2006-07-01,173,20,74,16,283
"6305","Mendocino County",2006-08-01,142,22,89,17,270
"6306","Mendocino County",2006-09-01,138,18,74,20,250
"6307","Mendocino County",2006-10-01,127,21,67,13,228
"6308","Mendocino County",2006-11-01,125,18,75,11,229
"6309","Mendocino County",2006-12-01,140,15,70,11,236
"6310","Mendocino County",2007-01-01,138,18,70,20,246
"6311","Mendocino County",2007-02-01,156,21,75,12,264
"6312","Mendocino County",2007-03-01,150,23,82,14,269
"6313","Mendocino County",2007-04-01,145,26,86,20,277
"6314","Mendocino County",2007-05-01,137,23,79,21,260
"6315","Mendocino County",2007-06-01,147,25,76,16,264
"6316","Mendocino County",2007-07-01,154,24,73,14,265
"6317","Mendocino County",2007-08-01,167,19,79,14,279
"6318","Mendocino County",2007-09-01,175,26,71,18,290
"6319","Mendocino County",2007-10-01,174,23,70,26,293
"6320","Mendocino County",2007-11-01,181,18,69,22,290
"6321","Mendocino County",2007-12-01,163,21,63,17,264
"6322","Mendocino County",2008-01-01,180,23,70,18,291
"6323","Mendocino County",2008-02-01,194,20,66,19,299
"6324","Mendocino County",2008-03-01,188,19,69,21,297
"6325","Mendocino County",2008-04-01,159,25,72,21,277
"6326","Mendocino County",2008-05-01,163,23,66,19,271
"6327","Mendocino County",2008-06-01,158,21,72,21,272
"6328","Mendocino County",2008-07-01,154,24,61,18,257
"6329","Mendocino County",2008-08-01,176,27,64,21,288
"6330","Mendocino County",2008-09-01,188,23,68,20,299
"6331","Mendocino County",2008-10-01,194,18,72,17,301
"6332","Mendocino County",2008-11-01,188,24,77,18,307
"6333","Mendocino County",2008-12-01,177,19,73,15,284
"6334","Mendocino County",2009-01-01,182,17,72,14,285
"6335","Mendocino County",2009-02-01,199,19,77,15,310
"6336","Mendocino County",2009-03-01,144,19,119,19,301
"6337","Mendocino County",2009-04-01,144,25,123,19,311
"6338","Mendocino County",2009-05-01,142,18,122,16,298
"6339","Mendocino County",2009-06-01,140,19,126,11,296
"6340","Mendocino County",2009-07-01,138,20,111,15,284
"6341","Mendocino County",2009-08-01,122,16,117,15,270
"6342","Mendocino County",2009-09-01,125,13,109,15,262
"6343","Mendocino County",2009-10-01,125,18,100,19,262
"6344","Mendocino County",2009-11-01,138,18,96,20,272
"6345","Mendocino County",2009-12-01,130,17,90,15,252
"6346","Mendocino County",2010-01-01,134,16,82,13,245
"6347","Mendocino County",2010-02-01,147,17,74,14,252
"6348","Mendocino County",2010-03-01,148,16,86,18,268
"6349","Mendocino County",2010-04-01,143,22,81,18,264
"6350","Mendocino County",2010-05-01,144,21,83,21,269
"6351","Mendocino County",2010-06-01,133,28,101,23,285
"6352","Mendocino County",2010-07-01,116,23,93,23,255
"6353","Mendocino County",2010-08-01,128,20,94,20,262
"6354","Mendocino County",2010-09-01,122,16,82,15,235
"6355","Mendocino County",2010-10-01,131,20,75,16,242
"6356","Mendocino County",2010-11-01,130,20,83,19,252
"6357","Mendocino County",2010-12-01,123,10,81,18,232
"6358","Mendocino County",2011-01-01,110,11,91,14,226
"6359","Mendocino County",2011-02-01,102,14,93,17,226
"6360","Mendocino County",2011-03-01,94,15,81,16,206
"6361","Mendocino County",2011-04-01,90,13,68,15,186
"6362","Mendocino County",2011-05-01,91,17,76,15,199
"6363","Mendocino County",2011-06-01,102,17,73,10,202
"6364","Mendocino County",2011-07-01,104,19,64,12,199
"6365","Mendocino County",2011-08-01,117,17,62,15,211
"6366","Mendocino County",2011-09-01,119,20,58,13,210
"6367","Mendocino County",2011-10-01,122,16,56,11,205
"6368","Mendocino County",2011-11-01,126,21,49,14,210
"6369","Mendocino County",2011-12-01,108,17,68,13,206
"6370","Mendocino County",2012-01-01,131,20,66,16,233
"6371","Mendocino County",2012-02-01,132,16,82,19,249
"6372","Mendocino County",2012-03-01,133,15,87,20,255
"6373","Mendocino County",2012-04-01,124,19,96,21,260
"6374","Mendocino County",2012-05-01,123,20,84,24,251
"6375","Mendocino County",2012-06-01,148,21,63,21,253
"6376","Mendocino County",2012-07-01,142,19,72,18,251
"6377","Mendocino County",2012-08-01,157,21,80,21,279
"6378","Mendocino County",2012-09-01,140,23,73,21,257
"6379","Mendocino County",2012-10-01,139,17,77,23,256
"6380","Mendocino County",2012-11-01,140,18,81,25,264
"6381","Mendocino County",2012-12-01,143,14,79,19,255
"6382","Mendocino County",2013-01-01,141,18,84,20,263
"6383","Mendocino County",2013-02-01,154,23,83,22,282
"6384","Mendocino County",2013-03-01,146,23,83,23,275
"6385","Mendocino County",2013-04-01,148,21,75,19,263
"6386","Mendocino County",2013-05-01,157,20,79,23,279
"6387","Mendocino County",2013-06-01,152,19,87,24,282
"6388","Mendocino County",2013-07-01,153,18,77,20,268
"6389","Mendocino County",2013-08-01,145,22,80,18,265
"6390","Mendocino County",2013-09-01,147,25,73,16,261
"6391","Mendocino County",2013-10-01,148,16,84,17,265
"6392","Mendocino County",2013-11-01,136,18,76,15,245
"6393","Mendocino County",2013-12-01,125,27,73,12,237
"6394","Mendocino County",2014-01-01,138,23,96,15,272
"6395","Mendocino County",2014-02-01,146,27,105,16,294
"6396","Mendocino County",2014-03-01,130,25,118,21,294
"6397","Mendocino County",2014-04-01,137,25,111,16,289
"6398","Mendocino County",2014-05-01,148,22,103,20,293
"6399","Mendocino County",2014-06-01,157,24,99,14,294
"6400","Mendocino County",2014-07-01,152,28,109,11,300
"6401","Mendocino County",2014-08-01,151,24,103,17,295
"6402","Mendocino County",2014-09-01,148,27,97,15,287
"6403","Mendocino County",2014-10-01,156,27,102,18,303
"6404","Mendocino County",2014-11-01,155,23,97,14,289
"6405","Mendocino County",2014-12-01,160,19,99,18,296
"6406","Mendocino County",2015-01-01,171,24,97,17,309
"6407","Mendocino County",2015-02-01,192,22,87,20,321
"6408","Mendocino County",2015-03-01,181,25,82,20,308
"6409","Mendocino County",2015-04-01,170,22,96,26,314
"6410","Mendocino County",2015-05-01,148,18,106,25,297
"6411","Mendocino County",2015-06-01,141,20,108,25,294
"6412","Mendocino County",2015-07-01,138,21,113,22,294
"6413","Mendocino County",2015-08-01,149,27,98,20,294
"6414","Mendocino County",2015-09-01,148,31,97,17,293
"6415","Mendocino County",2015-10-01,160,30,96,18,304
"6416","Mendocino County",2015-11-01,142,20,105,28,295
"6417","Mendocino County",2015-12-01,143,20,107,24,294
"6418","Mendocino County",2016-01-01,134,30,102,37,303
"6419","Mendocino County",2016-02-01,125,41,99,36,301
"6420","Mendocino County",2016-03-01,123,44,101,37,305
"6421","Mendocino County",2016-04-01,115,52,118,20,305
"6422","Mendocino County",2016-05-01,110,55,119,25,309
"6423","Mendocino County",2016-06-01,110,55,112,25,302
"6424","Mendocino County",2016-07-01,133,30,102,37,302
"6425","Mendocino County",2016-08-01,134,30,103,38,305
"6426","Mendocino County",2016-09-01,165,31,93,16,305
"6427","Mendocino County",2016-10-01,172,24,99,18,313
"6428","Mendocino County",2016-11-01,163,27,106,13,309
"6429","Mendocino County",2016-12-01,163,28,100,14,305
"6430","Mendocino County",2017-01-01,144,31,108,19,302
"6431","Mendocino County",2017-02-01,149,31,110,17,307
"6432","Mendocino County",2017-03-01,147,29,111,16,303
"6433","Mendocino County",2017-04-01,165,26,99,15,305
"6434","Mendocino County",2017-05-01,174,25,99,10,308
"6435","Mendocino County",2017-06-01,168,32,93,11,304
"6436","Mendocino County",2017-07-01,178,21,88,13,300
"6437","Mendocino County",2017-08-01,178,18,88,16,300
"6438","Mendocino County",2017-09-01,183,27,75,20,305
"6439","Mendocino County",2017-10-01,180,26,86,20,312
"6440","Mendocino County",2017-11-01,172,27,88,17,304
"6441","Mendocino County",2017-12-01,173,18,91,20,302
"6442","Mendocino County",2018-01-01,163,18,98,22,301
"6443","Mendocino County",2018-02-01,177,17,89,19,302
"6444","Mendocino County",2018-03-01,179,19,88,20,306
"6445","Mendocino County",2018-04-01,172,25,92,11,300
"6446","Mendocino County",2018-05-01,176,15,92,22,305
"6447","Mendocino County",2018-06-01,164,23,99,17,303
"6448","Mendocino County",2018-07-01,182,23,84,17,306
"6449","Mendocino County",2018-08-01,169,28,90,17,304
"6450","Mendocino County",2018-09-01,174,24,87,14,299
"6451","Mendocino County",2018-10-01,150,21,95,21,287
"6452","Mendocino County",2018-11-01,144,28,99,19,290
"6453","Mendocino County",2018-12-01,140,27,90,14,271
"6454","Mendocino County",2019-01-01,147,24,98,17,286
"6455","Mendocino County",2019-02-01,143,12,97,20,272
"6456","Mendocino County",2019-03-01,161,17,80,14,272
"6457","Mendocino County",2019-04-01,149,26,92,11,278
"6458","Mendocino County",2019-05-01,150,24,96,16,286
"6459","Mendocino County",2019-06-01,165,22,72,17,276
"6460","Mendocino County",2019-07-01,166,19,70,17,272
"6461","Mendocino County",2019-08-01,177,20,85,12,294
"6462","Mendocino County",2019-09-01,177,25,85,13,300
"6463","Mendocino County",2019-10-01,170,19,98,11,298
"6464","Mendocino County",2019-11-01,176,23,91,10,300
"6465","Mendocino County",2019-12-01,159,21,83,21,284
"6466","Mendocino County",2020-01-01,160,13,77,19,269
"6467","Mendocino County",2020-02-01,132,22,100,17,271
"6468","Mendocino County",2020-03-01,117,24,100,13,254
"6469","Merced County",1995-10-01,322,27,135,25,509
"6470","Merced County",1995-11-01,314,26,139,28,507
"6471","Merced County",1995-12-01,311,30,133,27,501
"6472","Merced County",1996-01-01,314,29,130,30,503
"6473","Merced County",1996-02-01,304,28,153,34,519
"6474","Merced County",1996-03-01,297,32,150,30,509
"6475","Merced County",1996-04-01,278,26,147,27,478
"6476","Merced County",1996-05-01,273,28,160,25,486
"6477","Merced County",1996-06-01,279,32,161,26,498
"6478","Merced County",1996-07-01,273,24,158,23,478
"6479","Merced County",1996-08-01,293,25,147,22,487
"6480","Merced County",1996-09-01,308,28,137,25,498
"6481","Merced County",1996-10-01,288,23,164,26,501
"6482","Merced County",1996-11-01,282,19,174,24,499
"6483","Merced County",1996-12-01,268,17,176,24,485
"6484","Merced County",1997-01-01,274,25,172,18,489
"6485","Merced County",1997-02-01,293,29,162,18,502
"6486","Merced County",1997-03-01,305,35,161,24,525
"6487","Merced County",1997-04-01,293,32,174,26,525
"6488","Merced County",1997-05-01,295,28,172,25,520
"6489","Merced County",1997-06-01,272,28,190,26,516
"6490","Merced County",1997-07-01,260,30,184,25,499
"6491","Merced County",1997-08-01,256,33,177,26,492
"6492","Merced County",1997-09-01,302,33,153,31,519
"6493","Merced County",1997-10-01,307,30,162,31,530
"6494","Merced County",1997-11-01,301,29,155,27,512
"6495","Merced County",1997-12-01,305,31,154,24,514
"6496","Merced County",1998-01-01,310,28,156,30,524
"6497","Merced County",1998-02-01,284,25,183,34,526
"6498","Merced County",1998-03-01,276,25,185,33,519
"6499","Merced County",1998-04-01,276,25,185,33,519
"6500","Merced County",1998-05-01,286,30,191,25,532
"6501","Merced County",1998-06-01,287,27,187,26,527
"6502","Merced County",1998-07-01,284,25,180,26,515
"6503","Merced County",1998-08-01,308,25,181,18,532
"6504","Merced County",1998-09-01,306,32,177,16,531
"6505","Merced County",1998-10-01,296,23,191,22,532
"6506","Merced County",1998-11-01,263,40,179,16,498
"6507","Merced County",1998-12-01,260,26,193,23,502
"6508","Merced County",1999-01-01,263,24,206,25,518
"6509","Merced County",1999-02-01,244,23,216,30,513
"6510","Merced County",1999-03-01,280,25,208,30,543
"6511","Merced County",1999-04-01,274,22,200,29,525
"6512","Merced County",1999-05-01,281,31,197,27,536
"6513","Merced County",1999-06-01,295,38,197,21,551
"6514","Merced County",1999-07-01,328,37,175,24,564
"6515","Merced County",1999-08-01,329,43,179,24,575
"6516","Merced County",1999-09-01,332,43,178,23,576
"6517","Merced County",1999-10-01,339,40,179,24,582
"6518","Merced County",1999-11-01,333,36,176,29,574
"6519","Merced County",1999-12-01,303,32,180,32,547
"6520","Merced County",2000-01-01,324,31,181,28,564
"6521","Merced County",2000-02-01,309,40,188,20,557
"6522","Merced County",2000-03-01,328,35,171,18,552
"6523","Merced County",2000-04-01,300,38,183,17,538
"6524","Merced County",2000-05-01,325,38,181,18,562
"6525","Merced County",2000-06-01,318,35,204,19,576
"6526","Merced County",2000-07-01,317,36,193,21,567
"6527","Merced County",2000-08-01,324,41,186,19,570
"6528","Merced County",2000-09-01,354,38,180,16,588
"6529","Merced County",2000-10-01,350,34,175,16,575
"6530","Merced County",2000-11-01,334,29,177,18,558
"6531","Merced County",2000-12-01,336,31,160,20,547
"6532","Merced County",2001-01-01,334,30,169,18,551
"6533","Merced County",2001-02-01,340,34,184,13,571
"6534","Merced County",2001-03-01,359,39,177,13,588
"6535","Merced County",2001-04-01,362,41,171,12,586
"6536","Merced County",2001-05-01,359,40,151,20,570
"6537","Merced County",2001-06-01,362,39,142,19,562
"6538","Merced County",2001-07-01,365,38,132,23,558
"6539","Merced County",2001-08-01,388,39,129,16,572
"6540","Merced County",2001-09-01,372,41,150,16,579
"6541","Merced County",2001-10-01,373,37,146,20,576
"6542","Merced County",2001-11-01,374,36,141,10,561
"6543","Merced County",2001-12-01,379,31,139,7,556
"6544","Merced County",2002-01-01,417,45,139,16,617
"6545","Merced County",2002-02-01,445,51,136,19,651
"6546","Merced County",2002-03-01,438,46,131,21,636
"6547","Merced County",2002-04-01,427,50,133,21,631
"6548","Merced County",2002-05-01,408,45,144,17,614
"6549","Merced County",2002-06-01,388,41,154,15,598
"6550","Merced County",2002-07-01,403,48,148,16,615
"6551","Merced County",2002-08-01,427,54,157,18,656
"6552","Merced County",2002-09-01,416,49,149,22,636
"6553","Merced County",2002-10-01,409,48,146,21,624
"6554","Merced County",2002-11-01,406,47,148,21,622
"6555","Merced County",2002-12-01,396,42,147,21,606
"6556","Merced County",2003-01-01,413,39,152,21,625
"6557","Merced County",2003-02-01,455,48,125,17,645
"6558","Merced County",2003-03-01,431,49,127,18,625
"6559","Merced County",2003-04-01,425,53,130,19,627
"6560","Merced County",2003-05-01,430,55,130,17,632
"6561","Merced County",2003-06-01,469,46,110,19,644
"6562","Merced County",2003-07-01,477,47,105,15,644
"6563","Merced County",2003-08-01,459,43,117,16,635
"6564","Merced County",2003-09-01,446,49,122,16,633
"6565","Merced County",2003-10-01,459,51,128,18,656
"6566","Merced County",2003-11-01,464,49,137,18,668
"6567","Merced County",2003-12-01,446,50,150,11,657
"6568","Merced County",2004-01-01,439,57,165,12,673
"6569","Merced County",2004-02-01,474,58,145,13,690
"6570","Merced County",2004-03-01,445,61,159,17,682
"6571","Merced County",2004-04-01,401,53,190,22,666
"6572","Merced County",2004-05-01,409,52,177,23,661
"6573","Merced County",2004-06-01,411,60,174,16,661
"6574","Merced County",2004-07-01,406,60,179,15,660
"6575","Merced County",2004-08-01,411,54,186,21,672
"6576","Merced County",2004-09-01,423,53,179,23,678
"6577","Merced County",2004-10-01,408,47,184,27,666
"6578","Merced County",2004-11-01,409,53,180,29,671
"6579","Merced County",2004-12-01,428,49,158,24,659
"6580","Merced County",2005-01-01,447,51,150,23,671
"6581","Merced County",2005-02-01,438,51,155,25,669
"6582","Merced County",2005-03-01,438,56,154,21,669
"6583","Merced County",2005-04-01,450,61,154,24,689
"6584","Merced County",2005-05-01,455,60,158,21,694
"6585","Merced County",2005-06-01,451,57,196,27,731
"6586","Merced County",2005-07-01,464,55,224,30,773
"6587","Merced County",2005-08-01,479,45,258,29,811
"6588","Merced County",2005-09-01,450,49,249,25,773
"6589","Merced County",2005-10-01,440,50,234,33,757
"6590","Merced County",2005-11-01,407,46,226,39,718
"6591","Merced County",2005-12-01,403,47,200,30,680
"6592","Merced County",2006-01-01,464,49,190,23,726
"6593","Merced County",2006-02-01,508,56,186,30,780
"6594","Merced County",2006-03-01,504,56,196,30,786
"6595","Merced County",2006-04-01,510,64,179,27,780
"6596","Merced County",2006-05-01,493,58,187,29,767
"6597","Merced County",2006-06-01,474,54,181,25,734
"6598","Merced County",2006-07-01,474,50,165,21,710
"6599","Merced County",2006-08-01,477,51,165,26,719
"6600","Merced County",2006-09-01,500,55,166,24,745
"6601","Merced County",2006-10-01,500,52,164,22,738
"6602","Merced County",2006-11-01,492,50,163,22,727
"6603","Merced County",2006-12-01,471,52,161,22,706
"6604","Merced County",2007-01-01,462,48,156,26,692
"6605","Merced County",2007-02-01,475,61,161,25,722
"6606","Merced County",2007-03-01,470,59,158,23,710
"6607","Merced County",2007-04-01,480,59,164,21,724
"6608","Merced County",2007-05-01,485,61,162,23,731
"6609","Merced County",2007-06-01,486,62,165,29,742
"6610","Merced County",2007-07-01,471,53,176,30,730
"6611","Merced County",2007-08-01,475,50,182,33,740
"6612","Merced County",2007-09-01,495,53,170,29,747
"6613","Merced County",2007-10-01,471,52,171,27,721
"6614","Merced County",2007-11-01,489,57,164,21,731
"6615","Merced County",2007-12-01,469,53,174,18,714
"6616","Merced County",2008-01-01,463,52,186,19,720
"6617","Merced County",2008-02-01,490,57,162,18,727
"6618","Merced County",2008-03-01,492,48,171,21,732
"6619","Merced County",2008-04-01,482,57,145,14,698
"6620","Merced County",2008-05-01,499,64,149,15,727
"6621","Merced County",2008-06-01,495,65,174,16,750
"6622","Merced County",2008-07-01,492,62,192,17,763
"6623","Merced County",2008-08-01,496,62,187,15,760
"6624","Merced County",2008-09-01,515,64,167,15,761
"6625","Merced County",2008-10-01,495,60,172,20,747
"6626","Merced County",2008-11-01,498,55,202,25,780
"6627","Merced County",2008-12-01,507,52,180,22,761
"6628","Merced County",2009-01-01,524,60,187,21,792
"6629","Merced County",2009-02-01,505,68,192,20,785
"6630","Merced County",2009-03-01,478,58,183,22,741
"6631","Merced County",2009-04-01,474,59,169,11,713
"6632","Merced County",2009-05-01,474,59,169,20,722
"6633","Merced County",2009-06-01,504,60,168,24,756
"6634","Merced County",2009-07-01,527,59,166,19,771
"6635","Merced County",2009-08-01,443,60,253,23,779
"6636","Merced County",2009-09-01,523,65,171,22,781
"6637","Merced County",2009-10-01,486,59,173,17,735
"6638","Merced County",2009-11-01,466,53,156,21,696
"6639","Merced County",2009-12-01,446,53,151,17,667
"6640","Merced County",2010-01-01,458,48,161,22,689
"6641","Merced County",2010-02-01,482,45,162,20,709
"6642","Merced County",2010-03-01,504,45,169,18,736
"6643","Merced County",2010-04-01,480,32,168,25,705
"6644","Merced County",2010-05-01,472,42,170,21,705
"6645","Merced County",2010-06-01,495,52,172,22,741
"6646","Merced County",2010-07-01,512,62,162,28,764
"6647","Merced County",2010-08-01,497,53,167,25,742
"6648","Merced County",2010-09-01,470,49,178,20,717
"6649","Merced County",2010-10-01,340,44,254,17,655
"6650","Merced County",2010-11-01,422,36,161,15,634
"6651","Merced County",2010-12-01,404,35,167,13,619
"6652","Merced County",2011-01-01,402,44,163,18,627
"6653","Merced County",2011-02-01,414,42,175,20,651
"6654","Merced County",2011-03-01,408,39,172,17,636
"6655","Merced County",2011-04-01,428,53,156,13,650
"6656","Merced County",2011-05-01,429,52,167,15,663
"6657","Merced County",2011-06-01,445,55,162,24,686
"6658","Merced County",2011-07-01,458,60,154,25,697
"6659","Merced County",2011-08-01,465,18,116,51,650
"6660","Merced County",2011-09-01,467,48,129,12,656
"6661","Merced County",2011-10-01,454,44,164,10,672
"6662","Merced County",2011-11-01,415,50,149,9,623
"6663","Merced County",2011-12-01,400,50,125,9,584
"6664","Merced County",2012-01-01,446,52,113,11,622
"6665","Merced County",2012-02-01,462,48,117,13,640
"6666","Merced County",2012-03-01,473,49,122,16,660
"6667","Merced County",2012-04-01,505,50,82,7,644
"6668","Merced County",2012-05-01,504,47,67,4,622
"6669","Merced County",2012-06-01,561,55,81,9,706
"6670","Merced County",2012-07-01,603,52,72,10,737
"6671","Merced County",2012-08-01,612,56,141,13,822
"6672","Merced County",2012-09-01,620,64,133,16,833
"6673","Merced County",2012-10-01,612,57,153,17,839
"6674","Merced County",2012-11-01,589,49,174,17,829
"6675","Merced County",2012-12-01,539,50,203,10,802
"6676","Merced County",2013-01-01,553,52,144,27,776
"6677","Merced County",2013-02-01,524,47,247,27,845
"6678","Merced County",2013-03-01,499,44,337,27,907
"6679","Merced County",2013-04-01,483,49,392,42,966
"6680","Merced County",2013-05-01,479,45,414,48,986
"6681","Merced County",2013-06-01,465,50,397,51,963
"6682","Merced County",2013-07-01,495,55,299,40,889
"6683","Merced County",2013-08-01,486,51,339,44,920
"6684","Merced County",2013-09-01,494,51,281,33,859
"6685","Merced County",2013-10-01,515,55,219,26,815
"6686","Merced County",2013-11-01,533,63,174,24,794
"6687","Merced County",2013-12-01,558,69,73,6,706
"6688","Merced County",2014-01-01,549,63,133,15,760
"6689","Merced County",2014-02-01,509,59,270,36,874
"6690","Merced County",2014-03-01,490,58,337,50,935
"6691","Merced County",2014-04-01,472,53,361,60,946
"6692","Merced County",2014-05-01,466,55,376,59,956
"6693","Merced County",2014-06-01,508,64,378,50,1000
"6694","Merced County",2014-07-01,513,70,380,43,1006
"6695","Merced County",2014-08-01,512,66,374,55,1007
"6696","Merced County",2014-09-01,504,59,320,62,945
"6697","Merced County",2014-10-01,527,57,295,54,933
"6698","Merced County",2014-11-01,548,58,222,27,855
"6699","Merced County",2014-12-01,553,54,117,10,734
"6700","Merced County",2015-01-01,576,56,25,3,660
"6701","Merced County",2015-02-01,580,62,41,6,689
"6702","Merced County",2015-03-01,569,59,53,6,687
"6703","Merced County",2015-04-01,545,58,57,7,667
"6704","Merced County",2015-05-01,539,59,58,13,669
"6705","Merced County",2015-06-01,552,58,60,14,684
"6706","Merced County",2015-07-01,549,67,58,7,681
"6707","Merced County",2015-08-01,562,64,64,10,700
"6708","Merced County",2015-09-01,591,70,47,7,715
"6709","Merced County",2015-10-01,602,75,55,4,736
"6710","Merced County",2015-11-01,603,64,45,2,714
"6711","Merced County",2015-12-01,604,59,18,3,684
"6712","Merced County",2016-01-01,589,64,24,3,680
"6713","Merced County",2016-02-01,552,61,47,4,664
"6714","Merced County",2016-03-01,563,56,57,10,686
"6715","Merced County",2016-04-01,580,51,53,6,690
"6716","Merced County",2016-05-01,588,53,62,10,713
"6717","Merced County",2016-06-01,594,57,63,5,719
"6718","Merced County",2016-07-01,567,56,64,4,691
"6719","Merced County",2016-08-01,591,60,46,5,702
"6720","Merced County",2016-09-01,602,58,46,3,709
"6721","Merced County",2016-10-01,583,59,47,4,693
"6722","Merced County",2016-11-01,575,51,25,8,659
"6723","Merced County",2016-12-01,595,52,12,3,662
"6724","Merced County",2017-01-01,584,47,20,1,652
"6725","Merced County",2017-02-01,582,48,27,6,663
"6726","Merced County",2017-03-01,579,50,31,3,663
"6727","Merced County",2017-04-01,577,61,23,2,663
"6728","Merced County",2017-05-01,600,68,23,2,693
"6729","Merced County",2017-06-01,599,71,29,2,701
"6730","Merced County",2017-07-01,597,71,25,2,695
"6731","Merced County",2017-08-01,597,71,25,2,695
"6732","Merced County",2017-09-01,543,61,15,2,621
"6733","Merced County",2017-10-01,551,NA,22,4,577
"6734","Merced County",2017-11-01,527,18,58,3,606
"6735","Merced County",2017-12-01,648,81,27,1,757
"6736","Merced County",2018-01-01,517,54,17,2,590
"6737","Merced County",2018-02-01,520,51,24,4,599
"6738","Merced County",2018-03-01,506,53,26,4,589
"6739","Merced County",2018-04-01,487,58,35,2,582
"6740","Merced County",2018-05-01,506,63,31,1,601
"6741","Merced County",2018-06-01,493,62,37,3,595
"6742","Merced County",2018-07-01,484,57,31,2,574
"6743","Merced County",2018-08-01,521,56,22,2,601
"6744","Merced County",2018-09-01,0,0,0,0,0
"6745","Merced County",2018-10-01,530,55,12,2,599
"6746","Merced County",2018-11-01,0,0,0,0,0
"6747","Merced County",2018-12-01,561,61,13,2,637
"6748","Merced County",2019-01-01,573,62,5,1,641
"6749","Merced County",2019-02-01,555,54,13,0,622
"6750","Merced County",2019-03-01,555,61,15,1,632
"6751","Merced County",2019-04-01,573,65,13,1,652
"6752","Merced County",2019-05-01,535,65,22,3,625
"6753","Merced County",2019-06-01,535,67,24,3,629
"6754","Merced County",2019-07-01,562,60,18,1,641
"6755","Merced County",2019-08-01,563,66,19,0,648
"6756","Merced County",2019-09-01,553,68,27,2,650
"6757","Merced County",2019-10-01,509,64,28,5,606
"6758","Merced County",2019-11-01,519,59,23,1,602
"6759","Merced County",2019-12-01,506,63,20,3,592
"6760","Merced County",2020-01-01,501,65,47,4,617
"6761","Merced County",2020-02-01,506,111,20,0,637
"6762","Merced County",2020-03-01,465,51,8,5,529
"6763","Modoc County",1995-10-01,10,4,7,4,25
"6764","Modoc County",1995-11-01,15,1,18,5,39
"6765","Modoc County",1995-12-01,10,1,9,5,25
"6766","Modoc County",1996-01-01,10,1,28,3,42
"6767","Modoc County",1996-02-01,15,2,17,4,38
"6768","Modoc County",1996-03-01,7,2,30,3,42
"6769","Modoc County",1996-04-01,11,2,29,4,46
"6770","Modoc County",1996-05-01,4,6,19,7,36
"6771","Modoc County",1996-06-01,10,1,20,4,35
"6772","Modoc County",1996-07-01,8,1,20,2,31
"6773","Modoc County",1996-08-01,9,2,17,4,32
"6774","Modoc County",1996-09-01,9,2,20,4,35
"6775","Modoc County",1996-10-01,5,1,18,2,26
"6776","Modoc County",1996-11-01,8,2,23,4,37
"6777","Modoc County",1996-12-01,9,3,18,4,34
"6778","Modoc County",1997-01-01,5,1,18,2,26
"6779","Modoc County",1997-02-01,8,2,23,4,37
"6780","Modoc County",1997-03-01,9,3,18,4,34
"6781","Modoc County",1997-04-01,9,0,24,5,38
"6782","Modoc County",1997-05-01,9,2,26,7,44
"6783","Modoc County",1997-06-01,15,1,21,12,49
"6784","Modoc County",1997-07-01,24,1,10,3,38
"6785","Modoc County",1997-08-01,12,2,18,4,36
"6786","Modoc County",1997-09-01,15,2,17,4,38
"6787","Modoc County",1997-10-01,21,4,15,3,43
"6788","Modoc County",1997-11-01,19,11,8,7,45
"6789","Modoc County",1997-12-01,33,5,5,0,43
"6790","Modoc County",1998-01-01,14,1,19,3,37
"6791","Modoc County",1998-02-01,14,1,19,3,37
"6792","Modoc County",1998-03-01,13,12,20,4,49
"6793","Modoc County",1998-04-01,11,3,24,3,41
"6794","Modoc County",1998-05-01,8,3,18,5,34
"6795","Modoc County",1998-06-01,9,3,19,4,35
"6796","Modoc County",1998-07-01,11,4,13,3,31
"6797","Modoc County",1998-08-01,7,1,17,3,28
"6798","Modoc County",1998-09-01,9,1,20,3,33
"6799","Modoc County",1998-10-01,9,1,20,3,33
"6800","Modoc County",1998-11-01,11,1,22,3,37
"6801","Modoc County",1998-12-01,9,2,21,3,35
"6802","Modoc County",1999-01-01,14,3,15,4,36
"6803","Modoc County",1999-02-01,14,2,16,2,34
"6804","Modoc County",1999-03-01,8,2,15,5,30
"6805","Modoc County",1999-04-01,15,3,9,7,34
"6806","Modoc County",1999-05-01,19,2,12,5,38
"6807","Modoc County",1999-06-01,19,1,12,4,36
"6808","Modoc County",1999-07-01,16,1,13,3,33
"6809","Modoc County",1999-08-01,11,2,14,3,30
"6810","Modoc County",1999-09-01,7,2,10,2,21
"6811","Modoc County",1999-10-01,6,1,14,3,24
"6812","Modoc County",1999-11-01,5,2,17,3,27
"6813","Modoc County",1999-12-01,8,1,12,0,21
"6814","Modoc County",2000-01-01,11,2,14,1,28
"6815","Modoc County",2000-02-01,8,1,18,2,29
"6816","Modoc County",2000-03-01,7,1,11,5,24
"6817","Modoc County",2000-04-01,7,1,11,5,24
"6818","Modoc County",2000-05-01,7,1,11,5,24
"6819","Modoc County",2000-06-01,7,1,11,5,24
"6820","Modoc County",2000-07-01,17,8,13,3,41
"6821","Modoc County",2000-08-01,13,5,14,4,36
"6822","Modoc County",2000-09-01,15,4,14,5,38
"6823","Modoc County",2000-10-01,13,4,10,5,32
"6824","Modoc County",2000-11-01,15,4,15,4,38
"6825","Modoc County",2000-12-01,15,7,16,3,41
"6826","Modoc County",2001-01-01,18,1,13,4,36
"6827","Modoc County",2001-02-01,15,1,14,3,33
"6828","Modoc County",2001-03-01,11,3,9,3,26
"6829","Modoc County",2001-04-01,18,3,13,2,36
"6830","Modoc County",2001-05-01,11,6,9,3,29
"6831","Modoc County",2001-06-01,21,3,9,4,37
"6832","Modoc County",2001-07-01,22,3,12,3,40
"6833","Modoc County",2001-08-01,26,1,8,1,36
"6834","Modoc County",2001-09-01,23,2,9,2,36
"6835","Modoc County",2001-10-01,20,4,9,4,37
"6836","Modoc County",2001-11-01,19,5,12,2,38
"6837","Modoc County",2001-12-01,23,2,16,4,45
"6838","Modoc County",2002-01-01,14,2,15,4,35
"6839","Modoc County",2002-02-01,14,2,16,2,34
"6840","Modoc County",2002-03-01,9,3,13,3,28
"6841","Modoc County",2002-04-01,17,2,12,2,33
"6842","Modoc County",2002-05-01,9,2,17,4,32
"6843","Modoc County",2002-06-01,9,1,7,6,23
"6844","Modoc County",2002-07-01,13,3,3,4,23
"6845","Modoc County",2002-08-01,8,2,7,6,23
"6846","Modoc County",2002-09-01,8,1,9,3,21
"6847","Modoc County",2002-10-01,13,2,11,3,29
"6848","Modoc County",2002-11-01,15,2,6,5,28
"6849","Modoc County",2002-12-01,17,3,6,2,28
"6850","Modoc County",2003-01-01,8,3,12,4,27
"6851","Modoc County",2003-02-01,21,6,7,4,38
"6852","Modoc County",2003-03-01,15,2,11,4,32
"6853","Modoc County",2003-04-01,8,6,16,5,35
"6854","Modoc County",2003-05-01,15,4,6,7,32
"6855","Modoc County",2003-06-01,12,0,12,5,29
"6856","Modoc County",2003-07-01,13,1,9,3,26
"6857","Modoc County",2003-08-01,13,1,21,2,37
"6858","Modoc County",2003-09-01,20,2,8,2,32
"6859","Modoc County",2003-10-01,18,3,10,4,35
"6860","Modoc County",2003-11-01,17,3,11,5,36
"6861","Modoc County",2003-12-01,13,2,8,4,27
"6862","Modoc County",2004-01-01,21,3,3,0,27
"6863","Modoc County",2004-02-01,17,2,8,3,30
"6864","Modoc County",2004-03-01,9,2,11,7,29
"6865","Modoc County",2004-04-01,8,5,15,6,34
"6866","Modoc County",2004-05-01,7,3,15,2,27
"6867","Modoc County",2004-06-01,13,3,7,3,26
"6868","Modoc County",2004-07-01,14,3,10,3,30
"6869","Modoc County",2004-08-01,13,3,8,3,27
"6870","Modoc County",2004-09-01,11,2,9,5,27
"6871","Modoc County",2004-10-01,12,2,10,4,28
"6872","Modoc County",2004-11-01,11,3,11,2,27
"6873","Modoc County",2004-12-01,11,3,12,1,27
"6874","Modoc County",2005-01-01,14,2,16,2,34
"6875","Modoc County",2005-02-01,17,3,13,2,35
"6876","Modoc County",2005-03-01,19,1,15,3,38
"6877","Modoc County",2005-04-01,19,1,14,5,39
"6878","Modoc County",2005-05-01,19,3,10,10,42
"6879","Modoc County",2005-06-01,18,2,16,4,40
"6880","Modoc County",2005-07-01,24,3,9,7,43
"6881","Modoc County",2005-08-01,18,3,12,7,40
"6882","Modoc County",2005-09-01,18,2,14,4,38
"6883","Modoc County",2005-10-01,16,2,13,4,35
"6884","Modoc County",2005-11-01,17,0,12,3,32
"6885","Modoc County",2005-12-01,12,4,9,1,26
"6886","Modoc County",2006-01-01,15,3,7,2,27
"6887","Modoc County",2006-02-01,10,4,6,2,22
"6888","Modoc County",2006-03-01,9,3,11,3,26
"6889","Modoc County",2006-04-01,12,5,13,3,33
"6890","Modoc County",2006-05-01,16,2,10,4,32
"6891","Modoc County",2006-06-01,14,2,11,1,28
"6892","Modoc County",2006-07-01,17,4,11,1,33
"6893","Modoc County",2006-08-01,13,3,11,3,30
"6894","Modoc County",2006-09-01,11,2,12,5,30
"6895","Modoc County",2006-10-01,18,3,12,3,36
"6896","Modoc County",2006-11-01,13,4,11,3,31
"6897","Modoc County",2006-12-01,15,3,12,4,34
"6898","Modoc County",2007-01-01,12,4,9,3,28
"6899","Modoc County",2007-02-01,12,3,6,4,25
"6900","Modoc County",2007-03-01,12,3,6,5,26
"6901","Modoc County",2007-04-01,17,3,8,3,31
"6902","Modoc County",2007-05-01,15,1,5,2,23
"6903","Modoc County",2007-06-01,20,1,3,1,25
"6904","Modoc County",2007-07-01,12,1,5,1,19
"6905","Modoc County",2007-08-01,10,1,7,1,19
"6906","Modoc County",2007-09-01,13,1,5,2,21
"6907","Modoc County",2007-10-01,12,2,9,1,24
"6908","Modoc County",2007-11-01,9,2,8,1,20
"6909","Modoc County",2007-12-01,5,1,6,1,13
"6910","Modoc County",2008-01-01,10,1,6,1,18
"6911","Modoc County",2008-02-01,11,0,9,1,21
"6912","Modoc County",2008-03-01,7,1,7,1,16
"6913","Modoc County",2008-04-01,8,1,8,2,19
"6914","Modoc County",2008-05-01,8,1,6,4,19
"6915","Modoc County",2008-06-01,14,2,5,2,23
"6916","Modoc County",2008-07-01,17,2,5,1,25
"6917","Modoc County",2008-08-01,18,2,4,1,25
"6918","Modoc County",2008-09-01,17,3,7,1,28
"6919","Modoc County",2008-10-01,10,3,6,0,19
"6920","Modoc County",2008-11-01,12,0,8,2,22
"6921","Modoc County",2008-12-01,15,0,8,1,24
"6922","Modoc County",2009-01-01,15,0,11,0,26
"6923","Modoc County",2009-02-01,18,1,14,0,33
"6924","Modoc County",2009-03-01,17,5,9,1,32
"6925","Modoc County",2009-04-01,12,5,7,1,25
"6926","Modoc County",2009-05-01,14,2,4,1,21
"6927","Modoc County",2009-06-01,11,2,5,1,19
"6928","Modoc County",2009-07-01,13,1,3,0,17
"6929","Modoc County",2009-08-01,10,1,4,1,16
"6930","Modoc County",2009-09-01,12,1,4,1,18
"6931","Modoc County",2009-10-01,12,1,6,1,20
"6932","Modoc County",2009-11-01,10,3,5,1,19
"6933","Modoc County",2009-12-01,8,1,3,2,14
"6934","Modoc County",2010-01-01,5,1,5,2,13
"6935","Modoc County",2010-02-01,7,1,3,1,12
"6936","Modoc County",2010-03-01,7,1,6,1,15
"6937","Modoc County",2010-04-01,9,1,5,0,15
"6938","Modoc County",2010-05-01,9,1,4,1,15
"6939","Modoc County",2010-06-01,10,2,3,0,15
"6940","Modoc County",2010-07-01,8,2,3,0,13
"6941","Modoc County",2010-08-01,8,2,4,2,16
"6942","Modoc County",2010-09-01,8,1,4,1,14
"6943","Modoc County",2010-10-01,6,1,4,0,11
"6944","Modoc County",2010-11-01,6,1,3,1,11
"6945","Modoc County",2010-12-01,7,2,5,2,16
"6946","Modoc County",2011-01-01,10,1,10,1,22
"6947","Modoc County",2011-02-01,10,1,10,1,22
"6948","Modoc County",2011-03-01,10,1,10,1,22
"6949","Modoc County",2011-04-01,7,1,11,2,21
"6950","Modoc County",2011-05-01,9,3,9,2,23
"6951","Modoc County",2011-06-01,8,3,9,2,22
"6952","Modoc County",2011-07-01,10,5,3,3,21
"6953","Modoc County",2011-08-01,9,3,7,2,21
"6954","Modoc County",2011-09-01,18,4,3,2,27
"6955","Modoc County",2011-10-01,14,4,4,4,26
"6956","Modoc County",2011-11-01,13,3,4,2,22
"6957","Modoc County",2011-12-01,13,3,4,3,23
"6958","Modoc County",2012-01-01,8,3,9,2,22
"6959","Modoc County",2012-02-01,9,2,9,2,22
"6960","Modoc County",2012-03-01,12,2,7,2,23
"6961","Modoc County",2012-04-01,10,2,8,1,21
"6962","Modoc County",2012-05-01,12,1,11,1,25
"6963","Modoc County",2012-06-01,12,1,5,0,18
"6964","Modoc County",2012-07-01,13,2,6,0,21
"6965","Modoc County",2012-08-01,13,2,5,1,21
"6966","Modoc County",2012-09-01,14,2,4,1,21
"6967","Modoc County",2012-10-01,15,3,11,2,31
"6968","Modoc County",2012-11-01,15,3,10,2,30
"6969","Modoc County",2012-12-01,15,3,10,1,29
"6970","Modoc County",2013-01-01,13,3,11,3,30
"6971","Modoc County",2013-02-01,12,3,13,2,30
"6972","Modoc County",2013-03-01,14,4,10,4,32
"6973","Modoc County",2013-04-01,13,3,11,3,30
"6974","Modoc County",2013-05-01,14,3,10,3,30
"6975","Modoc County",2013-06-01,13,4,11,2,30
"6976","Modoc County",2013-07-01,13,3,12,2,30
"6977","Modoc County",2013-08-01,10,1,8,1,20
"6978","Modoc County",2013-09-01,13,1,5,1,20
"6979","Modoc County",2013-10-01,14,1,9,1,25
"6980","Modoc County",2013-11-01,10,1,12,1,24
"6981","Modoc County",2013-12-01,14,1,11,3,29
"6982","Modoc County",2014-01-01,12,2,12,4,30
"6983","Modoc County",2014-02-01,14,2,12,4,32
"6984","Modoc County",2014-03-01,13,2,15,4,34
"6985","Modoc County",2014-04-01,11,2,17,3,33
"6986","Modoc County",2014-05-01,11,5,12,3,31
"6987","Modoc County",2014-06-01,11,4,14,4,33
"6988","Modoc County",2014-07-01,10,4,14,4,32
"6989","Modoc County",2014-08-01,15,4,7,4,30
"6990","Modoc County",2014-09-01,14,3,7,4,28
"6991","Modoc County",2014-10-01,19,3,5,1,28
"6992","Modoc County",2014-11-01,19,3,6,1,29
"6993","Modoc County",2014-12-01,23,2,4,2,31
"6994","Modoc County",2015-01-01,12,2,15,2,31
"6995","Modoc County",2015-02-01,10,3,9,4,26
"6996","Modoc County",2015-03-01,12,2,13,2,29
"6997","Modoc County",2015-04-01,11,2,7,1,21
"6998","Modoc County",2015-05-01,13,2,9,1,25
"6999","Modoc County",2015-06-01,13,2,8,1,24
"7000","Modoc County",2015-07-01,11,2,9,1,23
"7001","Modoc County",2015-08-01,8,2,7,1,18
"7002","Modoc County",2015-09-01,8,2,7,1,18
"7003","Modoc County",2015-10-01,9,2,7,1,19
"7004","Modoc County",2015-11-01,8,4,11,3,26
"7005","Modoc County",2015-12-01,6,3,13,2,24
"7006","Modoc County",2016-01-01,13,3,8,2,26
"7007","Modoc County",2016-02-01,5,2,8,3,18
"7008","Modoc County",2016-03-01,12,2,10,3,27
"7009","Modoc County",2016-04-01,12,3,11,1,27
"7010","Modoc County",2016-05-01,0,0,0,0,0
"7011","Modoc County",2016-06-01,0,0,0,0,0
"7012","Modoc County",2016-07-01,13,3,7,1,24
"7013","Modoc County",2016-08-01,12,3,7,2,24
"7014","Modoc County",2016-09-01,15,3,6,2,26
"7015","Modoc County",2016-10-01,16,3,7,1,27
"7016","Modoc County",2016-11-01,14,3,10,1,28
"7017","Modoc County",2016-12-01,11,2,9,1,23
"7018","Modoc County",2017-01-01,14,3,8,2,27
"7019","Modoc County",2017-02-01,13,3,7,2,25
"7020","Modoc County",2017-03-01,15,3,9,2,29
"7021","Modoc County",2017-04-01,16,1,8,2,27
"7022","Modoc County",2017-05-01,14,3,7,3,27
"7023","Modoc County",2017-06-01,18,3,7,3,31
"7024","Modoc County",2017-07-01,18,2,7,2,29
"7025","Modoc County",2017-08-01,20,3,8,3,34
"7026","Modoc County",2017-09-01,20,3,8,3,34
"7027","Modoc County",2017-10-01,22,3,8,2,35
"7028","Modoc County",2017-11-01,23,4,5,2,34
"7029","Modoc County",2017-12-01,20,4,10,2,36
"7030","Modoc County",2018-01-01,17,2,12,2,33
"7031","Modoc County",2018-02-01,22,2,9,2,35
"7032","Modoc County",2018-03-01,18,2,11,3,34
"7033","Modoc County",2018-04-01,16,3,12,1,32
"7034","Modoc County",2018-05-01,19,3,10,1,33
"7035","Modoc County",2018-06-01,19,4,11,2,36
"7036","Modoc County",2018-07-01,19,4,8,3,34
"7037","Modoc County",2018-08-01,25,4,8,3,40
"7038","Modoc County",2018-09-01,27,3,9,2,41
"7039","Modoc County",2018-10-01,23,4,9,3,39
"7040","Modoc County",2018-11-01,21,1,10,2,34
"7041","Modoc County",2018-12-01,21,4,12,1,38
"7042","Modoc County",2019-01-01,20,5,12,1,38
"7043","Modoc County",2019-02-01,21,7,10,1,39
"7044","Modoc County",2019-03-01,21,6,11,3,41
"7045","Modoc County",2019-04-01,19,6,10,4,39
"7046","Modoc County",2019-05-01,24,4,10,3,41
"7047","Modoc County",2019-06-01,25,8,9,2,44
"7048","Modoc County",2019-07-01,20,7,9,3,39
"7049","Modoc County",2019-08-01,0,NA,NA,NA,NA
"7050","Modoc County",2019-09-01,21,3,6,3,33
"7051","Modoc County",2019-10-01,19,7,10,3,39
"7052","Modoc County",2019-11-01,20,5,8,5,38
"7053","Modoc County",2019-12-01,25,3,8,3,39
"7054","Modoc County",2020-01-01,18,6,7,2,33
"7055","Modoc County",2020-02-01,23,4,8,6,41
"7056","Modoc County",2020-03-01,20,3,7,2,32
"7057","Mono County",1995-10-01,7.65,1.45,10.32,0.19,19.61
"7058","Mono County",1995-11-01,13.17,0.93,11.77,1.5,27.37
"7059","Mono County",1995-12-01,11.71,1.84,12.48,0.26,26.29
"7060","Mono County",1996-01-01,14.94,0.84,11.71,1.52,29.01
"7061","Mono County",1996-02-01,15.37,1.06,11.76,0.83,29.02
"7062","Mono County",1996-03-01,12.29,0.23,12.81,1.06,26.39
"7063","Mono County",1996-04-01,13.43,1.3,20.3,1.03,36.06
"7064","Mono County",1996-05-01,13.65,1.35,19,1.87,35.87
"7065","Mono County",1996-06-01,15.9,2.27,18.2,2.83,39.2
"7066","Mono County",1996-07-01,13.13,2.55,19.45,2.58,37.71
"7067","Mono County",1996-08-01,11.1,1.35,14.87,2.35,29.67
"7068","Mono County",1996-09-01,7.97,1.17,15.23,4.4,28.77
"7069","Mono County",1996-10-01,11.94,1.32,15,6.74,35
"7070","Mono County",1996-11-01,8.4,0.33,11.4,3.3,23.43
"7071","Mono County",1996-12-01,7.42,0.29,7.84,2.19,17.74
"7072","Mono County",1997-01-01,13.48,0.52,10,3.23,27.23
"7073","Mono County",1997-02-01,11.61,0.5,18.71,2.68,33.5
"7074","Mono County",1997-03-01,11.2,0.5,23.17,3.4,38.27
"7075","Mono County",1997-04-01,7.96,0.59,19.52,2.1,30.17
"7076","Mono County",1997-05-01,8.68,2.74,17.61,1.29,30.32
"7077","Mono County",1997-06-01,11.53,2.03,13.3,2.61,29.47
"7078","Mono County",1997-07-01,14.45,1.13,14.97,1.71,32.26
"7079","Mono County",1997-08-01,12.61,1.29,12.06,1.81,27.77
"7080","Mono County",1997-09-01,10.1,2.5,16.8,1.03,30.43
"7081","Mono County",1997-10-01,10.1,0.58,20.35,2.87,33.9
"7082","Mono County",1997-11-01,13.57,1.53,19.17,3.43,37.7
"7083","Mono County",1997-12-01,12.35,1.58,16.26,2.1,32.29
"7084","Mono County",1998-01-01,7.65,0.35,14.32,1.65,23.97
"7085","Mono County",1998-02-01,5.54,0.25,12.39,1.32,19.5
"7086","Mono County",1998-03-01,10.49,1.45,9.02,3.56,24.52
"7087","Mono County",1998-04-01,13.43,0.9,11.27,3.2,28.8
"7088","Mono County",1998-05-01,9.13,0.47,11.7,2.57,23.87
"7089","Mono County",1998-06-01,8.34,0.4,7.4,1.13,17.27
"7090","Mono County",1998-07-01,10.52,1.87,5.26,0.48,18.13
"7091","Mono County",1998-08-01,13.52,1.29,5.87,0.55,21.23
"7092","Mono County",1998-09-01,12.9,1.07,9.97,1.53,25.47
"7093","Mono County",1998-10-01,7.42,0.1,14.68,2.77,24.97
"7094","Mono County",1998-11-01,8.67,0.67,15.03,1.6,25.97
"7095","Mono County",1998-12-01,6.9,0.61,13,0.81,21.32
"7096","Mono County",1999-01-01,6.71,0.32,14.13,1.68,22.84
"7097","Mono County",1999-02-01,9.14,0.43,14.68,2.75,27
"7098","Mono County",1999-03-01,11.29,0.97,11.55,2.32,26.13
"7099","Mono County",1999-04-01,8.97,0.3,13.37,1.83,24.47
"7100","Mono County",1999-05-01,8.97,0.3,13.37,1.83,24.47
"7101","Mono County",1999-06-01,8.77,1.07,12.13,0.5,22.47
"7102","Mono County",1999-07-01,9.58,1.97,8.64,0.13,20.32
"7103","Mono County",1999-08-01,10.1,1.42,7.16,1.42,20.1
"7104","Mono County",1999-09-01,7.1,0.37,8.97,0.56,17
"7105","Mono County",1999-10-01,10.71,1.84,9.58,1.26,23.39
"7106","Mono County",1999-11-01,7.6,2.8,9.9,1.37,21.67
"7107","Mono County",1999-12-01,7,0.77,7.29,0.81,15.87
"7108","Mono County",2000-01-01,8.61,1.16,9.19,1.69,20.65
"7109","Mono County",2000-02-01,9.24,3.9,11.79,0.41,25.34
"7110","Mono County",2000-03-01,11.54,1.94,13.94,1.42,28.84
"7111","Mono County",2000-04-01,7.5,1,14.6,3.3,26.4
"7112","Mono County",2000-05-01,7.97,2.19,14.32,2.42,26.9
"7113","Mono County",2000-06-01,10.5,1.47,11.97,1.16,25.1
"7114","Mono County",2000-07-01,7.77,1.97,13.45,1.26,24.45
"7115","Mono County",2000-08-01,10.51,2,13.68,0.84,27.03
"7116","Mono County",2000-09-01,16.2,2.23,11.87,1,31.3
"7117","Mono County",2000-10-01,9.87,1.52,18.19,0.39,29.97
"7118","Mono County",2000-11-01,7.5,2.13,14.06,0.07,23.76
"7119","Mono County",2000-12-01,5.58,3.19,10.26,1,20.03
"7120","Mono County",2001-01-01,10,3,8,2,23
"7121","Mono County",2001-02-01,14,6,6,3,29
"7122","Mono County",2001-03-01,8,5,11,6,30
"7123","Mono County",2001-04-01,6,3,7,7,23
"7124","Mono County",2001-05-01,8,3,7,5,24
"7125","Mono County",2001-06-01,7,3,10,6,25
"7126","Mono County",2001-07-01,6,4,9,4,23
"7127","Mono County",2001-08-01,4,2,8,3,17
"7128","Mono County",2001-09-01,7,1,5,2,15
"7129","Mono County",2001-10-01,11,2,10,3,26
"7130","Mono County",2001-11-01,8,1,13,2,24
"7131","Mono County",2001-12-01,8,1,8,1,18
"7132","Mono County",2002-01-01,10,3,9,2,24
"7133","Mono County",2002-02-01,13,3,5,1,22
"7134","Mono County",2002-03-01,10,1,15,2,28
"7135","Mono County",2002-04-01,10,3,13,9,35
"7136","Mono County",2002-05-01,6,2,13,3,24
"7137","Mono County",2002-06-01,5,1,9,6,21
"7138","Mono County",2002-07-01,9,2,17,1,29
"7139","Mono County",2002-08-01,4,2,16,1,23
"7140","Mono County",2002-09-01,9,0,16,2,27
"7141","Mono County",2002-10-01,11,1,14,1,27
"7142","Mono County",2002-11-01,9,0,13,1,23
"7143","Mono County",2002-12-01,6,2,9,1,18
"7144","Mono County",2003-01-01,8,2,9,3,22
"7145","Mono County",2003-02-01,6,3,13,3,25
"7146","Mono County",2003-03-01,8,4,13,4,29
"7147","Mono County",2003-04-01,10,1,10,3,24
"7148","Mono County",2003-05-01,18,2,12,2,34
"7149","Mono County",2003-06-01,14,4,8,2,28
"7150","Mono County",2003-07-01,11,2,8,2,23
"7151","Mono County",2003-08-01,11,2,10,5,28
"7152","Mono County",2003-09-01,12,2,15,6,35
"7153","Mono County",2003-10-01,11,2,13,1,27
"7154","Mono County",2003-11-01,8,1,13,4,26
"7155","Mono County",2003-12-01,9,3,6,3,21
"7156","Mono County",2004-01-01,11,2,12,4,29
"7157","Mono County",2004-02-01,13,2,16,2,33
"7158","Mono County",2004-03-01,10,1,16,1,28
"7159","Mono County",2004-04-01,14,1,15,2,32
"7160","Mono County",2004-05-01,18,2,14,3,37
"7161","Mono County",2004-06-01,18,2,14,3,37
"7162","Mono County",2004-07-01,12,3,18,1,34
"7163","Mono County",2004-08-01,14,4,11,1,30
"7164","Mono County",2004-09-01,12,2,13,3,30
"7165","Mono County",2004-10-01,13,2,16,2,33
"7166","Mono County",2004-11-01,13,4,17,2,36
"7167","Mono County",2004-12-01,13,1,16,2,32
"7168","Mono County",2005-01-01,11,1,19,1,32
"7169","Mono County",2005-02-01,16,2,19,1,38
"7170","Mono County",2005-03-01,17,2,15,1,35
"7171","Mono County",2005-04-01,13,1,16,3,33
"7172","Mono County",2005-05-01,12,2,19,5,38
"7173","Mono County",2005-06-01,16,2,12,5,35
"7174","Mono County",2005-07-01,17,4,11,4,36
"7175","Mono County",2005-08-01,17,3,13,4,37
"7176","Mono County",2005-09-01,14,2,19,4,39
"7177","Mono County",2005-10-01,15,1,13,5,34
"7178","Mono County",2005-11-01,19,1,11,2,33
"7179","Mono County",2005-12-01,17,1,14,2,34
"7180","Mono County",2006-01-01,15,1,17,2,35
"7181","Mono County",2006-02-01,15,3,12,4,34
"7182","Mono County",2006-03-01,16,1,13,5,35
"7183","Mono County",2006-04-01,14,1,9,2,26
"7184","Mono County",2006-05-01,14,1,15,1,31
"7185","Mono County",2006-06-01,10,1,16,3,30
"7186","Mono County",2006-07-01,16,1,7,3,27
"7187","Mono County",2006-08-01,18,1,8,3,30
"7188","Mono County",2006-09-01,11,4,18,5,38
"7189","Mono County",2006-10-01,11,2,18,4,35
"7190","Mono County",2006-11-01,12,1,14,4,31
"7191","Mono County",2006-12-01,11,0,11,3,25
"7192","Mono County",2007-01-01,16,1,10,2,29
"7193","Mono County",2007-02-01,18,1,14,1,34
"7194","Mono County",2007-03-01,20,2,19,3,44
"7195","Mono County",2007-04-01,18,1,21,2,42
"7196","Mono County",2007-05-01,14,2,20,3,39
"7197","Mono County",2007-06-01,16,3,17,2,38
"7198","Mono County",2007-07-01,16,2,19,1,38
"7199","Mono County",2007-08-01,17,1,20,3,41
"7200","Mono County",2007-09-01,19,1,14,3,37
"7201","Mono County",2007-10-01,18,1,16,1,36
"7202","Mono County",2007-11-01,17,1,15,2,35
"7203","Mono County",2007-12-01,12,0,17,1,30
"7204","Mono County",2008-01-01,14,1,14,1,30
"7205","Mono County",2008-02-01,12,1,13,1,27
"7206","Mono County",2008-03-01,14,2,11,2,29
"7207","Mono County",2008-04-01,15,1,14,3,33
"7208","Mono County",2008-05-01,15,1,19,1,36
"7209","Mono County",2008-06-01,14,1,23,2,40
"7210","Mono County",2008-07-01,16,2,17,1,36
"7211","Mono County",2008-08-01,17,1,19,1,38
"7212","Mono County",2008-09-01,13,1,20,1,35
"7213","Mono County",2008-10-01,17,1,15,3,36
"7214","Mono County",2008-11-01,16,1,12,3,32
"7215","Mono County",2008-12-01,17,2,14,2,35
"7216","Mono County",2009-01-01,20,3,17,1,41
"7217","Mono County",2009-02-01,22,3,17,2,44
"7218","Mono County",2009-03-01,16,1,21,2,40
"7219","Mono County",2009-04-01,17,1,22,2,42
"7220","Mono County",2009-05-01,16,1,19,3,39
"7221","Mono County",2009-06-01,16,1,14,1,32
"7222","Mono County",2009-07-01,19,1,11,2,33
"7223","Mono County",2009-08-01,18,1,13,2,34
"7224","Mono County",2009-09-01,15,1,16,2,34
"7225","Mono County",2009-10-01,6,1,6,1,14
"7226","Mono County",2009-11-01,6,1,3,0,10
"7227","Mono County",2009-12-01,13,2,15,3,33
"7228","Mono County",2010-01-01,14,3,15,4,36
"7229","Mono County",2010-02-01,11,2,13,4,30
"7230","Mono County",2010-03-01,9,1,16,3,29
"7231","Mono County",2010-04-01,8,1,14,1,24
"7232","Mono County",2010-05-01,13,3,13,0,29
"7233","Mono County",2010-06-01,20,4,9,1,34
"7234","Mono County",2010-07-01,21,3,10,2,36
"7235","Mono County",2010-08-01,26,2,10,3,41
"7236","Mono County",2010-09-01,17,2,19,2,40
"7237","Mono County",2010-10-01,18,4,17,2,41
"7238","Mono County",2010-11-01,13,2,18,1,34
"7239","Mono County",2010-12-01,17,1,8,0,26
"7240","Mono County",2011-01-01,15,2,14,0,31
"7241","Mono County",2011-02-01,11,1,15,1,28
"7242","Mono County",2011-03-01,10,2,12,1,25
"7243","Mono County",2011-04-01,12,2,11,0,25
"7244","Mono County",2011-05-01,17,2,10,0,29
"7245","Mono County",2011-06-01,16,0,7,2,25
"7246","Mono County",2011-07-01,17,0,8,1,26
"7247","Mono County",2011-08-01,15,0,8,0,23
"7248","Mono County",2011-09-01,15,2,9,0,26
"7249","Mono County",2011-10-01,14,2,9,1,26
"7250","Mono County",2011-11-01,14,3,11,1,29
"7251","Mono County",2011-12-01,10,2,11,1,24
"7252","Mono County",2012-01-01,6,2,12,1,21
"7253","Mono County",2012-02-01,11,1,14,0,26
"7254","Mono County",2012-03-01,10,2,9,0,21
"7255","Mono County",2012-04-01,12,2,8,1,23
"7256","Mono County",2012-05-01,14,3,12,1,30
"7257","Mono County",2012-06-01,14,3,13,0,30
"7258","Mono County",2012-07-01,14,3,16,0,33
"7259","Mono County",2012-08-01,16,2,15,0,33
"7260","Mono County",2012-09-01,13,2,18,1,34
"7261","Mono County",2012-10-01,13,3,21,2,39
"7262","Mono County",2012-11-01,11,1,17,2,31
"7263","Mono County",2012-12-01,12,0,13,1,26
"7264","Mono County",2013-01-01,12,1,14,2,29
"7265","Mono County",2013-02-01,6,1,19,2,28
"7266","Mono County",2013-03-01,8,0,19,2,29
"7267","Mono County",2013-04-01,8,1,17,2,28
"7268","Mono County",2013-05-01,12,1,15,3,31
"7269","Mono County",2013-06-01,11,2,18,3,34
"7270","Mono County",2013-07-01,12,3,20,2,37
"7271","Mono County",2013-08-01,12,2,18,1,33
"7272","Mono County",2013-09-01,10,2,20,2,34
"7273","Mono County",2013-10-01,10,2,20,3,35
"7274","Mono County",2013-11-01,13,4,15,4,36
"7275","Mono County",2013-12-01,15,3,14,4,36
"7276","Mono County",2014-01-01,16,4,12,5,37
"7277","Mono County",2014-02-01,16,3,12,6,37
"7278","Mono County",2014-03-01,13,3,13,5,34
"7279","Mono County",2014-04-01,15,2,12,3,32
"7280","Mono County",2014-05-01,16,1,13,3,33
"7281","Mono County",2014-06-01,16,0,11,5,32
"7282","Mono County",2014-07-01,9,2,14,5,30
"7283","Mono County",2014-08-01,8,2,13,5,28
"7284","Mono County",2014-09-01,8,0,12,6,26
"7285","Mono County",2014-10-01,6,1,16,3,26
"7286","Mono County",2014-11-01,8,2,15,1,26
"7287","Mono County",2014-12-01,7,1,12,2,22
"7288","Mono County",2015-01-01,8,0,11,1,20
"7289","Mono County",2015-02-01,8,1,11,1,21
"7290","Mono County",2015-03-01,8,0,9,2,19
"7291","Mono County",2015-04-01,7,0,12,2,21
"7292","Mono County",2015-05-01,5,1,10,2,18
"7293","Mono County",2015-06-01,4,0,12,1,17
"7294","Mono County",2015-07-01,7,4,9,1,21
"7295","Mono County",2015-08-01,7,3,9,2,21
"7296","Mono County",2015-09-01,5,2,11,2,20
"7297","Mono County",2015-10-01,9,1,10,3,23
"7298","Mono County",2015-11-01,12,1,12,2,27
"7299","Mono County",2015-12-01,13,0,5,3,21
"7300","Mono County",2016-01-01,17,2,5,2,26
"7301","Mono County",2016-02-01,17,4,9,1,31
"7302","Mono County",2016-03-01,13,4,14,2,33
"7303","Mono County",2016-04-01,13,3,10,3,29
"7304","Mono County",2016-05-01,13,4,10,3,30
"7305","Mono County",2016-06-01,13,4,8,2,27
"7306","Mono County",2016-07-01,13,3,8,1,25
"7307","Mono County",2016-08-01,12,3,6,2,23
"7308","Mono County",2016-09-01,14,2,13,2,31
"7309","Mono County",2016-10-01,13,2,11,3,29
"7310","Mono County",2016-11-01,11,1,13,2,27
"7311","Mono County",2016-12-01,0,0,0,0,0
"7312","Mono County",2017-01-01,11,1,10,2,24
"7313","Mono County",2017-02-01,14,0,11,2,27
"7314","Mono County",2017-03-01,18,1,12,1,32
"7315","Mono County",2017-04-01,17,2,8,1,28
"7316","Mono County",2017-05-01,18,1,8,1,28
"7317","Mono County",2017-06-01,19,1,8,1,29
"7318","Mono County",2017-07-01,21,2,6,1,30
"7319","Mono County",2017-08-01,19,3,11,1,34
"7320","Mono County",2017-09-01,19,6,13,0,38
"7321","Mono County",2017-10-01,13,1,11,3,28
"7322","Mono County",2017-11-01,16,3,14,1,34
"7323","Mono County",2017-12-01,13,3,12,0,28
"7324","Mono County",2018-01-01,11,2,10,1,24
"7325","Mono County",2018-02-01,13,3,14,2,32
"7326","Mono County",2018-03-01,16,2,16,2,36
"7327","Mono County",2018-04-01,15,1,14,1,31
"7328","Mono County",2018-05-01,16,1,15,1,33
"7329","Mono County",2018-06-01,14,2,13,0,29
"7330","Mono County",2018-07-01,16,2,8,1,27
"7331","Mono County",2018-08-01,15,3,9,0,27
"7332","Mono County",2018-09-01,13,1,13,1,28
"7333","Mono County",2018-10-01,11,2,12,0,25
"7334","Mono County",2018-11-01,11,2,13,1,27
"7335","Mono County",2018-12-01,10,2,11,0,23
"7336","Mono County",2019-01-01,12,1,10,1,24
"7337","Mono County",2019-02-01,13,3,10,0,26
"7338","Mono County",2019-03-01,13,2,10,0,25
"7339","Mono County",2019-04-01,15,2,12,0,29
"7340","Mono County",2019-05-01,18,1,14,1,34
"7341","Mono County",2019-06-01,19,1,14,1,35
"7342","Mono County",2019-07-01,20,0,14,1,35
"7343","Mono County",2019-08-01,19,0,12,0,31
"7344","Mono County",2019-09-01,21,1,12,0,34
"7345","Mono County",2019-10-01,19,2,12,0,33
"7346","Mono County",2019-11-01,17,2,7,0,26
"7347","Mono County",2019-12-01,17,2,7,0,26
"7348","Mono County",2020-01-01,19,2,9,0,30
"7349","Mono County",2020-02-01,20,0,9,1,30
"7350","Mono County",2020-03-01,17,1,7,1,26
"7351","Monterey County",1995-10-01,573,69,291,32,965
"7352","Monterey County",1995-11-01,593,74,295,32,994
"7353","Monterey County",1995-12-01,560,61,296,30,947
"7354","Monterey County",1996-01-01,615,65,263,32,975
"7355","Monterey County",1996-02-01,625,64,292,28,1009
"7356","Monterey County",1996-03-01,626,65,308,30,1029
"7357","Monterey County",1996-04-01,596,64,310,35,1005
"7358","Monterey County",1996-05-01,585,59,303,36,983
"7359","Monterey County",1996-06-01,586,68,293,37,984
"7360","Monterey County",1996-07-01,595,72,307,47,1021
"7361","Monterey County",1996-08-01,566,69,359,48,1042
"7362","Monterey County",1996-09-01,567,61,360,44,1032
"7363","Monterey County",1996-10-01,549,63,345,44,1001
"7364","Monterey County",1996-11-01,581,69,320,43,1013
"7365","Monterey County",1996-12-01,580,72,289,46,987
"7366","Monterey County",1997-01-01,580,75,321,50,1026
"7367","Monterey County",1997-02-01,707,82,225,47,1061
"7368","Monterey County",1997-03-01,612,83,359,46,1100
"7369","Monterey County",1997-04-01,577,67,328,38,1010
"7370","Monterey County",1997-05-01,575,70,338,38,1021
"7371","Monterey County",1997-06-01,591,78,343,33,1045
"7372","Monterey County",1997-07-01,611,72,349,42,1074
"7373","Monterey County",1997-08-01,629,72,348,37,1086
"7374","Monterey County",1997-09-01,641,77,360,50,1128
"7375","Monterey County",1997-10-01,642,53,370,68,1133
"7376","Monterey County",1997-11-01,609,86,359,58,1112
"7377","Monterey County",1997-12-01,613,85,327,53,1078
"7378","Monterey County",1998-01-01,602,68,327,57,1054
"7379","Monterey County",1998-02-01,585,65,321,50,1021
"7380","Monterey County",1998-03-01,634,80,300,44,1058
"7381","Monterey County",1998-04-01,628,70,306,53,1057
"7382","Monterey County",1998-05-01,622,78,309,45,1054
"7383","Monterey County",1998-06-01,631,70,349,44,1094
"7384","Monterey County",1998-07-01,677,75,330,49,1131
"7385","Monterey County",1998-08-01,686,72,332,47,1137
"7386","Monterey County",1998-09-01,654,80,333,51,1118
"7387","Monterey County",1998-10-01,606,65,325,49,1045
"7388","Monterey County",1998-11-01,572,63,334,46,1015
"7389","Monterey County",1998-12-01,524,64,332,51,971
"7390","Monterey County",1999-01-01,559,72,311,47,989
"7391","Monterey County",1999-02-01,559,72,311,47,989
"7392","Monterey County",1999-03-01,561,47,333,41,982
"7393","Monterey County",1999-04-01,541,52,325,32,950
"7394","Monterey County",1999-05-01,542,56,343,36,977
"7395","Monterey County",1999-06-01,577,55,318,33,983
"7396","Monterey County",1999-07-01,572,59,329,34,994
"7397","Monterey County",1999-08-01,564,62,338,35,999
"7398","Monterey County",1999-09-01,575,71,332,35,1013
"7399","Monterey County",1999-10-01,600,63,327,38,1028
"7400","Monterey County",1999-11-01,581,52,312,33,978
"7401","Monterey County",1999-12-01,578,48,284,32,942
"7402","Monterey County",2000-01-01,555,60,304,31,950
"7403","Monterey County",2000-02-01,532,79,354,39,1004
"7404","Monterey County",2000-03-01,517,68,360,47,992
"7405","Monterey County",2000-04-01,497,47,352,52,948
"7406","Monterey County",2000-05-01,508,52,348,49,957
"7407","Monterey County",2000-06-01,518,56,338,49,961
"7408","Monterey County",2000-07-01,426,54,457,58,995
"7409","Monterey County",2000-08-01,436,54,448,56,994
"7410","Monterey County",2000-09-01,411,50,474,57,992
"7411","Monterey County",2000-10-01,404,52,451,58,965
"7412","Monterey County",2000-11-01,405,50,457,62,974
"7413","Monterey County",2000-12-01,422,48,435,56,961
"7414","Monterey County",2001-01-01,432,49,409,52,942
"7415","Monterey County",2001-02-01,417,44,404,61,926
"7416","Monterey County",2001-03-01,413,50,410,57,930
"7417","Monterey County",2001-04-01,437,53,417,56,963
"7418","Monterey County",2001-05-01,440,59,416,52,967
"7419","Monterey County",2001-06-01,437,63,430,49,979
"7420","Monterey County",2001-07-01,422,41,463,47,973
"7421","Monterey County",2001-08-01,431,43,456,55,985
"7422","Monterey County",2001-09-01,433,48,491,62,1034
"7423","Monterey County",2001-10-01,424,45,476,68,1013
"7424","Monterey County",2001-11-01,411,47,469,56,983
"7425","Monterey County",2001-12-01,404,45,458,55,962
"7426","Monterey County",2002-01-01,453,46,388,55,942
"7427","Monterey County",2002-02-01,434,46,356,48,884
"7428","Monterey County",2002-03-01,469,34,352,53,908
"7429","Monterey County",2002-04-01,486,43,349,57,935
"7430","Monterey County",2002-05-01,495,46,359,54,954
"7431","Monterey County",2002-06-01,480,48,378,62,968
"7432","Monterey County",2002-07-01,448,51,393,60,952
"7433","Monterey County",2002-08-01,453,58,418,52,981
"7434","Monterey County",2002-09-01,473,51,415,52,991
"7435","Monterey County",2002-10-01,454,54,441,61,1010
"7436","Monterey County",2002-11-01,461,56,405,72,994
"7437","Monterey County",2002-12-01,492,56,409,61,1018
"7438","Monterey County",2003-01-01,533,45,398,69,1045
"7439","Monterey County",2003-02-01,511,43,398,71,1023
"7440","Monterey County",2003-03-01,501,54,377,67,999
"7441","Monterey County",2003-04-01,522,54,389,62,1027
"7442","Monterey County",2003-05-01,530,47,401,69,1047
"7443","Monterey County",2003-06-01,521,42,408,66,1037
"7444","Monterey County",2003-07-01,511,66,422,43,1042
"7445","Monterey County",2003-08-01,500,70,446,59,1075
"7446","Monterey County",2003-09-01,518,65,430,59,1072
"7447","Monterey County",2003-10-01,561,78,432,58,1129
"7448","Monterey County",2003-11-01,570,82,450,60,1162
"7449","Monterey County",2003-12-01,537,72,426,60,1095
"7450","Monterey County",2004-01-01,561,84,410,60,1115
"7451","Monterey County",2004-02-01,593,84,425,54,1156
"7452","Monterey County",2004-03-01,563,76,445,54,1138
"7453","Monterey County",2004-04-01,548,67,453,60,1128
"7454","Monterey County",2004-05-01,547,71,440,68,1126
"7455","Monterey County",2004-06-01,545,74,427,70,1116
"7456","Monterey County",2004-07-01,528,77,444,54,1103
"7457","Monterey County",2004-08-01,548,83,418,50,1099
"7458","Monterey County",2004-09-01,570,82,408,69,1129
"7459","Monterey County",2004-10-01,611,81,399,65,1156
"7460","Monterey County",2004-11-01,616,79,401,49,1145
"7461","Monterey County",2004-12-01,603,74,391,49,1117
"7462","Monterey County",2005-01-01,653,81,338,41,1113
"7463","Monterey County",2005-02-01,672,90,349,48,1159
"7464","Monterey County",2005-03-01,622,87,362,58,1129
"7465","Monterey County",2005-04-01,629,83,369,67,1148
"7466","Monterey County",2005-05-01,638,90,382,61,1171
"7467","Monterey County",2005-06-01,662,94,382,65,1203
"7468","Monterey County",2005-07-01,669,82,386,68,1205
"7469","Monterey County",2005-08-01,657,80,358,55,1150
"7470","Monterey County",2005-09-01,666,94,378,50,1188
"7471","Monterey County",2005-10-01,622,85,391,55,1153
"7472","Monterey County",2005-11-01,611,71,373,56,1111
"7473","Monterey County",2005-12-01,582,69,370,42,1063
"7474","Monterey County",2006-01-01,623,84,356,44,1107
"7475","Monterey County",2006-02-01,657,95,373,45,1170
"7476","Monterey County",2006-03-01,709,96,332,43,1180
"7477","Monterey County",2006-04-01,726,103,316,57,1202
"7478","Monterey County",2006-05-01,752,102,302,57,1213
"7479","Monterey County",2006-06-01,757,82,302,62,1203
"7480","Monterey County",2006-07-01,742,87,289,67,1185
"7481","Monterey County",2006-08-01,757,79,296,61,1193
"7482","Monterey County",2006-09-01,782,88,297,51,1218
"7483","Monterey County",2006-10-01,794,89,305,56,1244
"7484","Monterey County",2006-11-01,756,94,318,56,1224
"7485","Monterey County",2006-12-01,772,93,309,46,1220
"7486","Monterey County",2007-01-01,786,109,238,40,1173
"7487","Monterey County",2007-02-01,785,116,253,40,1194
"7488","Monterey County",2007-03-01,780,95,260,35,1170
"7489","Monterey County",2007-04-01,768,118,232,28,1146
"7490","Monterey County",2007-05-01,755,95,245,42,1137
"7491","Monterey County",2007-06-01,751,109,281,49,1190
"7492","Monterey County",2007-07-01,779,100,277,47,1203
"7493","Monterey County",2007-08-01,769,94,257,49,1169
"7494","Monterey County",2007-09-01,743,109,247,45,1144
"7495","Monterey County",2007-10-01,781,114,246,41,1182
"7496","Monterey County",2007-11-01,788,110,239,41,1178
"7497","Monterey County",2007-12-01,746,90,237,38,1111
"7498","Monterey County",2008-01-01,732,102,189,31,1054
"7499","Monterey County",2008-02-01,777,115,164,30,1086
"7500","Monterey County",2008-03-01,801,111,187,32,1131
"7501","Monterey County",2008-04-01,796,103,175,28,1102
"7502","Monterey County",2008-05-01,772,89,195,38,1094
"7503","Monterey County",2008-06-01,804,93,188,34,1119
"7504","Monterey County",2008-07-01,791,89,200,39,1119
"7505","Monterey County",2008-08-01,770,91,215,35,1111
"7506","Monterey County",2008-09-01,788,93,214,34,1129
"7507","Monterey County",2008-10-01,762,93,187,26,1068
"7508","Monterey County",2008-11-01,728,81,176,29,1014
"7509","Monterey County",2008-12-01,712,78,180,34,1004
"7510","Monterey County",2009-01-01,715,78,185,31,1009
"7511","Monterey County",2009-02-01,694,80,194,32,1000
"7512","Monterey County",2009-03-01,676,75,199,43,993
"7513","Monterey County",2009-04-01,692,82,183,39,996
"7514","Monterey County",2009-05-01,707,85,198,42,1032
"7515","Monterey County",2009-06-01,683,92,210,49,1034
"7516","Monterey County",2009-07-01,680,91,211,52,1034
"7517","Monterey County",2009-08-01,686,79,248,52,1065
"7518","Monterey County",2009-09-01,647,77,285,49,1058
"7519","Monterey County",2009-10-01,642,77,279,50,1048
"7520","Monterey County",2009-11-01,613,83,281,40,1017
"7521","Monterey County",2009-12-01,582,76,295,54,1007
"7522","Monterey County",2010-01-01,628,85,290,36,1039
"7523","Monterey County",2010-02-01,635,80,241,27,983
"7524","Monterey County",2010-03-01,651,74,247,23,995
"7525","Monterey County",2010-04-01,649,86,235,26,996
"7526","Monterey County",2010-05-01,611,98,246,28,983
"7527","Monterey County",2010-06-01,610,98,260,36,1004
"7528","Monterey County",2010-07-01,608,85,256,38,987
"7529","Monterey County",2010-08-01,631,91,270,38,1030
"7530","Monterey County",2010-09-01,645,84,290,34,1053
"7531","Monterey County",2010-10-01,643,82,294,40,1059
"7532","Monterey County",2010-11-01,636,83,279,38,1036
"7533","Monterey County",2010-12-01,670,79,242,33,1024
"7534","Monterey County",2011-01-01,708,89,251,28,1076
"7535","Monterey County",2011-02-01,730,86,259,32,1107
"7536","Monterey County",2011-03-01,699,79,262,31,1071
"7537","Monterey County",2011-04-01,657,70,279,42,1048
"7538","Monterey County",2011-05-01,627,83,285,49,1044
"7539","Monterey County",2011-06-01,645,79,264,49,1037
"7540","Monterey County",2011-07-01,774,72,179,46,1071
"7541","Monterey County",2011-08-01,737,79,191,47,1054
"7542","Monterey County",2011-09-01,757,84,183,46,1070
"7543","Monterey County",2011-10-01,739,82,184,47,1052
"7544","Monterey County",2011-11-01,717,90,190,48,1045
"7545","Monterey County",2011-12-01,714,94,192,45,1045
"7546","Monterey County",2012-01-01,661,91,228,49,1029
"7547","Monterey County",2012-02-01,675,100,260,54,1089
"7548","Monterey County",2012-03-01,668,97,254,59,1078
"7549","Monterey County",2012-04-01,669,90,288,57,1104
"7550","Monterey County",2012-05-01,722,98,287,63,1170
"7551","Monterey County",2012-06-01,729,90,278,61,1158
"7552","Monterey County",2012-07-01,709,96,306,55,1166
"7553","Monterey County",2012-08-01,652,98,280,60,1090
"7554","Monterey County",2012-09-01,601,85,257,39,982
"7555","Monterey County",2012-10-01,635,88,262,54,1039
"7556","Monterey County",2012-11-01,669,104,244,51,1068
"7557","Monterey County",2012-12-01,662,103,246,58,1069
"7558","Monterey County",2013-01-01,679,100,256,59,1094
"7559","Monterey County",2013-02-01,699,58,270,98,1125
"7560","Monterey County",2013-03-01,716,119,288,53,1176
"7561","Monterey County",2013-04-01,677,113,285,47,1122
"7562","Monterey County",2013-05-01,721,107,261,55,1144
"7563","Monterey County",2013-06-01,705,118,262,53,1138
"7564","Monterey County",2013-07-01,710,115,236,36,1097
"7565","Monterey County",2013-08-01,727,108,217,32,1084
"7566","Monterey County",2013-09-01,635,100,262,41,1038
"7567","Monterey County",2013-10-01,664,94,196,51,1005
"7568","Monterey County",2013-11-01,617,89,183,45,934
"7569","Monterey County",2013-12-01,624,90,192,36,942
"7570","Monterey County",2014-01-01,660,92,183,39,974
"7571","Monterey County",2014-02-01,608,81,192,43,924
"7572","Monterey County",2014-03-01,622,83,211,45,961
"7573","Monterey County",2014-04-01,599,201,82,46,928
"7574","Monterey County",2014-05-01,650,97,202,53,1002
"7575","Monterey County",2014-06-01,638,96,198,55,987
"7576","Monterey County",2014-07-01,634,108,217,58,1017
"7577","Monterey County",2014-08-01,666,109,217,50,1042
"7578","Monterey County",2014-09-01,639,104,215,44,1002
"7579","Monterey County",2014-10-01,678,105,225,45,1053
"7580","Monterey County",2014-11-01,643,92,204,41,980
"7581","Monterey County",2014-12-01,592,76,218,42,928
"7582","Monterey County",2015-01-01,623,66,182,39,910
"7583","Monterey County",2015-02-01,562,67,174,27,830
"7584","Monterey County",2015-03-01,555,66,269,34,924
"7585","Monterey County",2015-04-01,535,67,272,40,914
"7586","Monterey County",2015-05-01,525,64,276,52,917
"7587","Monterey County",2015-06-01,520,54,257,53,884
"7588","Monterey County",2015-07-01,567,63,258,60,948
"7589","Monterey County",2015-08-01,541,58,240,56,895
"7590","Monterey County",2015-09-01,538,64,264,50,916
"7591","Monterey County",2015-10-01,548,73,279,49,949
"7592","Monterey County",2015-11-01,530,66,301,54,951
"7593","Monterey County",2015-12-01,529,58,290,52,929
"7594","Monterey County",2016-01-01,543,62,271,51,927
"7595","Monterey County",2016-02-01,524,55,294,49,922
"7596","Monterey County",2016-03-01,470,61,302,52,885
"7597","Monterey County",2016-04-01,461,60,298,50,869
"7598","Monterey County",2016-05-01,456,60,293,47,856
"7599","Monterey County",2016-06-01,466,75,298,55,894
"7600","Monterey County",2016-07-01,494,74,276,53,897
"7601","Monterey County",2016-08-01,495,74,305,59,933
"7602","Monterey County",2016-09-01,508,67,299,64,938
"7603","Monterey County",2016-10-01,510,71,290,47,918
"7604","Monterey County",2016-11-01,511,68,291,57,927
"7605","Monterey County",2016-12-01,512,64,278,51,905
"7606","Monterey County",2017-01-01,535,68,260,46,909
"7607","Monterey County",2017-02-01,548,69,251,48,916
"7608","Monterey County",2017-03-01,531,67,261,43,902
"7609","Monterey County",2017-04-01,538,64,247,50,899
"7610","Monterey County",2017-05-01,521,61,246,55,883
"7611","Monterey County",2017-06-01,513,58,235,57,863
"7612","Monterey County",2017-07-01,524,58,249,57,888
"7613","Monterey County",2017-08-01,504,62,276,58,900
"7614","Monterey County",2017-09-01,490,62,291,52,895
"7615","Monterey County",2017-10-01,494,58,298,54,904
"7616","Monterey County",2017-11-01,486,54,286,56,882
"7617","Monterey County",2017-12-01,461,53,282,50,846
"7618","Monterey County",2018-01-01,460,55,285,49,849
"7619","Monterey County",2018-02-01,452,59,313,51,875
"7620","Monterey County",2018-03-01,444,60,303,53,860
"7621","Monterey County",2018-04-01,471,61,298,62,892
"7622","Monterey County",2018-05-01,462,70,292,56,880
"7623","Monterey County",2018-06-01,464,72,286,54,876
"7624","Monterey County",2018-07-01,466,79,282,59,886
"7625","Monterey County",2018-08-01,476,78,277,67,898
"7626","Monterey County",2018-09-01,481,81,278,63,903
"7627","Monterey County",2018-10-01,467,76,266,65,874
"7628","Monterey County",2018-11-01,458,68,264,65,855
"7629","Monterey County",2018-12-01,449,67,264,56,836
"7630","Monterey County",2019-01-01,471,70,240,51,832
"7631","Monterey County",2019-02-01,489,64,262,51,866
"7632","Monterey County",2019-03-01,488,55,269,47,859
"7633","Monterey County",2019-04-01,491,65,277,46,879
"7634","Monterey County",2019-05-01,472,63,289,55,879
"7635","Monterey County",2019-06-01,480,58,283,54,875
"7636","Monterey County",2019-07-01,506,47,273,57,883
"7637","Monterey County",2019-08-01,497,46,292,51,886
"7638","Monterey County",2019-09-01,498,47,279,46,870
"7639","Monterey County",2019-10-01,492,50,258,41,841
"7640","Monterey County",2019-11-01,509,55,248,38,850
"7641","Monterey County",2019-12-01,500,54,252,44,850
"7642","Monterey County",2020-01-01,497,55,227,42,821
"7643","Monterey County",2020-02-01,505,63,270,38,876
"7644","Monterey County",2020-03-01,467,54,238,38,797
"7645","Napa County",1995-10-01,132,13,74,10,229
"7646","Napa County",1995-11-01,126,17,64,9,216
"7647","Napa County",1995-12-01,122,15,63,9,209
"7648","Napa County",1996-01-01,121,9,79,12,221
"7649","Napa County",1996-02-01,110,7,90,11,218
"7650","Napa County",1996-03-01,100,10,95,14,219
"7651","Napa County",1996-04-01,103,11,83,12,209
"7652","Napa County",1996-05-01,103,15,67,9,194
"7653","Napa County",1996-06-01,98,9,59,12,178
"7654","Napa County",1996-07-01,92,10,60,14,176
"7655","Napa County",1996-08-01,93,9,59,11,172
"7656","Napa County",1996-09-01,90,10,64,12,176
"7657","Napa County",1996-10-01,93,9,72,11,185
"7658","Napa County",1996-11-01,92,10,71,12,185
"7659","Napa County",1996-12-01,93,11,72,11,187
"7660","Napa County",1997-01-01,102,8,62,11,183
"7661","Napa County",1997-02-01,104,9,64,11,188
"7662","Napa County",1997-03-01,105,10,66,12,193
"7663","Napa County",1997-04-01,124,10,69,8,211
"7664","Napa County",1997-05-01,113,9,61,7,190
"7665","Napa County",1997-06-01,100,13,60,11,184
"7666","Napa County",1997-07-01,107,11,60,6,184
"7667","Napa County",1997-08-01,103,10,62,9,184
"7668","Napa County",1997-09-01,101,12,69,10,192
"7669","Napa County",1997-10-01,114,12,71,10,207
"7670","Napa County",1997-11-01,114,10,70,12,206
"7671","Napa County",1997-12-01,114,10,68,10,202
"7672","Napa County",1998-01-01,112,13,74,10,209
"7673","Napa County",1998-02-01,110,13,74,10,207
"7674","Napa County",1998-03-01,105,10,74,10,199
"7675","Napa County",1998-04-01,126,9,55,14,204
"7676","Napa County",1998-05-01,121,11,70,14,216
"7677","Napa County",1998-06-01,132,16,72,11,231
"7678","Napa County",1998-07-01,126,9,55,14,204
"7679","Napa County",1998-08-01,121,11,70,14,216
"7680","Napa County",1998-09-01,132,16,72,11,231
"7681","Napa County",1998-10-01,124,11,74,9,218
"7682","Napa County",1998-11-01,121,13,63,8,205
"7683","Napa County",1998-12-01,113,13,47,8,181
"7684","Napa County",1999-01-01,115,11,55,6,187
"7685","Napa County",1999-02-01,118,16,45,5,184
"7686","Napa County",1999-03-01,128,14,42,6,190
"7687","Napa County",1999-04-01,88,15,73,7,183
"7688","Napa County",1999-05-01,116,19,55,4,194
"7689","Napa County",1999-06-01,92,16,87,8,203
"7690","Napa County",1999-07-01,80,15,120,6,221
"7691","Napa County",1999-08-01,105,17,88,8,218
"7692","Napa County",1999-09-01,115,3,80,8,206
"7693","Napa County",1999-10-01,92,16,87,8,203
"7694","Napa County",1999-11-01,92,16,87,8,203
"7695","Napa County",1999-12-01,135,15,45,5,200
"7696","Napa County",2000-01-01,56,5,139,18,218
"7697","Napa County",2000-02-01,114,15,84,4,217
"7698","Napa County",2000-03-01,145,15,45,5,210
"7699","Napa County",2000-04-01,125,18,60,2,205
"7700","Napa County",2000-05-01,150,18,50,10,228
"7701","Napa County",2000-06-01,141,15,60,12,228
"7702","Napa County",2000-07-01,92,18,105,8,223
"7703","Napa County",2000-08-01,101,19,92,8,220
"7704","Napa County",2000-09-01,60,10,140,10,220
"7705","Napa County",2000-10-01,81,15,114,8,218
"7706","Napa County",2000-11-01,38,5,146,19,208
"7707","Napa County",2000-12-01,59,8,132,23,222
"7708","Napa County",2001-01-01,38,7,148,26,219
"7709","Napa County",2001-02-01,40,5,154,18,217
"7710","Napa County",2001-03-01,53,6,147,12,218
"7711","Napa County",2001-04-01,40,4,157,15,216
"7712","Napa County",2001-05-01,51,4,141,18,214
"7713","Napa County",2001-06-01,45,9,153,19,226
"7714","Napa County",2001-07-01,48,1,156,13,218
"7715","Napa County",2001-08-01,150,19,45,3,217
"7716","Napa County",2001-09-01,46,3,158,16,223
"7717","Napa County",2001-10-01,38,5,170,20,233
"7718","Napa County",2001-11-01,47,5,172,18,242
"7719","Napa County",2001-12-01,109,15,95,9,228
"7720","Napa County",2002-01-01,86,13,133,16,248
"7721","Napa County",2002-02-01,41,5,166,22,234
"7722","Napa County",2002-03-01,44,6,151,18,219
"7723","Napa County",2002-04-01,74,10,103,19,206
"7724","Napa County",2002-05-01,85,12,119,21,237
"7725","Napa County",2002-06-01,92,14,130,22,258
"7726","Napa County",2002-07-01,84,12,123,14,233
"7727","Napa County",2002-08-01,79,11,123,14,227
"7728","Napa County",2002-09-01,57,5,148,21,231
"7729","Napa County",2002-10-01,63,6,149,22,240
"7730","Napa County",2002-11-01,66,8,136,28,238
"7731","Napa County",2002-12-01,67,11,122,22,222
"7732","Napa County",2003-01-01,74,8,135,25,242
"7733","Napa County",2003-02-01,63,8,150,25,246
"7734","Napa County",2003-03-01,54,7,153,19,233
"7735","Napa County",2003-04-01,50,7,157,16,230
"7736","Napa County",2003-05-01,51,6,154,19,230
"7737","Napa County",2003-06-01,48,6,158,25,237
"7738","Napa County",2003-07-01,41,3,160,32,236
"7739","Napa County",2003-08-01,37,4,153,27,221
"7740","Napa County",2003-09-01,38,6,170,21,235
"7741","Napa County",2003-10-01,43,7,175,23,248
"7742","Napa County",2003-11-01,42,9,168,25,244
"7743","Napa County",2003-12-01,40,10,154,26,230
"7744","Napa County",2004-01-01,47,7,154,24,232
"7745","Napa County",2004-02-01,47,7,157,30,241
"7746","Napa County",2004-03-01,43,4,160,25,232
"7747","Napa County",2004-04-01,46,4,153,24,227
"7748","Napa County",2004-05-01,42,3,165,25,235
"7749","Napa County",2004-06-01,38,4,164,29,235
"7750","Napa County",2004-07-01,40,6,166,34,246
"7751","Napa County",2004-08-01,41,5,164,27,237
"7752","Napa County",2004-09-01,46,6,163,24,239
"7753","Napa County",2004-10-01,52,8,176,32,268
"7754","Napa County",2004-11-01,44,5,164,31,244
"7755","Napa County",2004-12-01,46,3,163,28,240
"7756","Napa County",2005-01-01,42,4,180,27,253
"7757","Napa County",2005-02-01,135,24,85,10,254
"7758","Napa County",2005-03-01,142,20,80,10,252
"7759","Napa County",2005-04-01,130,19,92,9,250
"7760","Napa County",2005-05-01,131,16,104,11,262
"7761","Napa County",2005-06-01,124,16,101,12,253
"7762","Napa County",2005-07-01,133,15,105,14,267
"7763","Napa County",2005-08-01,131,14,107,18,270
"7764","Napa County",2005-09-01,131,14,107,18,270
"7765","Napa County",2005-10-01,133,12,101,13,259
"7766","Napa County",2005-11-01,134,13,111,17,275
"7767","Napa County",2005-12-01,117,17,107,18,259
"7768","Napa County",2006-01-01,125,15,111,16,267
"7769","Napa County",2006-02-01,125,15,117,12,269
"7770","Napa County",2006-03-01,113,18,116,10,257
"7771","Napa County",2006-04-01,105,15,110,10,240
"7772","Napa County",2006-05-01,110,12,101,10,233
"7773","Napa County",2006-06-01,116,11,96,11,234
"7774","Napa County",2006-07-01,112,13,92,11,228
"7775","Napa County",2006-08-01,120,13,92,8,233
"7776","Napa County",2006-09-01,137,20,78,8,243
"7777","Napa County",2006-10-01,119,22,75,14,230
"7778","Napa County",2006-11-01,122,19,70,14,225
"7779","Napa County",2006-12-01,128,19,64,10,221
"7780","Napa County",2007-01-01,139,21,67,14,241
"7781","Napa County",2007-02-01,134,21,80,11,246
"7782","Napa County",2007-03-01,128,26,81,13,248
"7783","Napa County",2007-04-01,131,25,65,13,234
"7784","Napa County",2007-05-01,143,24,54,14,235
"7785","Napa County",2007-06-01,152,20,62,12,246
"7786","Napa County",2007-07-01,141,20,63,9,233
"7787","Napa County",2007-08-01,140,22,59,8,229
"7788","Napa County",2007-09-01,139,25,59,13,236
"7789","Napa County",2007-10-01,120,19,70,17,226
"7790","Napa County",2007-11-01,119,19,73,16,227
"7791","Napa County",2007-12-01,118,16,67,10,211
"7792","Napa County",2008-01-01,128,20,77,10,235
"7793","Napa County",2008-02-01,119,27,81,15,242
"7794","Napa County",2008-03-01,138,16,71,15,240
"7795","Napa County",2008-04-01,142,16,68,10,236
"7796","Napa County",2008-05-01,142,15,70,8,235
"7797","Napa County",2008-06-01,149,16,62,11,238
"7798","Napa County",2008-07-01,140,18,70,13,241
"7799","Napa County",2008-08-01,135,18,69,13,235
"7800","Napa County",2008-09-01,133,27,74,9,243
"7801","Napa County",2008-10-01,131,27,73,17,248
"7802","Napa County",2008-11-01,137,27,64,14,242
"7803","Napa County",2008-12-01,136,27,64,14,241
"7804","Napa County",2009-01-01,139,21,66,12,238
"7805","Napa County",2009-02-01,163,23,66,11,263
"7806","Napa County",2009-03-01,159,20,72,13,264
"7807","Napa County",2009-04-01,158,17,74,13,262
"7808","Napa County",2009-05-01,135,17,72,12,236
"7809","Napa County",2009-06-01,132,16,70,14,232
"7810","Napa County",2009-07-01,146,18,68,16,248
"7811","Napa County",2009-08-01,159,21,65,19,264
"7812","Napa County",2009-09-01,158,23,68,17,266
"7813","Napa County",2009-10-01,155,20,74,18,267
"7814","Napa County",2009-11-01,158,24,67,15,264
"7815","Napa County",2009-12-01,140,20,66,8,234
"7816","Napa County",2010-01-01,135,20,65,13,233
"7817","Napa County",2010-02-01,135,17,53,12,217
"7818","Napa County",2010-03-01,147,15,61,13,236
"7819","Napa County",2010-04-01,147,15,61,13,236
"7820","Napa County",2010-05-01,152,23,68,14,257
"7821","Napa County",2010-06-01,135,22,68,16,241
"7822","Napa County",2010-07-01,128,15,69,19,231
"7823","Napa County",2010-08-01,134,13,78,19,244
"7824","Napa County",2010-09-01,154,20,76,15,265
"7825","Napa County",2010-10-01,164,21,70,15,270
"7826","Napa County",2010-11-01,164,22,72,14,272
"7827","Napa County",2010-12-01,152,15,74,12,253
"7828","Napa County",2011-01-01,151,14,81,15,261
"7829","Napa County",2011-02-01,168,14,71,19,272
"7830","Napa County",2011-03-01,175,15,61,18,269
"7831","Napa County",2011-04-01,168,20,69,17,274
"7832","Napa County",2011-05-01,164,17,70,15,266
"7833","Napa County",2011-06-01,162,18,84,16,280
"7834","Napa County",2011-07-01,141,17,75,20,253
"7835","Napa County",2011-08-01,142,14,74,20,250
"7836","Napa County",2011-09-01,164,18,65,18,265
"7837","Napa County",2011-10-01,178,19,68,16,281
"7838","Napa County",2011-11-01,178,19,60,10,267
"7839","Napa County",2011-12-01,168,14,61,10,253
"7840","Napa County",2012-01-01,159,15,77,11,262
"7841","Napa County",2012-02-01,157,10,73,12,252
"7842","Napa County",2012-03-01,161,10,76,11,258
"7843","Napa County",2012-04-01,163,10,73,13,259
"7844","Napa County",2012-05-01,146,13,77,9,245
"7845","Napa County",2012-06-01,148,16,76,11,251
"7846","Napa County",2012-07-01,136,18,82,14,250
"7847","Napa County",2012-08-01,130,20,75,16,241
"7848","Napa County",2012-09-01,141,18,79,14,252
"7849","Napa County",2012-10-01,131,21,76,13,241
"7850","Napa County",2012-11-01,144,23,77,16,260
"7851","Napa County",2012-12-01,154,24,64,13,255
"7852","Napa County",2013-01-01,163,21,76,10,270
"7853","Napa County",2013-02-01,165,19,73,9,266
"7854","Napa County",2013-03-01,147,21,79,13,260
"7855","Napa County",2013-04-01,127,18,83,10,238
"7856","Napa County",2013-05-01,120,14,73,11,218
"7857","Napa County",2013-06-01,131,20,82,10,243
"7858","Napa County",2013-07-01,149,16,68,10,243
"7859","Napa County",2013-08-01,164,11,65,8,248
"7860","Napa County",2013-09-01,165,15,69,6,255
"7861","Napa County",2013-10-01,163,20,62,8,253
"7862","Napa County",2013-11-01,160,22,63,8,253
"7863","Napa County",2013-12-01,153,22,53,10,238
"7864","Napa County",2014-01-01,156,23,51,12,242
"7865","Napa County",2014-02-01,165,28,47,10,250
"7866","Napa County",2014-03-01,159,21,51,8,239
"7867","Napa County",2014-04-01,160,21,53,5,239
"7868","Napa County",2014-05-01,153,23,55,6,237
"7869","Napa County",2014-06-01,162,25,50,7,244
"7870","Napa County",2014-07-01,153,24,52,8,237
"7871","Napa County",2014-08-01,147,24,57,8,236
"7872","Napa County",2014-09-01,135,15,43,2,195
"7873","Napa County",2014-10-01,114,12,52,2,180
"7874","Napa County",2014-11-01,113,17,46,2,178
"7875","Napa County",2014-12-01,109,15,43,4,171
"7876","Napa County",2015-01-01,98,15,41,4,158
"7877","Napa County",2015-02-01,110,17,46,3,176
"7878","Napa County",2015-03-01,114,16,45,7,182
"7879","Napa County",2015-04-01,121,18,45,4,188
"7880","Napa County",2015-05-01,126,14,48,5,193
"7881","Napa County",2015-06-01,122,14,43,2,181
"7882","Napa County",2015-07-01,96,12,40,3,151
"7883","Napa County",2015-08-01,107,12,47,12,178
"7884","Napa County",2015-09-01,101,11,53,10,175
"7885","Napa County",2015-10-01,121,16,38,6,181
"7886","Napa County",2015-11-01,106,10,38,4,158
"7887","Napa County",2015-12-01,84,12,42,3,141
"7888","Napa County",2016-01-01,94,12,40,4,150
"7889","Napa County",2016-02-01,98,19,44,3,164
"7890","Napa County",2016-03-01,97,15,46,4,162
"7891","Napa County",2016-04-01,117,23,72,11,223
"7892","Napa County",2016-05-01,111,15,76,11,213
"7893","Napa County",2016-06-01,106,17,68,12,203
"7894","Napa County",2016-07-01,126,17,63,11,217
"7895","Napa County",2016-08-01,116,14,59,14,203
"7896","Napa County",2016-09-01,112,13,57,11,193
"7897","Napa County",2016-10-01,89,13,40,5,147
"7898","Napa County",2016-11-01,158,23,15,3,199
"7899","Napa County",2016-12-01,190,28,14,4,236
"7900","Napa County",2017-01-01,192,32,19,5,248
"7901","Napa County",2017-02-01,152,19,12,3,186
"7902","Napa County",2017-03-01,119,22,34,4,179
"7903","Napa County",2017-04-01,120,19,29,6,174
"7904","Napa County",2017-05-01,101,20,46,11,178
"7905","Napa County",2017-06-01,108,23,49,11,191
"7906","Napa County",2017-07-01,119,20,48,8,195
"7907","Napa County",2017-08-01,112,15,41,10,178
"7908","Napa County",2017-09-01,112,19,40,7,178
"7909","Napa County",2017-10-01,94,17,34,8,153
"7910","Napa County",2017-11-01,114,25,32,13,184
"7911","Napa County",2017-12-01,104,24,40,10,178
"7912","Napa County",2018-01-01,122,20,47,12,201
"7913","Napa County",2018-02-01,115,18,53,15,201
"7914","Napa County",2018-03-01,131,22,58,13,224
"7915","Napa County",2018-04-01,139,25,61,10,235
"7916","Napa County",2018-05-01,126,20,62,13,221
"7917","Napa County",2018-06-01,133,16,60,21,230
"7918","Napa County",2018-07-01,135,17,59,16,227
"7919","Napa County",2018-08-01,139,16,66,19,240
"7920","Napa County",2018-09-01,146,19,70,15,250
"7921","Napa County",2018-10-01,146,19,68,12,245
"7922","Napa County",2018-11-01,149,14,74,15,252
"7923","Napa County",2018-12-01,145,11,79,18,253
"7924","Napa County",2019-01-01,134,13,82,17,246
"7925","Napa County",2019-02-01,137,16,72,23,248
"7926","Napa County",2019-03-01,138,18,71,24,251
"7927","Napa County",2019-04-01,150,22,69,17,258
"7928","Napa County",2019-05-01,151,19,68,11,249
"7929","Napa County",2019-06-01,141,24,79,11,255
"7930","Napa County",2019-07-01,152,23,73,17,265
"7931","Napa County",2019-08-01,141,17,78,16,252
"7932","Napa County",2019-09-01,128,24,85,14,251
"7933","Napa County",2019-10-01,119,20,93,13,245
"7934","Napa County",2019-11-01,124,25,87,19,255
"7935","Napa County",2019-12-01,117,18,84,18,237
"7936","Napa County",2020-01-01,130,20,81,12,243
"7937","Napa County",2020-02-01,136,25,83,10,254
"7938","Napa County",2020-03-01,128,21,74,13,236
"7939","Nevada County",1995-10-01,81,13,59,14,167
"7940","Nevada County",1995-11-01,75,8,66,16,165
"7941","Nevada County",1995-12-01,78,5,70,10,163
"7942","Nevada County",1996-01-01,79,11,78,11,179
"7943","Nevada County",1996-02-01,78,9,84,12,183
"7944","Nevada County",1996-03-01,76,10,81,9,176
"7945","Nevada County",1996-04-01,80,10,71,7,168
"7946","Nevada County",1996-05-01,65,5,64,7,141
"7947","Nevada County",1996-06-01,66,7,61,8,142
"7948","Nevada County",1996-07-01,77,6,58,7,148
"7949","Nevada County",1996-08-01,89,7,51,10,157
"7950","Nevada County",1996-09-01,79,5,57,11,152
"7951","Nevada County",1996-10-01,68,5,55,9,137
"7952","Nevada County",1996-11-01,60,9,58,22,149
"7953","Nevada County",1996-12-01,69,9,52,10,140
"7954","Nevada County",1997-01-01,83,6,53,9,151
"7955","Nevada County",1997-02-01,72,4,59,9,144
"7956","Nevada County",1997-03-01,69,9,61,9,148
"7957","Nevada County",1997-04-01,66,11,64,8,149
"7958","Nevada County",1997-05-01,71,11,69,8,159
"7959","Nevada County",1997-06-01,70,13,63,10,156
"7960","Nevada County",1997-07-01,72,14,50,13,149
"7961","Nevada County",1997-08-01,80,15,52,13,160
"7962","Nevada County",1997-09-01,76,14,51,11,152
"7963","Nevada County",1997-10-01,70,11,44,13,138
"7964","Nevada County",1997-11-01,67,10,48,8,133
"7965","Nevada County",1997-12-01,71,8,48,8,135
"7966","Nevada County",1998-01-01,74,12,51,10,147
"7967","Nevada County",1998-02-01,73,13,53,11,150
"7968","Nevada County",1998-03-01,75,11,47,16,149
"7969","Nevada County",1998-04-01,77,15,53,17,162
"7970","Nevada County",1998-05-01,75,14,51,11,151
"7971","Nevada County",1998-06-01,70,11,42,16,139
"7972","Nevada County",1998-07-01,71,12,43,14,140
"7973","Nevada County",1998-08-01,62,10,47,9,128
"7974","Nevada County",1998-09-01,67,9,38,7,121
"7975","Nevada County",1998-10-01,61,14,27,8,110
"7976","Nevada County",1998-11-01,69,11,26,8,114
"7977","Nevada County",1998-12-01,68,9,30,8,115
"7978","Nevada County",1999-01-01,77,10,36,5,128
"7979","Nevada County",1999-02-01,79,12,45,9,145
"7980","Nevada County",1999-03-01,85,11,53,4,153
"7981","Nevada County",1999-04-01,80,14,50,6,150
"7982","Nevada County",1999-05-01,86,12,47,7,152
"7983","Nevada County",1999-06-01,95,9,47,8,159
"7984","Nevada County",1999-07-01,87,10,54,12,163
"7985","Nevada County",1999-08-01,75,9,48,13,145
"7986","Nevada County",1999-09-01,75,8,53,13,149
"7987","Nevada County",1999-10-01,84,7,59,12,162
"7988","Nevada County",1999-11-01,94,6,71,15,186
"7989","Nevada County",1999-12-01,92,3,67,10,172
"7990","Nevada County",2000-01-01,80,5,65,10,160
"7991","Nevada County",2000-02-01,81,4,60,12,157
"7992","Nevada County",2000-03-01,81,5,59,12,157
"7993","Nevada County",2000-04-01,82,4,65,12,163
"7994","Nevada County",2000-05-01,72,6,63,13,154
"7995","Nevada County",2000-06-01,75,4,64,14,157
"7996","Nevada County",2000-07-01,67,6,56,14,143
"7997","Nevada County",2000-08-01,55,6,51,9,121
"7998","Nevada County",2000-09-01,67,7,49,10,133
"7999","Nevada County",2000-10-01,70,8,39,9,126
"8000","Nevada County",2000-11-01,73,8,45,9,135
"8001","Nevada County",2000-12-01,64,6,47,6,123
"8002","Nevada County",2001-01-01,65,7,43,9,124
"8003","Nevada County",2001-02-01,68,8,42,11,129
"8004","Nevada County",2001-03-01,73,9,48,11,141
"8005","Nevada County",2001-04-01,71,6,54,11,142
"8006","Nevada County",2001-05-01,70,6,53,11,140
"8007","Nevada County",2001-06-01,69,6,52,11,138
"8008","Nevada County",2001-07-01,60,3,46,10,119
"8009","Nevada County",2001-08-01,62,4,46,10,122
"8010","Nevada County",2001-09-01,66,4,50,10,130
"8011","Nevada County",2001-10-01,68,5,50,9,132
"8012","Nevada County",2001-11-01,63,5,47,8,123
"8013","Nevada County",2001-12-01,60,4,44,9,117
"8014","Nevada County",2002-01-01,61,4,45,9,119
"8015","Nevada County",2002-02-01,68,4,51,11,134
"8016","Nevada County",2002-03-01,72,5,54,11,142
"8017","Nevada County",2002-04-01,86,9,46,12,153
"8018","Nevada County",2002-05-01,90,9,50,5,154
"8019","Nevada County",2002-06-01,87,9,47,12,155
"8020","Nevada County",2002-07-01,81,10,42,8,141
"8021","Nevada County",2002-08-01,78,11,35,10,134
"8022","Nevada County",2002-09-01,73,13,48,11,145
"8023","Nevada County",2002-10-01,64,10,50,16,140
"8024","Nevada County",2002-11-01,57,9,54,17,137
"8025","Nevada County",2002-12-01,53,11,59,13,136
"8026","Nevada County",2003-01-01,64,11,47,15,137
"8027","Nevada County",2003-02-01,76,11,56,12,155
"8028","Nevada County",2003-03-01,71,12,59,9,151
"8029","Nevada County",2003-04-01,75,13,62,11,161
"8030","Nevada County",2003-05-01,84,13,63,11,171
"8031","Nevada County",2003-06-01,81,15,57,12,165
"8032","Nevada County",2003-07-01,68,18,63,12,161
"8033","Nevada County",2003-08-01,67,12,64,10,153
"8034","Nevada County",2003-09-01,70,12,66,11,159
"8035","Nevada County",2003-10-01,68,11,55,33,167
"8036","Nevada County",2003-11-01,60,11,78,16,165
"8037","Nevada County",2003-12-01,60,8,70,13,151
"8038","Nevada County",2004-01-01,60,11,70,11,152
"8039","Nevada County",2004-02-01,74,11,70,12,167
"8040","Nevada County",2004-03-01,69,9,75,17,170
"8041","Nevada County",2004-04-01,80,14,66,15,175
"8042","Nevada County",2004-05-01,90,16,62,11,179
"8043","Nevada County",2004-06-01,98,13,62,11,184
"8044","Nevada County",2004-07-01,90,14,76,10,190
"8045","Nevada County",2004-08-01,99,14,65,12,190
"8046","Nevada County",2004-09-01,80,11,64,10,165
"8047","Nevada County",2004-10-01,84,15,68,13,180
"8048","Nevada County",2004-11-01,84,14,71,20,189
"8049","Nevada County",2004-12-01,91,10,56,13,170
"8050","Nevada County",2005-01-01,99,11,64,10,184
"8051","Nevada County",2005-02-01,91,13,79,18,201
"8052","Nevada County",2005-03-01,91,11,83,20,205
"8053","Nevada County",2005-04-01,92,12,82,16,202
"8054","Nevada County",2005-05-01,90,13,71,13,187
"8055","Nevada County",2005-06-01,87,13,54,16,170
"8056","Nevada County",2005-07-01,73,17,67,21,178
"8057","Nevada County",2005-08-01,71,20,77,21,189
"8058","Nevada County",2005-09-01,85,19,67,17,188
"8059","Nevada County",2005-10-01,71,19,74,11,175
"8060","Nevada County",2005-11-01,78,16,62,14,170
"8061","Nevada County",2005-12-01,79,9,53,16,157
"8062","Nevada County",2006-01-01,82,14,70,11,177
"8063","Nevada County",2006-02-01,72,13,79,14,178
"8064","Nevada County",2006-03-01,88,18,65,19,190
"8065","Nevada County",2006-04-01,109,19,67,15,210
"8066","Nevada County",2006-05-01,77,16,68,16,177
"8067","Nevada County",2006-06-01,65,7,38,28,138
"8068","Nevada County",2006-07-01,66,12,64,15,157
"8069","Nevada County",2006-08-01,83,9,61,13,166
"8070","Nevada County",2006-09-01,78,12,58,13,161
"8071","Nevada County",2006-10-01,94,15,62,11,182
"8072","Nevada County",2006-11-01,89,10,65,11,175
"8073","Nevada County",2006-12-01,80,12,57,8,157
"8074","Nevada County",2007-01-01,80,15,60,9,164
"8075","Nevada County",2007-02-01,82,16,53,10,161
"8076","Nevada County",2007-03-01,91,18,55,13,177
"8077","Nevada County",2007-04-01,103,17,60,11,191
"8078","Nevada County",2007-05-01,87,12,61,13,173
"8079","Nevada County",2007-06-01,79,19,58,13,169
"8080","Nevada County",2007-07-01,84,14,46,9,153
"8081","Nevada County",2007-08-01,57,10,85,10,162
"8082","Nevada County",2007-09-01,72,12,65,11,160
"8083","Nevada County",2007-10-01,86,13,45,13,157
"8084","Nevada County",2007-11-01,113,14,42,10,179
"8085","Nevada County",2007-12-01,91,15,45,7,158
"8086","Nevada County",2008-01-01,114,38,48,8,208
"8087","Nevada County",2008-02-01,101,11,63,11,186
"8088","Nevada County",2008-03-01,86,15,66,11,178
"8089","Nevada County",2008-04-01,95,16,54,9,174
"8090","Nevada County",2008-05-01,84,22,52,13,171
"8091","Nevada County",2008-06-01,123,41,52,9,225
"8092","Nevada County",2008-07-01,113,39,47,9,208
"8093","Nevada County",2008-08-01,108,42,40,8,198
"8094","Nevada County",2008-09-01,105,14,56,12,187
"8095","Nevada County",2008-10-01,79,16,57,8,160
"8096","Nevada County",2008-11-01,48,12,57,5,122
"8097","Nevada County",2008-12-01,64,12,55,9,140
"8098","Nevada County",2009-01-01,72,11,66,14,163
"8099","Nevada County",2009-02-01,85,12,57,11,165
"8100","Nevada County",2009-03-01,88,11,52,14,165
"8101","Nevada County",2009-04-01,84,11,58,15,168
"8102","Nevada County",2009-05-01,85,10,67,17,179
"8103","Nevada County",2009-06-01,83,13,59,17,172
"8104","Nevada County",2009-07-01,73,16,52,15,156
"8105","Nevada County",2009-08-01,72,20,45,11,148
"8106","Nevada County",2009-09-01,74,18,51,12,155
"8107","Nevada County",2009-10-01,74,16,54,13,157
"8108","Nevada County",2009-11-01,76,16,52,12,156
"8109","Nevada County",2009-12-01,64,14,55,9,142
"8110","Nevada County",2010-01-01,63,13,49,10,135
"8111","Nevada County",2010-02-01,66,12,41,13,132
"8112","Nevada County",2010-03-01,58,13,42,13,126
"8113","Nevada County",2010-04-01,54,15,78,14,161
"8114","Nevada County",2010-05-01,59,11,71,16,157
"8115","Nevada County",2010-06-01,67,11,75,24,177
"8116","Nevada County",2010-07-01,61,11,74,19,165
"8117","Nevada County",2010-08-01,68,14,73,15,170
"8118","Nevada County",2010-09-01,70,14,71,14,169
"8119","Nevada County",2010-10-01,79,11,81,15,186
"8120","Nevada County",2010-11-01,72,10,73,18,173
"8121","Nevada County",2010-12-01,72,14,69,16,171
"8122","Nevada County",2011-01-01,75,15,73,14,177
"8123","Nevada County",2011-02-01,76,17,82,13,188
"8124","Nevada County",2011-03-01,70,18,64,10,162
"8125","Nevada County",2011-04-01,72,19,56,13,160
"8126","Nevada County",2011-05-01,60,13,61,18,152
"8127","Nevada County",2011-06-01,63,17,53,17,150
"8128","Nevada County",2011-07-01,88,19,59,13,179
"8129","Nevada County",2011-08-01,87,21,63,13,184
"8130","Nevada County",2011-09-01,71,20,63,9,163
"8131","Nevada County",2011-10-01,84,19,65,7,175
"8132","Nevada County",2011-11-01,84,13,57,8,162
"8133","Nevada County",2011-12-01,89,13,67,9,178
"8134","Nevada County",2012-01-01,88,15,72,11,186
"8135","Nevada County",2012-02-01,93,18,70,10,191
"8136","Nevada County",2012-03-01,93,17,67,8,185
"8137","Nevada County",2012-04-01,101,20,68,9,198
"8138","Nevada County",2012-05-01,103,18,63,10,194
"8139","Nevada County",2012-06-01,113,22,56,12,203
"8140","Nevada County",2012-07-01,118,23,54,11,206
"8141","Nevada County",2012-08-01,117,26,43,14,200
"8142","Nevada County",2012-09-01,114,24,38,14,190
"8143","Nevada County",2012-10-01,102,19,67,10,198
"8144","Nevada County",2012-11-01,93,18,70,10,191
"8145","Nevada County",2012-12-01,119,19,36,5,179
"8146","Nevada County",2013-01-01,101,17,64,11,193
"8147","Nevada County",2013-02-01,115,23,53,11,202
"8148","Nevada County",2013-03-01,115,23,54,11,203
"8149","Nevada County",2013-04-01,108,19,23,7,157
"8150","Nevada County",2013-05-01,109,15,21,6,151
"8151","Nevada County",2013-06-01,104,15,24,5,148
"8152","Nevada County",2013-07-01,101,19,21,3,144
"8153","Nevada County",2013-08-01,112,25,20,3,160
"8154","Nevada County",2013-09-01,124,23,18,6,171
"8155","Nevada County",2013-10-01,159,43,18,8,228
"8156","Nevada County",2013-11-01,107,25,20,10,162
"8157","Nevada County",2013-12-01,160,38,17,7,222
"8158","Nevada County",2014-01-01,150,40,21,11,222
"8159","Nevada County",2014-02-01,148,41,23,8,220
"8160","Nevada County",2014-03-01,158,38,26,6,228
"8161","Nevada County",2014-04-01,164,39,23,7,233
"8162","Nevada County",2014-05-01,136,32,23,7,198
"8163","Nevada County",2014-06-01,177,41,29,8,255
"8164","Nevada County",2014-07-01,155,47,39,5,246
"8165","Nevada County",2014-08-01,155,45,42,4,246
"8166","Nevada County",2014-09-01,149,46,38,4,237
"8167","Nevada County",2014-10-01,143,39,45,9,236
"8168","Nevada County",2014-11-01,120,35,58,10,223
"8169","Nevada County",2014-12-01,108,33,47,8,196
"8170","Nevada County",2015-01-01,130,38,36,8,212
"8171","Nevada County",2015-02-01,138,41,42,12,233
"8172","Nevada County",2015-03-01,122,41,45,9,217
"8173","Nevada County",2015-04-01,125,33,46,9,213
"8174","Nevada County",2015-05-01,140,39,42,11,232
"8175","Nevada County",2015-06-01,158,41,31,9,239
"8176","Nevada County",2015-07-01,147,39,36,7,229
"8177","Nevada County",2015-08-01,146,36,41,8,231
"8178","Nevada County",2015-09-01,135,37,42,9,223
"8179","Nevada County",2015-10-01,134,37,43,11,225
"8180","Nevada County",2015-11-01,141,33,49,11,234
"8181","Nevada County",2015-12-01,126,31,50,8,215
"8182","Nevada County",2016-01-01,120,29,46,10,205
"8183","Nevada County",2016-02-01,135,29,43,14,221
"8184","Nevada County",2016-03-01,139,29,35,10,213
"8185","Nevada County",2016-04-01,136,33,30,10,209
"8186","Nevada County",2016-05-01,131,26,44,8,209
"8187","Nevada County",2016-06-01,132,28,43,6,209
"8188","Nevada County",2016-07-01,130,33,43,8,214
"8189","Nevada County",2016-08-01,129,33,35,7,204
"8190","Nevada County",2016-09-01,120,33,38,10,201
"8191","Nevada County",2016-10-01,119,34,38,10,201
"8192","Nevada County",2016-11-01,114,27,35,10,186
"8193","Nevada County",2016-12-01,110,25,29,9,173
"8194","Nevada County",2017-01-01,109,23,31,11,174
"8195","Nevada County",2017-02-01,128,23,39,13,203
"8196","Nevada County",2017-03-01,123,26,38,10,197
"8197","Nevada County",2017-04-01,126,30,29,10,195
"8198","Nevada County",2017-05-01,124,29,30,8,191
"8199","Nevada County",2017-06-01,124,24,30,7,185
"8200","Nevada County",2017-07-01,128,26,40,8,202
"8201","Nevada County",2017-08-01,139,29,46,7,221
"8202","Nevada County",2017-09-01,148,34,44,5,231
"8203","Nevada County",2017-10-01,146,34,37,5,222
"8204","Nevada County",2017-11-01,139,35,38,5,217
"8205","Nevada County",2017-12-01,140,30,37,7,214
"8206","Nevada County",2018-01-01,150,32,41,7,230
"8207","Nevada County",2018-02-01,153,38,37,7,235
"8208","Nevada County",2018-03-01,135,38,35,5,213
"8209","Nevada County",2018-04-01,144,41,39,8,232
"8210","Nevada County",2018-05-01,136,36,40,7,219
"8211","Nevada County",2018-06-01,140,38,41,6,225
"8212","Nevada County",2018-07-01,146,31,47,8,232
"8213","Nevada County",2018-08-01,134,29,46,10,219
"8214","Nevada County",2018-09-01,144,34,31,10,219
"8215","Nevada County",2018-10-01,143,20,39,11,213
"8216","Nevada County",2018-11-01,143,23,48,10,224
"8217","Nevada County",2018-12-01,143,21,36,12,212
"8218","Nevada County",2019-01-01,145,21,37,9,212
"8219","Nevada County",2019-02-01,145,26,39,8,218
"8220","Nevada County",2019-03-01,139,29,39,9,216
"8221","Nevada County",2019-04-01,128,28,39,10,205
"8222","Nevada County",2019-05-01,130,26,41,6,203
"8223","Nevada County",2019-06-01,122,27,34,5,188
"8224","Nevada County",2019-07-01,113,29,27,6,175
"8225","Nevada County",2019-08-01,118,32,32,5,187
"8226","Nevada County",2019-09-01,119,32,31,7,189
"8227","Nevada County",2019-10-01,129,36,31,9,205
"8228","Nevada County",2019-11-01,131,31,27,9,198
"8229","Nevada County",2019-12-01,131,32,24,8,195
"8230","Nevada County",2020-01-01,123,29,30,5,187
"8231","Nevada County",2020-02-01,136,30,32,10,208
"8232","Nevada County",2020-03-01,131,32,36,6,205
"8233","Orange County",1995-10-01,1822,187,2623,415,5047
"8234","Orange County",1995-11-01,1816,183,2614,387,5000
"8235","Orange County",1995-12-01,1809,169,2524,367,4869
"8236","Orange County",1996-01-01,1815,179,2532,358,4884
"8237","Orange County",1996-02-01,1862,197,2530,364,4953
"8238","Orange County",1996-03-01,1806,169,2558,381,4914
"8239","Orange County",1996-04-01,1829,162,2581,396,4968
"8240","Orange County",1996-05-01,1867,195,2600,413,5075
"8241","Orange County",1996-06-01,1829,187,2651,421,5088
"8242","Orange County",1996-07-01,1790,192,2662,411,5055
"8243","Orange County",1996-08-01,1834,197,2681,417,5129
"8244","Orange County",1996-09-01,1814,202,2736,419,5171
"8245","Orange County",1996-10-01,1778,195,2740,417,5130
"8246","Orange County",1996-11-01,1772,217,2712,417,5118
"8247","Orange County",1996-12-01,1693,212,2619,413,4937
"8248","Orange County",1997-01-01,1836,225,2631,409,5101
"8249","Orange County",1997-02-01,1872,233,2533,405,5043
"8250","Orange County",1997-03-01,1839,227,2590,417,5073
"8251","Orange County",1997-04-01,1876,233,2542,416,5067
"8252","Orange County",1997-05-01,1841,207,2599,422,5069
"8253","Orange County",1997-06-01,1834,229,2634,437,5134
"8254","Orange County",1997-07-01,2142,281,2577,448,5448
"8255","Orange County",1997-08-01,2178,289,1936,1037,5440
"8256","Orange County",1997-09-01,2318,309,2378,412,5417
"8257","Orange County",1997-10-01,2317,301,2471,436,5525
"8258","Orange County",1997-11-01,2360,288,2498,456,5602
"8259","Orange County",1997-12-01,2267,266,2539,462,5534
"8260","Orange County",1998-01-01,2295,263,2631,453,5642
"8261","Orange County",1998-02-01,2282,289,2545,430,5546
"8262","Orange County",1998-03-01,2310,287,2608,471,5676
"8263","Orange County",1998-04-01,2331,286,2586,458,5661
"8264","Orange County",1998-05-01,2370,298,2617,448,5733
"8265","Orange County",1998-06-01,2366,1291,1660,446,5763
"8266","Orange County",1998-07-01,2304,300,2673,445,5722
"8267","Orange County",1998-08-01,2276,286,2620,452,5634
"8268","Orange County",1998-09-01,2323,269,2510,456,5558
"8269","Orange County",1998-10-01,2316,290,2524,459,5589
"8270","Orange County",1998-11-01,2276,262,2541,469,5548
"8271","Orange County",1998-12-01,2212,256,2445,461,5374
"8272","Orange County",1999-01-01,2309,270,2457,443,5479
"8273","Orange County",1999-02-01,2175,246,2430,467,5318
"8274","Orange County",1999-03-01,2184,259,2509,451,5403
"8275","Orange County",1999-04-01,2145,261,2506,418,5330
"8276","Orange County",1999-05-01,2110,263,2469,397,5239
"8277","Orange County",1999-06-01,2098,280,2402,377,5157
"8278","Orange County",1999-07-01,2085,256,2442,395,5178
"8279","Orange County",1999-08-01,2134,285,2511,390,5320
"8280","Orange County",1999-09-01,2190,277,2560,415,5442
"8281","Orange County",1999-10-01,2185,272,2602,407,5466
"8282","Orange County",1999-11-01,2102,260,2486,396,5244
"8283","Orange County",1999-12-01,2061,266,2260,366,4953
"8284","Orange County",2000-01-01,2209,285,2289,380,5163
"8285","Orange County",2000-02-01,2245,274,2280,388,5187
"8286","Orange County",2000-03-01,2223,292,2291,384,5190
"8287","Orange County",2000-04-01,2157,279,2381,401,5218
"8288","Orange County",2000-05-01,2093,271,2392,409,5165
"8289","Orange County",2000-06-01,2137,270,2342,404,5153
"8290","Orange County",2000-07-01,2160,261,2318,401,5140
"8291","Orange County",2000-08-01,2113,255,2392,371,5131
"8292","Orange County",2000-09-01,2122,261,2390,353,5126
"8293","Orange County",2000-10-01,2223,285,2388,377,5273
"8294","Orange County",2000-11-01,2180,268,2373,374,5195
"8295","Orange County",2000-12-01,2173,269,2313,372,5127
"8296","Orange County",2001-01-01,2159,255,2333,394,5141
"8297","Orange County",2001-02-01,2071,291,2192,456,5010
"8298","Orange County",2001-03-01,2066,252,2220,380,4918
"8299","Orange County",2001-04-01,2044,246,2169,337,4796
"8300","Orange County",2001-05-01,2065,249,2112,344,4770
"8301","Orange County",2001-06-01,2081,266,2025,330,4702
"8302","Orange County",2001-07-01,2092,260,2012,335,4699
"8303","Orange County",2001-08-01,2103,256,2042,337,4738
"8304","Orange County",2001-09-01,2183,280,2003,320,4786
"8305","Orange County",2001-10-01,2188,287,2093,315,4883
"8306","Orange County",2001-11-01,2205,265,2052,315,4837
"8307","Orange County",2001-12-01,2211,257,1962,305,4735
"8308","Orange County",2002-01-01,2295,272,1960,297,4824
"8309","Orange County",2002-02-01,2340,270,2043,309,4962
"8310","Orange County",2002-03-01,2293,281,2157,328,5059
"8311","Orange County",2002-04-01,2314,284,2097,308,5003
"8312","Orange County",2002-05-01,2320,272,2135,356,5083
"8313","Orange County",2002-06-01,2338,278,2158,352,5126
"8314","Orange County",2002-07-01,2358,268,2104,357,5087
"8315","Orange County",2002-08-01,2335,279,2157,361,5132
"8316","Orange County",2002-09-01,2397,284,2201,347,5229
"8317","Orange County",2002-10-01,2362,290,2236,351,5239
"8318","Orange County",2002-11-01,2373,281,2143,328,5125
"8319","Orange County",2002-12-01,2412,278,2081,305,5076
"8320","Orange County",2003-01-01,2454,299,2091,322,5166
"8321","Orange County",2003-02-01,2410,302,2204,335,5251
"8322","Orange County",2003-03-01,2452,292,2259,359,5362
"8323","Orange County",2003-04-01,2378,305,2315,375,5373
"8324","Orange County",2003-05-01,2350,319,2290,382,5341
"8325","Orange County",2003-06-01,2402,342,2254,359,5357
"8326","Orange County",2003-07-01,2436,325,2161,356,5278
"8327","Orange County",2003-08-01,2469,301,2257,393,5420
"8328","Orange County",2003-09-01,2511,329,2279,418,5537
"8329","Orange County",2003-10-01,2565,340,2388,432,5725
"8330","Orange County",2003-11-01,2541,339,2493,432,5805
"8331","Orange County",2003-12-01,2498,317,2407,414,5636
"8332","Orange County",2004-01-01,2643,330,2328,419,5720
"8333","Orange County",2004-02-01,2616,327,2351,445,5739
"8334","Orange County",2004-03-01,2618,321,2482,477,5898
"8335","Orange County",2004-04-01,2620,325,2599,493,6037
"8336","Orange County",2004-05-01,2637,328,2622,499,6086
"8337","Orange County",2004-06-01,2693,324,2678,517,6212
"8338","Orange County",2004-07-01,2732,369,2704,476,6281
"8339","Orange County",2004-08-01,2673,373,2714,458,6218
"8340","Orange County",2004-09-01,2689,388,2724,456,6257
"8341","Orange County",2004-10-01,2695,385,2724,491,6295
"8342","Orange County",2004-11-01,2790,367,2572,469,6198
"8343","Orange County",2004-12-01,2707,335,2478,451,5971
"8344","Orange County",2005-01-01,2791,356,2420,462,6029
"8345","Orange County",2005-02-01,2768,361,2538,475,6142
"8346","Orange County",2005-03-01,2758,377,2639,500,6274
"8347","Orange County",2005-04-01,2788,395,2680,490,6353
"8348","Orange County",2005-05-01,2755,385,2841,503,6484
"8349","Orange County",2005-06-01,2750,404,2994,506,6654
"8350","Orange County",2005-07-01,2768,384,3032,534,6718
"8351","Orange County",2005-08-01,2830,385,3178,541,6934
"8352","Orange County",2005-09-01,2909,386,3105,544,6944
"8353","Orange County",2005-10-01,2859,364,3074,537,6834
"8354","Orange County",2005-11-01,2915,364,2983,546,6808
"8355","Orange County",2005-12-01,2905,361,2785,530,6581
"8356","Orange County",2006-01-01,3071,376,2681,522,6650
"8357","Orange County",2006-02-01,3031,381,2649,520,6581
"8358","Orange County",2006-03-01,3004,385,2706,511,6606
"8359","Orange County",2006-04-01,2945,366,2686,492,6489
"8360","Orange County",2006-05-01,2985,390,2747,517,6639
"8361","Orange County",2006-06-01,3003,382,2704,538,6627
"8362","Orange County",2006-07-01,3090,380,2676,511,6657
"8363","Orange County",2006-08-01,3102,387,2645,514,6648
"8364","Orange County",2006-09-01,3217,395,2592,526,6730
"8365","Orange County",2006-10-01,3180,377,2549,533,6639
"8366","Orange County",2006-11-01,3244,387,2442,483,6556
"8367","Orange County",2006-12-01,3313,388,2462,455,6618
"8368","Orange County",2007-01-01,3527,423,2539,480,6969
"8369","Orange County",2007-02-01,3426,433,2623,489,6971
"8370","Orange County",2007-03-01,3424,466,2682,484,7056
"8371","Orange County",2007-04-01,3373,460,2633,455,6921
"8372","Orange County",2007-05-01,3394,461,2681,464,7000
"8373","Orange County",2007-06-01,3352,437,2733,500,7022
"8374","Orange County",2007-07-01,3337,461,2626,480,6904
"8375","Orange County",2007-08-01,3255,488,2549,492,6784
"8376","Orange County",2007-09-01,3242,472,2489,500,6703
"8377","Orange County",2007-10-01,3232,472,2408,471,6583
"8378","Orange County",2007-11-01,3231,459,2368,470,6528
"8379","Orange County",2007-12-01,3077,428,2249,448,6202
"8380","Orange County",2008-01-01,3229,437,2231,441,6338
"8381","Orange County",2008-02-01,3163,424,2329,427,6343
"8382","Orange County",2008-03-01,3181,412,2435,446,6474
"8383","Orange County",2008-04-01,3166,442,2447,435,6490
"8384","Orange County",2008-05-01,3225,454,2384,434,6497
"8385","Orange County",2008-06-01,3251,447,2319,432,6449
"8386","Orange County",2008-07-01,3320,446,2263,459,6488
"8387","Orange County",2008-08-01,3327,447,2287,447,6508
"8388","Orange County",2008-09-01,3328,444,2328,441,6541
"8389","Orange County",2008-10-01,3379,446,2368,447,6640
"8390","Orange County",2008-11-01,3353,427,2323,402,6505
"8391","Orange County",2008-12-01,3240,414,2247,381,6282
"8392","Orange County",2009-01-01,3355,410,2186,428,6379
"8393","Orange County",2009-02-01,3145,384,2280,439,6248
"8394","Orange County",2009-03-01,3069,390,2345,447,6251
"8395","Orange County",2009-04-01,3078,391,2240,415,6124
"8396","Orange County",2009-05-01,3140,401,2317,416,6274
"8397","Orange County",2009-06-01,3141,391,2394,474,6400
"8398","Orange County",2009-07-01,2975,367,2324,453,6119
"8399","Orange County",2009-08-01,2980,351,2223,429,5983
"8400","Orange County",2009-09-01,3086,382,2094,373,5935
"8401","Orange County",2009-10-01,3134,378,1919,357,5788
"8402","Orange County",2009-11-01,3042,374,1821,336,5573
"8403","Orange County",2009-12-01,2964,351,1609,327,5251
"8404","Orange County",2010-01-01,3135,409,1514,309,5367
"8405","Orange County",2010-02-01,2965,374,1517,275,5131
"8406","Orange County",2010-03-01,2991,381,1533,273,5178
"8407","Orange County",2010-04-01,2958,368,1551,276,5153
"8408","Orange County",2010-05-01,2957,380,1585,275,5197
"8409","Orange County",2010-06-01,3037,399,1526,286,5248
"8410","Orange County",2010-07-01,3089,384,1529,290,5292
"8411","Orange County",2010-08-01,3060,408,1758,293,5519
"8412","Orange County",2010-09-01,3107,447,2079,321,5954
"8413","Orange County",2010-10-01,3058,410,2279,365,6112
"8414","Orange County",2010-11-01,2973,391,2388,356,6108
"8415","Orange County",2010-12-01,2961,380,2311,363,6015
"8416","Orange County",2011-01-01,3149,419,2230,415,6213
"8417","Orange County",2011-02-01,3118,406,2186,408,6118
"8418","Orange County",2011-03-01,3088,413,2265,404,6170
"8419","Orange County",2011-04-01,3054,426,2291,426,6197
"8420","Orange County",2011-05-01,3060,421,2288,423,6192
"8421","Orange County",2011-06-01,3090,420,2267,401,6178
"8422","Orange County",2011-07-01,3123,438,2320,413,6294
"8423","Orange County",2011-08-01,3118,428,2401,400,6347
"8424","Orange County",2011-09-01,3157,414,2372,373,6316
"8425","Orange County",2011-10-01,3156,417,2422,354,6349
"8426","Orange County",2011-11-01,3095,369,2478,357,6299
"8427","Orange County",2011-12-01,3005,409,2521,399,6334
"8428","Orange County",2012-01-01,3064,393,2504,409,6370
"8429","Orange County",2012-02-01,3104,405,2699,456,6664
"8430","Orange County",2012-03-01,3058,399,2733,485,6675
"8431","Orange County",2012-04-01,3090,412,2817,499,6818
"8432","Orange County",2012-05-01,3132,419,2860,512,6923
"8433","Orange County",2012-06-01,3209,443,2865,504,7021
"8434","Orange County",2012-07-01,3341,451,2820,471,7083
"8435","Orange County",2012-08-01,3240,446,2864,473,7023
"8436","Orange County",2012-09-01,3227,445,2890,487,7049
"8437","Orange County",2012-10-01,3221,434,2916,509,7080
"8438","Orange County",2012-11-01,3139,450,2896,502,6987
"8439","Orange County",2012-12-01,3118,440,2793,484,6835
"8440","Orange County",2013-01-01,3373,492,2829,505,7199
"8441","Orange County",2013-02-01,3371,504,2748,492,7115
"8442","Orange County",2013-03-01,3331,488,2922,503,7244
"8443","Orange County",2013-04-01,3395,501,2881,507,7284
"8444","Orange County",2013-05-01,3407,516,2867,509,7299
"8445","Orange County",2013-06-01,3413,497,2757,537,7204
"8446","Orange County",2013-07-01,3421,494,2697,537,7149
"8447","Orange County",2013-08-01,3413,489,2759,532,7193
"8448","Orange County",2013-09-01,3494,513,2799,508,7314
"8449","Orange County",2013-10-01,3500,530,2859,513,7402
"8450","Orange County",2013-11-01,3443,522,2838,541,7344
"8451","Orange County",2013-12-01,3490,497,2741,514,7242
"8452","Orange County",2014-01-01,3601,534,2640,513,7288
"8453","Orange County",2014-02-01,3515,529,2833,542,7419
"8454","Orange County",2014-03-01,3469,503,2813,554,7339
"8455","Orange County",2014-04-01,3543,513,2756,540,7352
"8456","Orange County",2014-05-01,3451,512,2787,550,7300
"8457","Orange County",2014-06-01,3474,519,2666,534,7193
"8458","Orange County",2014-07-01,3436,493,2667,552,7148
"8459","Orange County",2014-08-01,3395,493,2556,536,6980
"8460","Orange County",2014-09-01,3370,509,2633,550,7062
"8461","Orange County",2014-10-01,3358,528,2611,555,7052
"8462","Orange County",2014-11-01,3138,489,2450,504,6581
"8463","Orange County",2014-12-01,2776,383,2180,416,5755
"8464","Orange County",2015-01-01,2826,378,1969,386,5559
"8465","Orange County",2015-02-01,2884,374,1981,379,5618
"8466","Orange County",2015-03-01,2895,413,2039,375,5722
"8467","Orange County",2015-04-01,2926,433,2114,379,5852
"8468","Orange County",2015-05-01,2963,418,2158,353,5892
"8469","Orange County",2015-06-01,2980,428,2192,382,5982
"8470","Orange County",2015-07-01,3076,436,2228,365,6105
"8471","Orange County",2015-08-01,3062,431,2234,376,6103
"8472","Orange County",2015-09-01,3110,440,2301,379,6230
"8473","Orange County",2015-10-01,3059,427,2403,401,6290
"8474","Orange County",2015-11-01,2956,401,2445,407,6209
"8475","Orange County",2015-12-01,2901,420,2416,384,6121
"8476","Orange County",2016-01-01,2993,430,2382,369,6174
"8477","Orange County",2016-02-01,3045,436,2466,417,6364
"8478","Orange County",2016-03-01,2979,412,2495,414,6300
"8479","Orange County",2016-04-01,2941,435,2448,419,6243
"8480","Orange County",2016-05-01,2980,443,2553,450,6426
"8481","Orange County",2016-06-01,3056,403,2586,463,6508
"8482","Orange County",2016-07-01,3115,400,2600,446,6561
"8483","Orange County",2016-08-01,3111,401,2562,436,6510
"8484","Orange County",2016-09-01,3107,405,2557,435,6504
"8485","Orange County",2016-10-01,3141,396,2636,430,6603
"8486","Orange County",2016-11-01,3069,392,2597,444,6502
"8487","Orange County",2016-12-01,3004,372,2439,394,6209
"8488","Orange County",2017-01-01,2822,333,2399,394,5948
"8489","Orange County",2017-02-01,2832,330,2437,413,6012
"8490","Orange County",2017-03-01,2763,349,2549,392,6053
"8491","Orange County",2017-04-01,2753,353,2602,426,6134
"8492","Orange County",2017-05-01,2750,333,2645,424,6152
"8493","Orange County",2017-06-01,2781,336,2623,414,6154
"8494","Orange County",2017-07-01,2742,345,2612,398,6097
"8495","Orange County",2017-08-01,2749,344,2701,411,6205
"8496","Orange County",2017-09-01,2762,351,2706,434,6253
"8497","Orange County",2017-10-01,2670,329,2735,447,6181
"8498","Orange County",2017-11-01,2620,317,2648,428,6013
"8499","Orange County",2017-12-01,2600,342,2540,433,5915
"8500","Orange County",2018-01-01,2693,357,2401,444,5895
"8501","Orange County",2018-02-01,2682,342,2515,469,6008
"8502","Orange County",2018-03-01,2603,322,2536,461,5922
"8503","Orange County",2018-04-01,2662,336,2631,492,6121
"8504","Orange County",2018-05-01,2721,337,2708,492,6258
"8505","Orange County",2018-06-01,2734,355,2912,480,6481
"8506","Orange County",2018-07-01,2691,347,2906,428,6372
"8507","Orange County",2018-08-01,2735,362,2770,430,6297
"8508","Orange County",2018-09-01,2807,371,2755,436,6369
"8509","Orange County",2018-10-01,2779,351,2752,450,6332
"8510","Orange County",2018-11-01,2784,335,2556,418,6093
"8511","Orange County",2018-12-01,2726,307,2622,415,6070
"8512","Orange County",2019-01-01,2728,318,2521,379,5946
"8513","Orange County",2019-02-01,2705,323,2531,397,5956
"8514","Orange County",2019-03-01,2717,307,2505,434,5963
"8515","Orange County",2019-04-01,2748,316,2235,391,5690
"8516","Orange County",2019-05-01,2742,305,2129,372,5548
"8517","Orange County",2019-06-01,2740,316,2128,368,5552
"8518","Orange County",2019-07-01,2744,328,1812,365,5249
"8519","Orange County",2019-08-01,2701,323,1788,389,5201
"8520","Orange County",2019-09-01,2730,329,1836,385,5280
"8521","Orange County",2019-10-01,2624,318,1832,378,5152
"8522","Orange County",2019-11-01,2518,295,1818,339,4970
"8523","Orange County",2019-12-01,2519,299,1733,301,4852
"8524","Orange County",2020-01-01,2592,311,1736,321,4960
"8525","Orange County",2020-02-01,2613,308,1826,327,5074
"8526","Orange County",2020-03-01,2588,303,1659,293,4843
"8527","Placer County",1995-10-01,179,29,203,25,436
"8528","Placer County",1995-11-01,151,30,212,26,419
"8529","Placer County",1995-12-01,132,23,200,33,388
"8530","Placer County",1996-01-01,153,16,195,39,403
"8531","Placer County",1996-02-01,154,16,205,39,414
"8532","Placer County",1996-03-01,157,21,193,35,406
"8533","Placer County",1996-04-01,164,18,191,38,411
"8534","Placer County",1996-05-01,160,17,205,34,416
"8535","Placer County",1996-06-01,169,16,194,35,414
"8536","Placer County",1996-07-01,157,16,201,37,411
"8537","Placer County",1996-08-01,153,21,201,38,413
"8538","Placer County",1996-09-01,144,18,213,45,420
"8539","Placer County",1996-10-01,164,18,206,55,443
"8540","Placer County",1996-11-01,181,24,203,35,443
"8541","Placer County",1996-12-01,184,25,174,28,411
"8542","Placer County",1997-01-01,160,14,199,40,413
"8543","Placer County",1997-02-01,215,22,180,31,448
"8544","Placer County",1997-03-01,152,19,193,32,396
"8545","Placer County",1997-04-01,187,34,198,5,424
"8546","Placer County",1997-05-01,315,47,62,5,429
"8547","Placer County",1997-06-01,291,43,96,12,442
"8548","Placer County",1997-07-01,195,19,199,37,450
"8549","Placer County",1997-08-01,189,23,208,35,455
"8550","Placer County",1997-09-01,193,22,209,36,460
"8551","Placer County",1997-10-01,196,22,184,33,435
"8552","Placer County",1997-11-01,212,22,180,34,448
"8553","Placer County",1997-12-01,200,20,182,34,436
"8554","Placer County",1998-01-01,195,24,202,33,454
"8555","Placer County",1998-02-01,209,24,193,32,458
"8556","Placer County",1998-03-01,216,24,196,31,467
"8557","Placer County",1998-04-01,207,23,194,32,456
"8558","Placer County",1998-05-01,210,23,175,36,444
"8559","Placer County",1998-06-01,207,23,174,35,439
"8560","Placer County",1998-07-01,212,23,175,36,446
"8561","Placer County",1998-08-01,201,23,172,35,431
"8562","Placer County",1998-09-01,202,23,172,35,432
"8563","Placer County",1998-10-01,209,23,174,35,441
"8564","Placer County",1998-11-01,210,23,175,36,444
"8565","Placer County",1998-12-01,185,21,161,33,400
"8566","Placer County",1999-01-01,168,20,160,33,381
"8567","Placer County",1999-02-01,163,19,158,33,373
"8568","Placer County",1999-03-01,171,20,154,31,376
"8569","Placer County",1999-04-01,183,21,160,33,397
"8570","Placer County",1999-05-01,179,21,159,33,392
"8571","Placer County",1999-06-01,181,21,161,33,396
"8572","Placer County",1999-07-01,185,21,162,33,401
"8573","Placer County",1999-08-01,201,23,172,35,431
"8574","Placer County",1999-09-01,199,27,151,31,408
"8575","Placer County",1999-10-01,198,123,163,33,517
"8576","Placer County",1999-11-01,192,21,158,33,404
"8577","Placer County",1999-12-01,184,21,144,29,378
"8578","Placer County",2000-01-01,196,21,148,30,395
"8579","Placer County",2000-02-01,210,23,170,35,438
"8580","Placer County",2000-03-01,216,24,175,37,452
"8581","Placer County",2000-04-01,212,24,170,36,442
"8582","Placer County",2000-05-01,213,24,174,36,447
"8583","Placer County",2000-06-01,223,25,172,35,455
"8584","Placer County",2000-07-01,228,25,179,37,469
"8585","Placer County",2000-08-01,223,26,174,35,458
"8586","Placer County",2000-09-01,214,24,173,35,446
"8587","Placer County",2000-10-01,213,24,174,36,447
"8588","Placer County",2000-11-01,209,23,169,36,437
"8589","Placer County",2000-12-01,188,21,150,30,389
"8590","Placer County",2001-01-01,207,22,156,31,416
"8591","Placer County",2001-02-01,202,22,159,32,415
"8592","Placer County",2001-03-01,212,24,170,35,441
"8593","Placer County",2001-04-01,214,24,169,34,441
"8594","Placer County",2001-05-01,212,24,167,35,438
"8595","Placer County",2001-06-01,201,23,172,35,431
"8596","Placer County",2001-07-01,213,24,176,36,449
"8597","Placer County",2001-08-01,236,26,183,37,482
"8598","Placer County",2001-09-01,242,26,185,37,490
"8599","Placer County",2001-10-01,232,25,182,37,476
"8600","Placer County",2001-11-01,220,24,178,36,458
"8601","Placer County",2001-12-01,211,24,171,34,440
"8602","Placer County",2002-01-01,222,25,170,34,451
"8603","Placer County",2002-02-01,233,26,178,37,474
"8604","Placer County",2002-03-01,236,26,183,37,482
"8605","Placer County",2002-04-01,242,26,186,37,491
"8606","Placer County",2002-05-01,237,26,183,37,483
"8607","Placer County",2002-06-01,239,26,183,37,485
"8608","Placer County",2002-07-01,240,26,185,37,488
"8609","Placer County",2002-08-01,238,26,184,37,485
"8610","Placer County",2002-09-01,241,26,185,37,489
"8611","Placer County",2002-10-01,243,26,186,37,492
"8612","Placer County",2002-11-01,241,26,185,37,489
"8613","Placer County",2002-12-01,232,25,182,37,476
"8614","Placer County",2003-01-01,246,27,185,37,495
"8615","Placer County",2003-02-01,243,27,181,37,488
"8616","Placer County",2003-03-01,244,27,181,36,488
"8617","Placer County",2003-04-01,239,26,178,36,479
"8618","Placer County",2003-05-01,245,27,180,36,488
"8619","Placer County",2003-06-01,248,27,183,37,495
"8620","Placer County",2003-07-01,240,26,181,37,484
"8621","Placer County",2003-08-01,238,26,183,37,484
"8622","Placer County",2003-09-01,247,27,185,37,496
"8623","Placer County",2003-10-01,244,26,185,37,492
"8624","Placer County",2003-11-01,243,26,182,37,488
"8625","Placer County",2003-12-01,249,27,179,36,491
"8626","Placer County",2004-01-01,270,39,163,33,505
"8627","Placer County",2004-02-01,267,38,158,32,495
"8628","Placer County",2004-03-01,268,38,157,31,494
"8629","Placer County",2004-04-01,267,38,158,31,494
"8630","Placer County",2004-05-01,270,38,158,31,497
"8631","Placer County",2004-06-01,267,38,161,32,498
"8632","Placer County",2004-07-01,263,37,160,32,492
"8633","Placer County",2004-08-01,270,38,157,31,496
"8634","Placer County",2004-09-01,270,39,169,34,512
"8635","Placer County",2004-10-01,270,38,169,34,511
"8636","Placer County",2004-11-01,267,38,166,33,504
"8637","Placer County",2004-12-01,266,38,158,32,494
"8638","Placer County",2005-01-01,276,39,160,33,508
"8639","Placer County",2005-02-01,278,40,164,34,516
"8640","Placer County",2005-03-01,283,40,167,34,524
"8641","Placer County",2005-04-01,285,40,172,35,532
"8642","Placer County",2005-05-01,285,40,174,35,534
"8643","Placer County",2005-06-01,281,40,172,34,527
"8644","Placer County",2005-07-01,285,40,174,35,534
"8645","Placer County",2005-08-01,290,41,174,34,539
"8646","Placer County",2005-09-01,281,40,173,35,529
"8647","Placer County",2005-10-01,289,41,175,35,540
"8648","Placer County",2005-11-01,293,41,173,35,542
"8649","Placer County",2005-12-01,290,41,174,34,539
"8650","Placer County",2006-01-01,322,46,179,36,583
"8651","Placer County",2006-02-01,317,45,178,36,576
"8652","Placer County",2006-03-01,321,45,178,36,580
"8653","Placer County",2006-04-01,325,46,179,36,586
"8654","Placer County",2006-05-01,327,46,180,36,589
"8655","Placer County",2006-06-01,327,47,179,36,589
"8656","Placer County",2006-07-01,330,47,181,36,594
"8657","Placer County",2006-08-01,333,47,180,36,596
"8658","Placer County",2006-09-01,333,47,183,35,598
"8659","Placer County",2006-10-01,337,48,181,36,602
"8660","Placer County",2006-11-01,329,46,179,36,590
"8661","Placer County",2006-12-01,324,45,177,35,581
"8662","Placer County",2007-01-01,339,48,182,36,605
"8663","Placer County",2007-02-01,339,48,181,36,604
"8664","Placer County",2007-03-01,341,48,183,37,609
"8665","Placer County",2007-04-01,334,47,181,36,598
"8666","Placer County",2007-05-01,330,47,181,36,594
"8667","Placer County",2007-06-01,333,47,182,36,598
"8668","Placer County",2007-07-01,328,46,180,36,590
"8669","Placer County",2007-08-01,331,47,180,36,594
"8670","Placer County",2007-09-01,329,47,180,36,592
"8671","Placer County",2007-10-01,323,45,179,36,583
"8672","Placer County",2007-11-01,327,46,178,35,586
"8673","Placer County",2007-12-01,318,45,177,36,576
"8674","Placer County",2008-01-01,317,45,176,36,574
"8675","Placer County",2008-02-01,319,45,177,35,576
"8676","Placer County",2008-03-01,320,45,178,36,579
"8677","Placer County",2008-04-01,318,45,177,35,575
"8678","Placer County",2008-05-01,328,46,181,36,591
"8679","Placer County",2008-06-01,323,46,179,36,584
"8680","Placer County",2008-07-01,324,45,179,36,584
"8681","Placer County",2008-08-01,334,47,180,36,597
"8682","Placer County",2008-09-01,337,47,178,36,598
"8683","Placer County",2008-10-01,324,46,163,32,565
"8684","Placer County",2008-11-01,304,43,164,32,543
"8685","Placer County",2008-12-01,305,43,161,32,541
"8686","Placer County",2009-01-01,303,43,160,31,537
"8687","Placer County",2009-02-01,276,38,138,28,480
"8688","Placer County",2009-03-01,304,43,154,31,532
"8689","Placer County",2009-04-01,299,42,164,34,539
"8690","Placer County",2009-05-01,309,45,173,34,561
"8691","Placer County",2009-06-01,308,44,175,35,562
"8692","Placer County",2009-07-01,302,43,165,33,543
"8693","Placer County",2009-08-01,304,43,163,33,543
"8694","Placer County",2009-09-01,308,44,173,34,559
"8695","Placer County",2009-10-01,309,44,172,33,558
"8696","Placer County",2009-11-01,310,44,171,35,560
"8697","Placer County",2009-12-01,302,43,158,32,535
"8698","Placer County",2010-01-01,311,44,169,34,558
"8699","Placer County",2010-02-01,309,44,170,35,558
"8700","Placer County",2010-03-01,313,44,170,34,561
"8701","Placer County",2010-04-01,314,44,163,32,553
"8702","Placer County",2010-05-01,308,44,168,33,553
"8703","Placer County",2010-06-01,302,43,160,31,536
"8704","Placer County",2010-07-01,305,43,151,29,528
"8705","Placer County",2010-08-01,322,46,158,31,557
"8706","Placer County",2010-09-01,326,46,158,31,561
"8707","Placer County",2010-10-01,311,44,151,28,534
"8708","Placer County",2010-11-01,306,43,141,28,518
"8709","Placer County",2010-12-01,281,39,139,28,487
"8710","Placer County",2011-01-01,276,39,160,32,507
"8711","Placer County",2011-02-01,291,41,156,31,519
"8712","Placer County",2011-03-01,282,39,143,29,493
"8713","Placer County",2011-04-01,293,42,153,31,519
"8714","Placer County",2011-05-01,295,42,160,32,529
"8715","Placer County",2011-06-01,300,43,160,32,535
"8716","Placer County",2011-07-01,302,43,154,31,530
"8717","Placer County",2011-08-01,301,43,159,31,534
"8718","Placer County",2011-09-01,311,44,159,31,545
"8719","Placer County",2011-10-01,302,43,157,32,534
"8720","Placer County",2011-11-01,302,43,156,32,533
"8721","Placer County",2011-12-01,306,43,163,32,544
"8722","Placer County",2012-01-01,316,44,161,32,553
"8723","Placer County",2012-02-01,321,45,160,32,558
"8724","Placer County",2012-03-01,337,48,170,34,589
"8725","Placer County",2012-04-01,348,49,178,36,611
"8726","Placer County",2012-05-01,346,49,167,33,595
"8727","Placer County",2012-06-01,349,49,174,34,606
"8728","Placer County",2012-07-01,355,50,174,34,613
"8729","Placer County",2012-08-01,353,50,178,36,617
"8730","Placer County",2012-09-01,340,48,173,34,595
"8731","Placer County",2012-10-01,335,47,176,36,594
"8732","Placer County",2012-11-01,342,48,175,35,600
"8733","Placer County",2012-12-01,345,48,177,36,606
"8734","Placer County",2013-01-01,348,50,181,36,615
"8735","Placer County",2013-02-01,358,51,181,36,626
"8736","Placer County",2013-03-01,364,51,187,37,639
"8737","Placer County",2013-04-01,359,50,186,37,632
"8738","Placer County",2013-05-01,348,49,184,37,618
"8739","Placer County",2013-06-01,349,49,184,37,619
"8740","Placer County",2013-07-01,348,49,183,37,617
"8741","Placer County",2013-08-01,360,51,184,37,632
"8742","Placer County",2013-09-01,367,51,186,38,642
"8743","Placer County",2013-10-01,368,51,187,37,643
"8744","Placer County",2013-11-01,366,51,188,37,642
"8745","Placer County",2013-12-01,365,51,188,37,641
"8746","Placer County",2014-01-01,373,52,189,38,652
"8747","Placer County",2014-02-01,379,53,190,38,660
"8748","Placer County",2014-03-01,375,52,189,38,654
"8749","Placer County",2014-04-01,372,52,188,38,650
"8750","Placer County",2014-05-01,370,52,186,37,645
"8751","Placer County",2014-06-01,417,57,157,30,661
"8752","Placer County",2014-07-01,434,60,168,33,695
"8753","Placer County",2014-08-01,440,61,171,33,705
"8754","Placer County",2014-09-01,434,60,170,33,697
"8755","Placer County",2014-10-01,403,57,162,31,653
"8756","Placer County",2014-11-01,394,54,158,30,636
"8757","Placer County",2014-12-01,383,53,147,28,611
"8758","Placer County",2015-01-01,383,54,153,30,620
"8759","Placer County",2015-02-01,382,54,151,31,618
"8760","Placer County",2015-03-01,380,53,142,27,602
"8761","Placer County",2015-04-01,382,53,152,30,617
"8762","Placer County",2015-05-01,385,42,170,36,633
"8763","Placer County",2015-06-01,372,42,160,36,610
"8764","Placer County",2015-07-01,371,42,160,40,613
"8765","Placer County",2015-08-01,373,44,157,43,617
"8766","Placer County",2015-09-01,411,55,168,13,647
"8767","Placer County",2015-10-01,397,46,168,50,661
"8768","Placer County",2015-11-01,391,45,173,54,663
"8769","Placer County",2015-12-01,387,44,156,52,639
"8770","Placer County",2016-01-01,398,46,161,53,658
"8771","Placer County",2016-02-01,409,46,169,51,675
"8772","Placer County",2016-03-01,410,46,179,46,681
"8773","Placer County",2016-04-01,403,45,184,54,686
"8774","Placer County",2016-05-01,412,46,184,54,696
"8775","Placer County",2016-06-01,419,49,182,54,704
"8776","Placer County",2016-07-01,417,49,181,55,702
"8777","Placer County",2016-08-01,415,49,177,54,695
"8778","Placer County",2016-09-01,427,51,182,47,707
"8779","Placer County",2016-10-01,431,49,182,52,714
"8780","Placer County",2016-11-01,430,50,182,55,717
"8781","Placer County",2016-12-01,422,49,181,46,698
"8782","Placer County",2017-01-01,400,45,178,45,668
"8783","Placer County",2017-02-01,447,38,184,47,716
"8784","Placer County",2017-03-01,459,40,189,54,742
"8785","Placer County",2017-04-01,447,38,186,56,727
"8786","Placer County",2017-05-01,438,38,185,57,718
"8787","Placer County",2017-06-01,429,36,184,56,705
"8788","Placer County",2017-07-01,441,39,184,56,720
"8789","Placer County",2017-08-01,445,40,185,56,726
"8790","Placer County",2017-09-01,444,39,182,57,722
"8791","Placer County",2017-10-01,458,39,187,54,738
"8792","Placer County",2017-11-01,461,38,188,53,740
"8793","Placer County",2017-12-01,467,38,190,57,752
"8794","Placer County",2018-01-01,465,38,192,51,746
"8795","Placer County",2018-02-01,454,39,189,54,736
"8796","Placer County",2018-03-01,469,39,190,57,755
"8797","Placer County",2018-04-01,464,38,188,53,743
"8798","Placer County",2018-05-01,464,37,189,48,738
"8799","Placer County",2018-06-01,457,39,187,55,738
"8800","Placer County",2018-07-01,476,40,191,61,768
"8801","Placer County",2018-08-01,454,37,184,60,735
"8802","Placer County",2018-09-01,455,37,185,52,729
"8803","Placer County",2018-10-01,435,37,178,51,701
"8804","Placer County",2018-11-01,427,39,175,49,690
"8805","Placer County",2018-12-01,417,37,169,41,664
"8806","Placer County",2019-01-01,429,38,173,45,685
"8807","Placer County",2019-02-01,433,40,178,48,699
"8808","Placer County",2019-03-01,431,40,182,50,703
"8809","Placer County",2019-04-01,434,39,182,51,706
"8810","Placer County",2019-05-01,427,40,182,54,703
"8811","Placer County",2019-06-01,434,40,179,55,708
"8812","Placer County",2019-07-01,424,41,178,47,690
"8813","Placer County",2019-08-01,438,40,186,43,707
"8814","Placer County",2019-09-01,439,41,186,45,711
"8815","Placer County",2019-10-01,431,43,178,48,700
"8816","Placer County",2019-11-01,417,40,168,49,674
"8817","Placer County",2019-12-01,409,40,156,51,656
"8818","Placer County",2020-01-01,415,42,161,52,670
"8819","Placer County",2020-02-01,419,43,171,54,687
"8820","Placer County",2020-03-01,408,38,172,46,664
"8821","Plumas County",1995-10-01,17.8,2.5,16.1,2.7,39.1
"8822","Plumas County",1995-11-01,13.3,1.6,15.9,1.7,32.5
"8823","Plumas County",1995-12-01,15.3,4,15.7,2.7,37.7
"8824","Plumas County",1996-01-01,16.4,4.7,23.1,2.6,46.8
"8825","Plumas County",1996-02-01,17.31,2.96,26.96,5.55,52.78
"8826","Plumas County",1996-03-01,15.29,1.41,29.78,5.32,51.8
"8827","Plumas County",1996-04-01,12.3,2.56,28.1,2.93,45.89
"8828","Plumas County",1996-05-01,15.9,1.64,20.68,3.09,41.31
"8829","Plumas County",1996-06-01,19.3,1.8,17.37,1.96,40.43
"8830","Plumas County",1996-07-01,18.97,1.97,22.9,2.13,45.97
"8831","Plumas County",1996-08-01,17.16,7.55,20.67,2.97,48.35
"8832","Plumas County",1996-09-01,16.43,4.23,21.57,2.03,44.26
"8833","Plumas County",1996-10-01,15.19,2.42,15.61,3.9,37.12
"8834","Plumas County",1996-11-01,18.43,1.8,15.53,2.6,38.36
"8835","Plumas County",1996-12-01,12.39,2.29,15.16,1,30.84
"8836","Plumas County",1997-01-01,12.96,1.16,15.93,2.58,32.63
"8837","Plumas County",1997-02-01,18.75,1.46,18.78,3.89,42.88
"8838","Plumas County",1997-03-01,13.67,2.48,23.48,3.67,43.3
"8839","Plumas County",1997-04-01,13.43,2.9,23.57,2.6,42.5
"8840","Plumas County",1997-05-01,14.67,2.23,22.77,3,42.67
"8841","Plumas County",1997-06-01,11.83,2.23,23.1,0.77,37.93
"8842","Plumas County",1997-07-01,16.71,4.26,21.58,1.45,44
"8843","Plumas County",1997-08-01,19.68,4.35,22.22,4,50.25
"8844","Plumas County",1997-09-01,15.56,4.53,18.56,2.73,41.38
"8845","Plumas County",1997-10-01,16.71,4.26,21.58,1.45,44
"8846","Plumas County",1997-11-01,15.19,3.48,17.41,2.45,38.53
"8847","Plumas County",1997-12-01,25.16,1.94,15.16,2.16,44.42
"8848","Plumas County",1998-01-01,20.81,1.29,21.48,1.94,45.52
"8849","Plumas County",1998-02-01,20.04,1.32,24.5,3.04,48.9
"8850","Plumas County",1998-03-01,20.05,4.05,22.05,3.85,50
"8851","Plumas County",1998-04-01,20.77,6.2,25.43,4.9,57.3
"8852","Plumas County",1998-05-01,23.81,3.26,23.96,5.16,56.19
"8853","Plumas County",1998-06-01,24.4,3.5,21.77,5.26,54.93
"8854","Plumas County",1998-07-01,20,3.4,30.7,6.8,60.9
"8855","Plumas County",1998-08-01,20.65,5,27.16,5.61,58.42
"8856","Plumas County",1998-09-01,20,3.4,30.7,6.8,60.9
"8857","Plumas County",1998-10-01,21,3.16,31.13,4.42,59.71
"8858","Plumas County",1998-11-01,20.44,2.93,28.43,5.33,57.13
"8859","Plumas County",1998-12-01,14.9,1.26,30.32,2.58,49.06
"8860","Plumas County",1999-01-01,19.23,3.61,29,2.39,54.23
"8861","Plumas County",1999-02-01,21.46,3,26.43,2.25,53.14
"8862","Plumas County",1999-03-01,30.06,1.77,25.66,2.48,59.97
"8863","Plumas County",1999-04-01,24.64,1.63,22.73,3.5,52.5
"8864","Plumas County",1999-05-01,28.39,2.1,20.94,2.61,54.04
"8865","Plumas County",1999-06-01,23.3,1.43,24.5,3.3,52.53
"8866","Plumas County",1999-07-01,22.03,3.81,23.42,3.22,52.48
"8867","Plumas County",1999-08-01,19.26,3.61,21.26,4.52,48.65
"8868","Plumas County",1999-09-01,24.93,2.37,20.63,4.44,52.37
"8869","Plumas County",1999-10-01,24.1,3.58,16.68,3.54,47.9
"8870","Plumas County",1999-11-01,27.17,3.9,13.66,3.06,47.79
"8871","Plumas County",1999-12-01,20.97,3.65,13.87,2.51,41
"8872","Plumas County",2000-01-01,23.78,2.61,13.32,2.81,42.52
"8873","Plumas County",2000-02-01,23.72,3.17,16.69,2.35,45.93
"8874","Plumas County",2000-03-01,23.29,2.61,15.55,3.65,45.1
"8875","Plumas County",2000-04-01,16.8,2.23,13.74,4.2,36.97
"8876","Plumas County",2000-05-01,18.62,3.03,13.84,3.03,38.52
"8877","Plumas County",2000-06-01,19.2,3.27,12.86,2.7,38.03
"8878","Plumas County",2000-07-01,23.48,3.42,13.01,4.61,44.52
"8879","Plumas County",2000-08-01,26.19,5.94,15.45,5.75,53.33
"8880","Plumas County",2000-09-01,25.27,9.93,14.53,4.8,54.53
"8881","Plumas County",2000-10-01,25,7,17.68,6.26,55.94
"8882","Plumas County",2000-11-01,17.1,6.1,18.1,6.7,48
"8883","Plumas County",2000-12-01,19,5.39,17.8,6.1,48.29
"8884","Plumas County",2001-01-01,18,5,20,6,49
"8885","Plumas County",2001-02-01,14,6,16,3,39
"8886","Plumas County",2001-03-01,15,5,16,4,40
"8887","Plumas County",2001-04-01,20,5,16,5,46
"8888","Plumas County",2001-05-01,20,4,18,2,44
"8889","Plumas County",2001-06-01,26,6,18,2,53
"8890","Plumas County",2001-07-01,27,8,19,2,56
"8891","Plumas County",2001-08-01,24,6,19,2,51
"8892","Plumas County",2001-09-01,20,5,20,4,49
"8893","Plumas County",2001-10-01,27,4,20,4,55
"8894","Plumas County",2001-11-01,28,3,20,3,54
"8895","Plumas County",2001-12-01,19,2,14,2,37
"8896","Plumas County",2002-01-01,15,5,15,3,38
"8897","Plumas County",2002-02-01,16,5,14,2,37
"8898","Plumas County",2002-03-01,17,3,18,2,40
"8899","Plumas County",2002-04-01,19,5,13,2,39
"8900","Plumas County",2002-05-01,24,4,19,2,49
"8901","Plumas County",2002-06-01,25,4,18,3,50
"8902","Plumas County",2002-07-01,30,6,11,5,52
"8903","Plumas County",2002-08-01,24,5,14,5,48
"8904","Plumas County",2002-09-01,26,4,16,4,50
"8905","Plumas County",2002-10-01,22,2,16,3,43
"8906","Plumas County",2002-11-01,24,4,16,2,46
"8907","Plumas County",2002-12-01,24,5,18,2,49
"8908","Plumas County",2003-01-01,22,3,24,4,53
"8909","Plumas County",2003-02-01,25,4,18,4,51
"8910","Plumas County",2003-03-01,33,5,15,4,57
"8911","Plumas County",2003-04-01,23,7,21,4,55
"8912","Plumas County",2003-05-01,24,4,23,4,55
"8913","Plumas County",2003-06-01,22,5,20,4,51
"8914","Plumas County",2003-07-01,32,3,19,3,57
"8915","Plumas County",2003-08-01,27,3,18,2,50
"8916","Plumas County",2003-09-01,29,5,17,3,54
"8917","Plumas County",2003-10-01,26,4,15,3,48
"8918","Plumas County",2003-11-01,19,4,17,2,42
"8919","Plumas County",2003-12-01,21,4,19,1,45
"8920","Plumas County",2004-01-01,25,3,24,3,55
"8921","Plumas County",2004-02-01,26,3,24,5,58
"8922","Plumas County",2004-03-01,21,4,25,8,58
"8923","Plumas County",2004-04-01,21,3,25,8,57
"8924","Plumas County",2004-05-01,25,5,27,4,61
"8925","Plumas County",2004-06-01,23,6,30,3,62
"8926","Plumas County",2004-07-01,26,4,29,5,64
"8927","Plumas County",2004-08-01,27,4,28,5,64
"8928","Plumas County",2004-09-01,19,3,27,6,55
"8929","Plumas County",2004-10-01,18,4,19,5,46
"8930","Plumas County",2004-11-01,18,6,19,4,47
"8931","Plumas County",2004-12-01,21,4,17,7,49
"8932","Plumas County",2005-01-01,16,5,21,9,51
"8933","Plumas County",2005-02-01,20,5,21,9,55
"8934","Plumas County",2005-03-01,18,5,22,10,55
"8935","Plumas County",2005-04-01,15,5,22,11,53
"8936","Plumas County",2005-05-01,14,2,18,11,45
"8937","Plumas County",2005-06-01,22,4,18,10,54
"8938","Plumas County",2005-07-01,30,6,14,7,57
"8939","Plumas County",2005-08-01,23,7,19,4,53
"8940","Plumas County",2005-09-01,20,4,19,6,49
"8941","Plumas County",2005-10-01,20,3,24,7,54
"8942","Plumas County",2005-11-01,24,4,23,5,56
"8943","Plumas County",2005-12-01,27,6,17,4,54
"8944","Plumas County",2006-01-01,22,5,24,6,57
"8945","Plumas County",2006-02-01,29,7,22,7,65
"8946","Plumas County",2006-03-01,26,5,23,7,61
"8947","Plumas County",2006-04-01,21,5,23,8,57
"8948","Plumas County",2006-05-01,23,6,23,8,60
"8949","Plumas County",2006-06-01,20,3,24,8,55
"8950","Plumas County",2006-07-01,23,3,17,6,49
"8951","Plumas County",2006-08-01,23,3,21,4,51
"8952","Plumas County",2006-09-01,24,2,28,8,62
"8953","Plumas County",2006-10-01,18,4,26,6,54
"8954","Plumas County",2006-11-01,11,3,31,7,52
"8955","Plumas County",2006-12-01,14,4,23,5,46
"8956","Plumas County",2007-01-01,16,2,29,5,52
"8957","Plumas County",2007-02-01,17,3,25,5,50
"8958","Plumas County",2007-03-01,19,4,17,6,46
"8959","Plumas County",2007-04-01,19,10,20,4,53
"8960","Plumas County",2007-05-01,29,8,18,3,58
"8961","Plumas County",2007-06-01,16,4,21,6,47
"8962","Plumas County",2007-07-01,16,6,22,4,48
"8963","Plumas County",2007-08-01,14,6,25,8,53
"8964","Plumas County",2007-09-01,16,5,26,9,56
"8965","Plumas County",2007-10-01,21,6,21,9,57
"8966","Plumas County",2007-11-01,21,6,22,6,55
"8967","Plumas County",2007-12-01,17,4,22,5,48
"8968","Plumas County",2008-01-01,12,4,21,3,40
"8969","Plumas County",2008-02-01,11,3,21,3,38
"8970","Plumas County",2008-03-01,13,2,15,3,33
"8971","Plumas County",2008-04-01,12,2,17,2,33
"8972","Plumas County",2008-05-01,12,2,16,5,35
"8973","Plumas County",2008-06-01,26,1,8,4,39
"8974","Plumas County",2008-07-01,23,1,9,4,37
"8975","Plumas County",2008-08-01,18,1,19,3,41
"8976","Plumas County",2008-09-01,21,1,19,3,44
"8977","Plumas County",2008-10-01,18,4,21,1,44
"8978","Plumas County",2008-11-01,15,4,22,2,43
"8979","Plumas County",2008-12-01,14,2,19,1,36
"8980","Plumas County",2009-01-01,21,2,24,5,52
"8981","Plumas County",2009-02-01,15,3,34,6,58
"8982","Plumas County",2009-03-01,25,4,21,7,57
"8983","Plumas County",2009-04-01,21,5,24,7,57
"8984","Plumas County",2009-05-01,12,5,24,9,50
"8985","Plumas County",2009-06-01,14,5,15,9,43
"8986","Plumas County",2009-07-01,21,5,11,5,42
"8987","Plumas County",2009-08-01,21,5,13,2,41
"8988","Plumas County",2009-09-01,24,5,12,3,44
"8989","Plumas County",2009-10-01,22,4,13,2,41
"8990","Plumas County",2009-11-01,18,5,16,4,43
"8991","Plumas County",2009-12-01,17,4,18,4,43
"8992","Plumas County",2010-01-01,20,4,25,1,50
"8993","Plumas County",2010-02-01,20,4,21,2,47
"8994","Plumas County",2010-03-01,22,5,13,2,42
"8995","Plumas County",2010-04-01,17,4,21,6,48
"8996","Plumas County",2010-05-01,18,4,19,3,44
"8997","Plumas County",2010-06-01,22,5,15,1,43
"8998","Plumas County",2010-07-01,16,5,17,3,41
"8999","Plumas County",2010-08-01,19,7,11,4,41
"9000","Plumas County",2010-09-01,15,4,15,5,39
"9001","Plumas County",2010-10-01,21,4,13,4,42
"9002","Plumas County",2010-11-01,19,4,20,5,48
"9003","Plumas County",2010-12-01,21,4,13,4,42
"9004","Plumas County",2011-01-01,20,4,20,5,49
"9005","Plumas County",2011-02-01,17,3,20,4,44
"9006","Plumas County",2011-03-01,12,3,18,3,36
"9007","Plumas County",2011-04-01,12,3,14,3,32
"9008","Plumas County",2011-05-01,15,3,10,5,33
"9009","Plumas County",2011-06-01,10,4,15,8,37
"9010","Plumas County",2011-07-01,15,6,13,8,42
"9011","Plumas County",2011-08-01,14,5,10,5,34
"9012","Plumas County",2011-09-01,12,5,8,6,31
"9013","Plumas County",2011-10-01,15,7,9,3,34
"9014","Plumas County",2011-11-01,15,3,10,5,33
"9015","Plumas County",2011-12-01,13,7,18,4,42
"9016","Plumas County",2012-01-01,12,6,13,4,35
"9017","Plumas County",2012-02-01,11,7,16,5,39
"9018","Plumas County",2012-03-01,13,8,11,7,39
"9019","Plumas County",2012-04-01,18,6,10,7,41
"9020","Plumas County",2012-05-01,18,6,10,7,41
"9021","Plumas County",2012-06-01,17,8,15,5,45
"9022","Plumas County",2012-07-01,21,7,15,4,47
"9023","Plumas County",2012-08-01,21,8,11,2,42
"9024","Plumas County",2012-09-01,18,8,13,4,43
"9025","Plumas County",2012-10-01,17,7,9,5,38
"9026","Plumas County",2012-11-01,21,7,12,5,45
"9027","Plumas County",2012-12-01,28,7,7,3,45
"9028","Plumas County",2013-01-01,16,6,11,2,35
"9029","Plumas County",2013-02-01,19,7,13,5,44
"9030","Plumas County",2013-03-01,20,2,16,2,40
"9031","Plumas County",2013-04-01,15,2,18,3,38
"9032","Plumas County",2013-05-01,11,4,26,2,43
"9033","Plumas County",2013-06-01,12,3,25,3,43
"9034","Plumas County",2013-07-01,18,3,20,6,47
"9035","Plumas County",2013-08-01,18,3,19,6,46
"9036","Plumas County",2013-09-01,19,3,21,7,50
"9037","Plumas County",2013-10-01,14,4,23,5,46
"9038","Plumas County",2013-11-01,13,6,29,3,51
"9039","Plumas County",2013-12-01,15,4,24,1,44
"9040","Plumas County",2014-01-01,26,3,21,6,56
"9041","Plumas County",2014-02-01,34,3,18,6,61
"9042","Plumas County",2014-03-01,33,4,18,4,59
"9043","Plumas County",2014-04-01,32,5,14,4,55
"9044","Plumas County",2014-05-01,27,6,13,2,48
"9045","Plumas County",2014-06-01,24,8,10,3,45
"9046","Plumas County",2014-07-01,26,7,11,3,47
"9047","Plumas County",2014-08-01,33,8,10,4,55
"9048","Plumas County",2014-09-01,31,7,8,5,51
"9049","Plumas County",2014-10-01,30,6,7,4,47
"9050","Plumas County",2014-11-01,25,6,10,4,45
"9051","Plumas County",2014-12-01,29,2,8,2,41
"9052","Plumas County",2015-01-01,28,4,11,2,45
"9053","Plumas County",2015-02-01,27,5,14,4,50
"9054","Plumas County",2015-03-01,28,6,15,3,52
"9055","Plumas County",2015-04-01,26,5,13,3,47
"9056","Plumas County",2015-05-01,26,7,20,2,55
"9057","Plumas County",2015-06-01,30,3,17,2,52
"9058","Plumas County",2015-07-01,26,4,17,3,50
"9059","Plumas County",2015-08-01,20,7,16,3,46
"9060","Plumas County",2015-09-01,23,7,11,3,44
"9061","Plumas County",2015-10-01,25,8,12,2,47
"9062","Plumas County",2015-11-01,30,11,10,6,57
"9063","Plumas County",2015-12-01,33,8,13,4,59
"9064","Plumas County",2016-01-01,36,8,11,1,57
"9065","Plumas County",2016-02-01,34,6,10,0,50
"9066","Plumas County",2016-03-01,38,6,12,1,57
"9067","Plumas County",2016-04-01,40,7,11,2,61
"9068","Plumas County",2016-05-01,37,9,8,3,57
"9069","Plumas County",2016-06-01,34,8,7,2,52
"9070","Plumas County",2016-07-01,35,8,6,0,49
"9071","Plumas County",2016-08-01,34,7,8,1,51
"9072","Plumas County",2016-09-01,32,8,10,3,53
"9073","Plumas County",2016-10-01,25,7,7,4,43
"9074","Plumas County",2016-11-01,26,6,6,2,41
"9075","Plumas County",2016-12-01,30,8,6,1,44
"9076","Plumas County",2017-01-01,32,11,4,1,48
"9077","Plumas County",2017-02-01,34,8,4,2,48
"9078","Plumas County",2017-03-01,33,10,6,2,51
"9079","Plumas County",2017-04-01,22,6,22,4,54
"9080","Plumas County",2017-05-01,25,8,16,3,52
"9081","Plumas County",2017-06-01,28,9,13,2,52
"9082","Plumas County",2017-07-01,30,8,8,2,48
"9083","Plumas County",2017-08-01,36,8,9,2,55
"9084","Plumas County",2017-09-01,40,8,8,3,59
"9085","Plumas County",2017-10-01,33,5,7,2,47
"9086","Plumas County",2017-11-01,33,7,5,2,47
"9087","Plumas County",2017-12-01,26,8,5,1,40
"9088","Plumas County",2018-01-01,22,8,8,3,41
"9089","Plumas County",2018-02-01,22,10,6,2,40
"9090","Plumas County",2018-03-01,23,13,6,2,44
"9091","Plumas County",2018-04-01,27,9,8,1,45
"9092","Plumas County",2018-05-01,27,7,11,2,46
"9093","Plumas County",2018-06-01,22,6,10,1,39
"9094","Plumas County",2018-07-01,26,6,10,1,44
"9095","Plumas County",2018-08-01,30,7,12,2,51
"9096","Plumas County",2018-09-01,33,8,12,5,58
"9097","Plumas County",2018-10-01,28,11,11,5,55
"9098","Plumas County",2018-11-01,27,11,10,5,53
"9099","Plumas County",2018-12-01,25,8,11,4,48
"9100","Plumas County",2019-01-01,29,7,11,4,51
"9101","Plumas County",2019-02-01,23,6,26,4,59
"9102","Plumas County",2019-03-01,28,9,24,2,63
"9103","Plumas County",2019-04-01,27,10,20,1,58
"9104","Plumas County",2019-05-01,28,8,16,2,54
"9105","Plumas County",2019-06-01,34,9,15,1,59
"9106","Plumas County",2019-07-01,31,11,15,3,60
"9107","Plumas County",2019-08-01,32,9,18,2,61
"9108","Plumas County",2019-09-01,24,9,18,2,53
"9109","Plumas County",2019-10-01,22,9,19,1,51
"9110","Plumas County",2019-11-01,22,11,19,2,54
"9111","Plumas County",2019-12-01,29,11,17,3,60
"9112","Plumas County",2020-01-01,21,6,20,6,53
"9113","Plumas County",2020-02-01,18,5,23,6,52
"9114","Plumas County",2020-03-01,15,3,22,4,44
"9115","Riverside County",1995-10-01,1498,162,742,100,2502
"9116","Riverside County",1995-11-01,1538,177,747,105,2567
"9117","Riverside County",1995-12-01,1487,164,714,102,2467
"9118","Riverside County",1996-01-01,1462,175,722,99,2458
"9119","Riverside County",1996-02-01,1543,183,754,98,2578
"9120","Riverside County",1996-03-01,1500,186,782,110,2578
"9121","Riverside County",1996-04-01,1489,204,757,114,2564
"9122","Riverside County",1996-05-01,1527,172,732,114,2545
"9123","Riverside County",1996-06-01,1546,186,745,108,2585
"9124","Riverside County",1996-07-01,1539,176,777,109,2601
"9125","Riverside County",1996-08-01,1580,177,763,114,2634
"9126","Riverside County",1996-09-01,1630,186,754,98,2668
"9127","Riverside County",1996-10-01,1580,177,763,114,2634
"9128","Riverside County",1996-11-01,1599,180,724,86,2589
"9129","Riverside County",1996-12-01,1571,203,673,74,2521
"9130","Riverside County",1997-01-01,1578,189,697,88,2552
"9131","Riverside County",1997-02-01,1635,204,723,99,2661
"9132","Riverside County",1997-03-01,1661,187,689,118,2655
"9133","Riverside County",1997-04-01,1645,193,736,121,2695
"9134","Riverside County",1997-05-01,1629,185,737,117,2668
"9135","Riverside County",1997-06-01,1597,188,737,116,2638
"9136","Riverside County",1997-07-01,1614,182,774,116,2686
"9137","Riverside County",1997-08-01,1598,190,768,124,2680
"9138","Riverside County",1997-09-01,1684,199,732,122,2737
"9139","Riverside County",1997-10-01,1651,193,745,112,2701
"9140","Riverside County",1997-11-01,1628,204,727,108,2667
"9141","Riverside County",1997-12-01,1624,201,689,108,2622
"9142","Riverside County",1998-01-01,1689,196,710,113,2708
"9143","Riverside County",1998-02-01,1773,217,737,123,2850
"9144","Riverside County",1998-03-01,1752,216,762,130,2860
"9145","Riverside County",1998-04-01,1717,222,741,117,2797
"9146","Riverside County",1998-05-01,1717,222,741,117,2797
"9147","Riverside County",1998-06-01,1680,188,657,86,2611
"9148","Riverside County",1998-07-01,1716,201,640,96,2653
"9149","Riverside County",1998-08-01,1737,186,673,99,2695
"9150","Riverside County",1998-09-01,1747,202,637,103,2689
"9151","Riverside County",1998-10-01,1685,205,664,97,2651
"9152","Riverside County",1998-11-01,1671,204,656,112,2643
"9153","Riverside County",1998-12-01,1671,204,656,112,2643
"9154","Riverside County",1999-01-01,1624,194,635,102,2555
"9155","Riverside County",1999-02-01,1699,212,661,98,2670
"9156","Riverside County",1999-03-01,1679,206,692,104,2681
"9157","Riverside County",1999-04-01,1701,191,683,104,2679
"9158","Riverside County",1999-05-01,1760,198,637,107,2702
"9159","Riverside County",1999-06-01,1754,201,645,113,2713
"9160","Riverside County",1999-07-01,1751,207,661,123,2742
"9161","Riverside County",1999-08-01,1728,217,670,118,2733
"9162","Riverside County",1999-09-01,1769,219,678,111,2777
"9163","Riverside County",1999-10-01,1739,213,656,105,2713
"9164","Riverside County",1999-11-01,1686,215,660,116,2677
"9165","Riverside County",1999-12-01,1598,224,633,112,2567
"9166","Riverside County",2000-01-01,1579,191,632,98,2500
"9167","Riverside County",2000-02-01,1657,199,650,105,2611
"9168","Riverside County",2000-03-01,1677,208,659,107,2651
"9169","Riverside County",2000-04-01,1660,207,659,114,2640
"9170","Riverside County",2000-05-01,1613,205,679,130,2627
"9171","Riverside County",2000-06-01,1606,214,699,131,2650
"9172","Riverside County",2000-07-01,1597,220,743,151,2711
"9173","Riverside County",2000-08-01,1663,219,723,166,2771
"9174","Riverside County",2000-09-01,1666,227,729,148,2770
"9175","Riverside County",2000-10-01,1603,202,737,137,2679
"9176","Riverside County",2000-11-01,1617,195,729,133,2674
"9177","Riverside County",2000-12-01,1644,181,683,135,2643
"9178","Riverside County",2001-01-01,1649,186,806,146,2787
"9179","Riverside County",2001-02-01,1654,182,717,140,2693
"9180","Riverside County",2001-03-01,1658,190,720,141,2709
"9181","Riverside County",2001-04-01,1629,180,793,144,2746
"9182","Riverside County",2001-05-01,1675,186,830,137,2828
"9183","Riverside County",2001-06-01,1699,184,837,135,2855
"9184","Riverside County",2001-07-01,1730,195,849,141,2915
"9185","Riverside County",2001-08-01,1738,195,871,165,2969
"9186","Riverside County",2001-09-01,1832,211,878,182,3103
"9187","Riverside County",2001-10-01,1855,213,875,166,3109
"9188","Riverside County",2001-11-01,1822,206,879,161,3068
"9189","Riverside County",2001-12-01,1849,199,833,148,3029
"9190","Riverside County",2002-01-01,1946,205,902,151,3204
"9191","Riverside County",2002-02-01,1984,234,935,137,3290
"9192","Riverside County",2002-03-01,1936,239,937,128,3240
"9193","Riverside County",2002-04-01,1961,251,913,131,3256
"9194","Riverside County",2002-05-01,1948,254,913,124,3239
"9195","Riverside County",2002-06-01,1971,261,920,131,3283
"9196","Riverside County",2002-07-01,1981,269,880,140,3270
"9197","Riverside County",2002-08-01,2038,254,871,135,3298
"9198","Riverside County",2002-09-01,2017,262,899,116,3294
"9199","Riverside County",2002-10-01,2026,261,885,113,3285
"9200","Riverside County",2002-11-01,1966,259,874,114,3213
"9201","Riverside County",2002-12-01,1975,260,863,123,3221
"9202","Riverside County",2003-01-01,2046,282,837,128,3293
"9203","Riverside County",2003-02-01,1977,271,880,141,3269
"9204","Riverside County",2003-03-01,1949,275,890,131,3245
"9205","Riverside County",2003-04-01,2016,268,856,139,3279
"9206","Riverside County",2003-05-01,2068,285,816,124,3293
"9207","Riverside County",2003-06-01,2115,272,760,120,3267
"9208","Riverside County",2003-07-01,2110,249,804,121,3284
"9209","Riverside County",2003-08-01,2138,255,811,139,3343
"9210","Riverside County",2003-09-01,2256,268,773,146,3443
"9211","Riverside County",2003-10-01,2159,251,735,134,3279
"9212","Riverside County",2003-11-01,2215,253,670,120,3258
"9213","Riverside County",2003-12-01,2171,241,670,107,3189
"9214","Riverside County",2004-01-01,2222,266,681,101,3270
"9215","Riverside County",2004-02-01,2317,283,612,95,3307
"9216","Riverside County",2004-03-01,2303,256,608,106,3273
"9217","Riverside County",2004-04-01,2290,265,604,99,3258
"9218","Riverside County",2004-05-01,2243,255,670,104,3272
"9219","Riverside County",2004-06-01,2229,264,671,86,3250
"9220","Riverside County",2004-07-01,2247,265,637,85,3234
"9221","Riverside County",2004-08-01,2283,290,572,93,3238
"9222","Riverside County",2004-09-01,2280,284,581,97,3242
"9223","Riverside County",2004-10-01,2266,265,582,103,3216
"9224","Riverside County",2004-11-01,2242,259,591,103,3195
"9225","Riverside County",2004-12-01,2248,257,575,101,3181
"9226","Riverside County",2005-01-01,2310,276,561,94,3241
"9227","Riverside County",2005-02-01,2359,300,511,79,3249
"9228","Riverside County",2005-03-01,2296,299,503,81,3179
"9229","Riverside County",2005-04-01,2290,300,510,85,3185
"9230","Riverside County",2005-05-01,2391,308,440,83,3222
"9231","Riverside County",2005-06-01,2432,319,417,69,3237
"9232","Riverside County",2005-07-01,2435,323,419,67,3244
"9233","Riverside County",2005-08-01,2432,304,431,69,3236
"9234","Riverside County",2005-09-01,2494,312,400,64,3270
"9235","Riverside County",2005-10-01,2458,305,454,75,3292
"9236","Riverside County",2005-11-01,2484,317,436,89,3326
"9237","Riverside County",2005-12-01,2436,307,440,99,3282
"9238","Riverside County",2006-01-01,2435,325,426,98,3284
"9239","Riverside County",2006-02-01,2463,343,399,86,3291
"9240","Riverside County",2006-03-01,2530,325,395,75,3325
"9241","Riverside County",2006-04-01,2514,306,412,78,3310
"9242","Riverside County",2006-05-01,2556,307,432,63,3358
"9243","Riverside County",2006-06-01,2599,311,420,74,3404
"9244","Riverside County",2006-07-01,2590,307,430,72,3399
"9245","Riverside County",2006-08-01,2627,323,406,68,3424
"9246","Riverside County",2006-09-01,2650,303,394,69,3416
"9247","Riverside County",2006-10-01,2677,305,406,70,3458
"9248","Riverside County",2006-11-01,2722,311,386,56,3475
"9249","Riverside County",2006-12-01,2692,300,415,68,3475
"9250","Riverside County",2007-01-01,2783,293,420,83,3579
"9251","Riverside County",2007-02-01,2908,305,396,66,3675
"9252","Riverside County",2007-03-01,2944,297,418,66,3725
"9253","Riverside County",2007-04-01,2993,290,402,62,3747
"9254","Riverside County",2007-05-01,2992,305,394,70,3761
"9255","Riverside County",2007-06-01,3015,315,411,69,3810
"9256","Riverside County",2007-07-01,3021,304,427,73,3825
"9257","Riverside County",2007-08-01,3010,307,435,74,3826
"9258","Riverside County",2007-09-01,3066,312,404,66,3848
"9259","Riverside County",2007-10-01,3007,293,447,69,3816
"9260","Riverside County",2007-11-01,2923,279,459,67,3728
"9261","Riverside County",2007-12-01,2836,281,450,56,3623
"9262","Riverside County",2008-01-01,2858,280,470,61,3669
"9263","Riverside County",2008-02-01,2794,280,489,68,3631
"9264","Riverside County",2008-03-01,2716,284,543,83,3626
"9265","Riverside County",2008-04-01,2691,273,551,84,3599
"9266","Riverside County",2008-05-01,2646,247,601,113,3607
"9267","Riverside County",2008-06-01,2652,241,630,124,3647
"9268","Riverside County",2008-07-01,2668,241,630,121,3660
"9269","Riverside County",2008-08-01,2640,260,624,121,3645
"9270","Riverside County",2008-09-01,2625,256,568,119,3568
"9271","Riverside County",2008-10-01,2581,251,602,130,3564
"9272","Riverside County",2008-11-01,2571,243,595,131,3540
"9273","Riverside County",2008-12-01,2530,250,585,135,3500
"9274","Riverside County",2009-01-01,2565,276,589,132,3562
"9275","Riverside County",2009-02-01,2558,278,593,135,3564
"9276","Riverside County",2009-03-01,2504,262,620,143,3529
"9277","Riverside County",2009-04-01,2495,265,623,140,3523
"9278","Riverside County",2009-05-01,2548,257,647,143,3595
"9279","Riverside County",2009-06-01,2592,249,659,126,3626
"9280","Riverside County",2009-07-01,2562,273,669,134,3638
"9281","Riverside County",2009-08-01,2615,277,627,131,3650
"9282","Riverside County",2009-09-01,2614,278,633,110,3635
"9283","Riverside County",2009-10-01,2516,265,655,125,3561
"9284","Riverside County",2009-11-01,2489,247,638,130,3504
"9285","Riverside County",2009-12-01,2418,228,599,114,3359
"9286","Riverside County",2010-01-01,2415,234,571,110,3330
"9287","Riverside County",2010-02-01,2381,234,515,103,3233
"9288","Riverside County",2010-03-01,2414,251,564,106,3335
"9289","Riverside County",2010-04-01,2501,282,591,96,3470
"9290","Riverside County",2010-05-01,2461,265,591,94,3411
"9291","Riverside County",2010-06-01,2470,278,611,98,3457
"9292","Riverside County",2010-07-01,2436,278,601,117,3432
"9293","Riverside County",2010-08-01,2398,275,649,114,3436
"9294","Riverside County",2010-09-01,2390,272,665,129,3456
"9295","Riverside County",2010-10-01,2354,265,643,124,3386
"9296","Riverside County",2010-11-01,2323,259,589,121,3292
"9297","Riverside County",2010-12-01,2207,252,569,126,3154
"9298","Riverside County",2011-01-01,2227,255,572,112,3166
"9299","Riverside County",2011-02-01,2208,237,582,124,3151
"9300","Riverside County",2011-03-01,2134,256,624,120,3134
"9301","Riverside County",2011-04-01,2128,265,622,109,3124
"9302","Riverside County",2011-05-01,2182,257,621,117,3177
"9303","Riverside County",2011-06-01,2204,264,617,127,3212
"9304","Riverside County",2011-07-01,2247,263,633,130,3273
"9305","Riverside County",2011-08-01,2216,263,652,135,3266
"9306","Riverside County",2011-09-01,2261,283,648,150,3342
"9307","Riverside County",2011-10-01,2274,296,710,172,3452
"9308","Riverside County",2011-11-01,2248,283,906,195,3632
"9309","Riverside County",2011-12-01,2258,285,1008,200,3751
"9310","Riverside County",2012-01-01,2318,268,1054,217,3857
"9311","Riverside County",2012-02-01,2259,255,1127,230,3871
"9312","Riverside County",2012-03-01,2276,253,1086,208,3823
"9313","Riverside County",2012-04-01,2308,257,1130,202,3897
"9314","Riverside County",2012-05-01,2326,269,1123,193,3911
"9315","Riverside County",2012-06-01,2339,277,1087,202,3905
"9316","Riverside County",2012-07-01,2298,280,1127,204,3909
"9317","Riverside County",2012-08-01,2344,299,1096,186,3925
"9318","Riverside County",2012-09-01,2415,306,1027,168,3916
"9319","Riverside County",2012-10-01,2440,306,1001,168,3915
"9320","Riverside County",2012-11-01,2395,279,1043,185,3902
"9321","Riverside County",2012-12-01,2375,282,1071,179,3907
"9322","Riverside County",2013-01-01,2472,295,982,153,3902
"9323","Riverside County",2013-02-01,2464,315,941,137,3857
"9324","Riverside County",2013-03-01,2423,305,986,153,3867
"9325","Riverside County",2013-04-01,2466,295,957,164,3882
"9326","Riverside County",2013-05-01,2466,318,936,162,3882
"9327","Riverside County",2013-06-01,2528,323,878,153,3882
"9328","Riverside County",2013-07-01,2512,317,900,149,3878
"9329","Riverside County",2013-08-01,2453,313,985,160,3911
"9330","Riverside County",2013-09-01,2485,317,976,156,3934
"9331","Riverside County",2013-10-01,2441,327,1007,157,3932
"9332","Riverside County",2013-11-01,2423,310,1032,158,3923
"9333","Riverside County",2013-12-01,2436,288,1028,171,3923
"9334","Riverside County",2014-01-01,2517,306,988,152,3963
"9335","Riverside County",2014-02-01,2544,306,942,148,3940
"9336","Riverside County",2014-03-01,2500,291,983,155,3929
"9337","Riverside County",2014-04-01,2494,288,1026,150,3958
"9338","Riverside County",2014-05-01,2471,298,1033,153,3955
"9339","Riverside County",2014-06-01,2461,285,1048,169,3963
"9340","Riverside County",2014-07-01,2401,295,1079,183,3958
"9341","Riverside County",2014-08-01,2342,299,1123,171,3935
"9342","Riverside County",2014-09-01,2324,302,1111,181,3918
"9343","Riverside County",2014-10-01,2325,289,1148,181,3943
"9344","Riverside County",2014-11-01,2204,275,1227,198,3904
"9345","Riverside County",2014-12-01,2099,250,1322,231,3902
"9346","Riverside County",2015-01-01,2122,268,1314,213,3917
"9347","Riverside County",2015-02-01,2159,278,1288,207,3932
"9348","Riverside County",2015-03-01,2129,252,1330,220,3931
"9349","Riverside County",2015-04-01,2093,246,1364,228,3931
"9350","Riverside County",2015-05-01,2024,245,1353,217,3839
"9351","Riverside County",2015-06-01,2058,251,1283,209,3801
"9352","Riverside County",2015-07-01,2114,235,1243,203,3795
"9353","Riverside County",2015-08-01,2068,235,1276,206,3785
"9354","Riverside County",2015-09-01,2120,244,1207,202,3773
"9355","Riverside County",2015-10-01,2138,250,1173,187,3748
"9356","Riverside County",2015-11-01,2101,241,1186,183,3711
"9357","Riverside County",2015-12-01,2058,240,1200,188,3686
"9358","Riverside County",2016-01-01,2111,240,1190,191,3732
"9359","Riverside County",2016-02-01,2147,243,1177,163,3730
"9360","Riverside County",2016-03-01,2183,240,1154,167,3744
"9361","Riverside County",2016-04-01,2245,261,1098,159,3763
"9362","Riverside County",2016-05-01,2272,277,1091,157,3797
"9363","Riverside County",2016-06-01,2319,281,1072,147,3819
"9364","Riverside County",2016-07-01,2362,278,1007,148,3795
"9365","Riverside County",2016-08-01,2364,277,982,149,3772
"9366","Riverside County",2016-09-01,2395,279,977,145,3796
"9367","Riverside County",2016-10-01,2295,275,1052,140,3762
"9368","Riverside County",2016-11-01,2285,278,1047,134,3744
"9369","Riverside County",2016-12-01,2263,265,1049,155,3732
"9370","Riverside County",2017-01-01,2300,255,1045,148,3748
"9371","Riverside County",2017-02-01,2302,271,1051,140,3764
"9372","Riverside County",2017-03-01,2274,277,1083,140,3774
"9373","Riverside County",2017-04-01,2226,281,1100,144,3751
"9374","Riverside County",2017-05-01,2200,280,1118,157,3755
"9375","Riverside County",2017-06-01,2267,282,1044,147,3740
"9376","Riverside County",2017-07-01,2276,279,1038,156,3749
"9377","Riverside County",2017-08-01,2299,286,1039,153,3777
"9378","Riverside County",2017-09-01,2313,308,984,158,3763
"9379","Riverside County",2017-10-01,2317,306,988,151,3762
"9380","Riverside County",2017-11-01,2319,301,990,150,3760
"9381","Riverside County",2017-12-01,2321,277,1005,161,3764
"9382","Riverside County",2018-01-01,2381,297,871,131,3680
"9383","Riverside County",2018-02-01,2389,307,854,134,3684
"9384","Riverside County",2018-03-01,2329,307,910,144,3690
"9385","Riverside County",2018-04-01,2346,303,899,138,3686
"9386","Riverside County",2018-05-01,2310,297,944,131,3682
"9387","Riverside County",2018-06-01,2344,300,903,133,3680
"9388","Riverside County",2018-07-01,2367,287,900,139,3693
"9389","Riverside County",2018-08-01,2368,290,965,137,3760
"9390","Riverside County",2018-09-01,2461,300,894,136,3791
"9391","Riverside County",2018-10-01,2444,285,834,132,3695
"9392","Riverside County",2018-11-01,2460,292,798,125,3675
"9393","Riverside County",2018-12-01,2400,292,846,125,3663
"9394","Riverside County",2019-01-01,2436,293,837,115,3681
"9395","Riverside County",2019-02-01,2449,298,820,115,3682
"9396","Riverside County",2019-03-01,2406,292,882,137,3717
"9397","Riverside County",2019-04-01,2478,290,856,124,3748
"9398","Riverside County",2019-05-01,2441,291,875,125,3732
"9399","Riverside County",2019-06-01,2431,287,957,155,3830
"9400","Riverside County",2019-07-01,2468,301,900,150,3819
"9401","Riverside County",2019-08-01,2493,296,885,147,3821
"9402","Riverside County",2019-09-01,2537,304,856,131,3828
"9403","Riverside County",2019-10-01,2538,303,847,121,3809
"9404","Riverside County",2019-11-01,2466,297,905,129,3797
"9405","Riverside County",2019-12-01,2445,296,913,140,3794
"9406","Riverside County",2020-01-01,2487,299,903,132,3821
"9407","Riverside County",2020-02-01,2527,305,865,126,3823
"9408","Riverside County",2020-03-01,2531,285,839,123,3778
"9409","Sacramento County",1995-10-01,1516,264,1248,236,3264
"9410","Sacramento County",1995-11-01,1516,265,1238,227,3246
"9411","Sacramento County",1995-12-01,1419,227,1176,244,3066
"9412","Sacramento County",1996-01-01,1475,211,1156,228,3070
"9413","Sacramento County",1996-02-01,1519,227,1232,235,3213
"9414","Sacramento County",1996-03-01,1539,217,1348,233,3337
"9415","Sacramento County",1996-04-01,1500,222,1336,237,3295
"9416","Sacramento County",1996-05-01,1495,217,1213,236,3161
"9417","Sacramento County",1996-06-01,1508,231,1192,234,3165
"9418","Sacramento County",1996-07-01,1536,241,1192,235,3204
"9419","Sacramento County",1996-08-01,1582,225,1197,229,3233
"9420","Sacramento County",1996-09-01,1485,360,1194,240,3279
"9421","Sacramento County",1996-10-01,1615,240,1223,246,3324
"9422","Sacramento County",1996-11-01,1642,225,1188,248,3303
"9423","Sacramento County",1996-12-01,1592,233,1081,205,3111
"9424","Sacramento County",1997-01-01,1705,224,1121,236,3286
"9425","Sacramento County",1997-02-01,1748,219,1234,242,3443
"9426","Sacramento County",1997-03-01,1704,251,1308,257,3520
"9427","Sacramento County",1997-04-01,1655,275,1377,251,3558
"9428","Sacramento County",1997-05-01,1644,274,1363,249,3530
"9429","Sacramento County",1997-06-01,1608,264,1340,257,3469
"9430","Sacramento County",1997-07-01,1628,301,1299,245,3473
"9431","Sacramento County",1997-08-01,1647,300,1311,247,3505
"9432","Sacramento County",1997-09-01,1622,296,1282,245,3445
"9433","Sacramento County",1997-10-01,1619,284,1234,252,3389
"9434","Sacramento County",1997-11-01,1667,296,1173,242,3378
"9435","Sacramento County",1997-12-01,1671,269,1242,251,3433
"9436","Sacramento County",1998-01-01,1714,294,1216,246,3470
"9437","Sacramento County",1998-02-01,1744,328,1278,251,3601
"9438","Sacramento County",1998-03-01,1716,322,1370,251,3659
"9439","Sacramento County",1998-04-01,1693,305,1342,247,3587
"9440","Sacramento County",1998-05-01,1679,301,1306,246,3532
"9441","Sacramento County",1998-06-01,1637,314,1381,249,3581
"9442","Sacramento County",1998-07-01,1638,336,1371,249,3594
"9443","Sacramento County",1998-08-01,1633,321,1377,249,3580
"9444","Sacramento County",1998-09-01,1578,313,1356,249,3496
"9445","Sacramento County",1998-10-01,1558,278,1260,245,3341
"9446","Sacramento County",1998-11-01,1436,266,1172,243,3117
"9447","Sacramento County",1998-12-01,1436,266,1172,243,3117
"9448","Sacramento County",1999-01-01,1476,268,1176,247,3167
"9449","Sacramento County",1999-02-01,1532,291,1231,250,3304
"9450","Sacramento County",1999-03-01,1506,303,1216,246,3271
"9451","Sacramento County",1999-04-01,1470,280,1244,250,3244
"9452","Sacramento County",1999-05-01,1426,237,1263,308,3234
"9453","Sacramento County",1999-06-01,1506,242,1195,244,3187
"9454","Sacramento County",1999-07-01,1515,253,1091,242,3101
"9455","Sacramento County",1999-08-01,1535,299,1117,240,3191
"9456","Sacramento County",1999-09-01,1579,270,1149,228,3226
"9457","Sacramento County",1999-10-01,1657,310,1155,182,3304
"9458","Sacramento County",1999-11-01,1647,301,1123,185,3256
"9459","Sacramento County",1999-12-01,1574,312,1032,141,3059
"9460","Sacramento County",2000-01-01,1733,274,1075,187,3269
"9461","Sacramento County",2000-02-01,1552,298,1083,187,3120
"9462","Sacramento County",2000-03-01,1529,318,1102,186,3135
"9463","Sacramento County",2000-04-01,1515,325,1148,187,3175
"9464","Sacramento County",2000-05-01,1516,342,1082,187,3127
"9465","Sacramento County",2000-06-01,1502,344,1103,188,3137
"9466","Sacramento County",2000-07-01,1537,286,1173,185,3181
"9467","Sacramento County",2000-08-01,1587,296,1153,176,3212
"9468","Sacramento County",2000-09-01,1579,257,1165,177,3178
"9469","Sacramento County",2000-10-01,1592,268,1191,187,3238
"9470","Sacramento County",2000-11-01,1604,248,1192,188,3232
"9471","Sacramento County",2000-12-01,1545,205,1150,224,3124
"9472","Sacramento County",2001-01-01,1582,202,1161,202,3147
"9473","Sacramento County",2001-02-01,1544,205,1228,222,3199
"9474","Sacramento County",2001-03-01,1548,264,1287,216,3315
"9475","Sacramento County",2001-04-01,1471,234,1323,125,3153
"9476","Sacramento County",2001-05-01,1447,245,1318,211,3221
"9477","Sacramento County",2001-06-01,1486,237,1470,187,3380
"9478","Sacramento County",2001-07-01,1508,236,1352,191,3287
"9479","Sacramento County",2001-08-01,1563,235,1323,206,3327
"9480","Sacramento County",2001-09-01,1611,250,1332,190,3383
"9481","Sacramento County",2001-10-01,1327,215,1297,198,3037
"9482","Sacramento County",2001-11-01,1275,216,1234,174,2899
"9483","Sacramento County",2001-12-01,1276,216,1189,174,2855
"9484","Sacramento County",2002-01-01,1340,243,1158,134,2875
"9485","Sacramento County",2002-02-01,1258,181,1174,148,2761
"9486","Sacramento County",2002-03-01,1363,266,1542,176,3347
"9487","Sacramento County",2002-04-01,1352,229,1272,193,3046
"9488","Sacramento County",2002-05-01,1319,201,1295,184,2999
"9489","Sacramento County",2002-06-01,1279,196,1247,132,2854
"9490","Sacramento County",2002-07-01,1338,231,1244,210,3023
"9491","Sacramento County",2002-08-01,1344,231,1393,210,3178
"9492","Sacramento County",2002-09-01,1324,234,1396,212,3166
"9493","Sacramento County",2002-10-01,1333,216,1452,216,3217
"9494","Sacramento County",2002-11-01,1386,197,1409,213,3205
"9495","Sacramento County",2002-12-01,1402,367,1386,136,3291
"9496","Sacramento County",2003-01-01,1412,231,1410,162,3215
"9497","Sacramento County",2003-02-01,1366,242,1476,148,3232
"9498","Sacramento County",2003-03-01,1393,212,1417,190,3212
"9499","Sacramento County",2003-04-01,1411,185,1482,222,3300
"9500","Sacramento County",2003-05-01,1343,227,1445,188,3203
"9501","Sacramento County",2003-06-01,1319,204,1522,186,3231
"9502","Sacramento County",2003-07-01,1352,196,1497,215,3260
"9503","Sacramento County",2003-08-01,1360,196,1551,215,3322
"9504","Sacramento County",2003-09-01,1362,196,1591,215,3364
"9505","Sacramento County",2003-10-01,1423,209,1543,211,3386
"9506","Sacramento County",2003-11-01,1413,222,1554,206,3395
"9507","Sacramento County",2003-12-01,1404,216,1495,217,3332
"9508","Sacramento County",2004-01-01,1475,224,1498,223,3420
"9509","Sacramento County",2004-02-01,1538,247,1561,241,3587
"9510","Sacramento County",2004-03-01,1567,252,1602,262,3683
"9511","Sacramento County",2004-04-01,1554,242,1577,272,3645
"9512","Sacramento County",2004-05-01,1493,260,1515,272,3540
"9513","Sacramento County",2004-06-01,1484,235,1513,266,3498
"9514","Sacramento County",2004-07-01,1506,224,1493,256,3479
"9515","Sacramento County",2004-08-01,1560,261,1513,254,3588
"9516","Sacramento County",2004-09-01,1549,234,1467,268,3518
"9517","Sacramento County",2004-10-01,1569,235,1517,267,3588
"9518","Sacramento County",2004-11-01,1579,223,1453,241,3496
"9519","Sacramento County",2004-12-01,1653,210,1368,246,3477
"9520","Sacramento County",2005-01-01,1659,212,1334,259,3464
"9521","Sacramento County",2005-02-01,1671,207,1315,258,3451
"9522","Sacramento County",2005-03-01,1679,207,1335,264,3485
"9523","Sacramento County",2005-04-01,1667,228,1371,271,3537
"9524","Sacramento County",2005-05-01,1664,231,1369,271,3535
"9525","Sacramento County",2005-06-01,1658,233,1511,256,3658
"9526","Sacramento County",2005-07-01,1684,206,1459,240,3589
"9527","Sacramento County",2005-08-01,1595,243,1368,247,3453
"9528","Sacramento County",2005-09-01,1697,257,1547,267,3768
"9529","Sacramento County",2005-10-01,1636,254,1566,265,3721
"9530","Sacramento County",2005-11-01,1656,264,1469,259,3648
"9531","Sacramento County",2005-12-01,1681,217,1421,265,3584
"9532","Sacramento County",2006-01-01,1767,173,1445,278,3663
"9533","Sacramento County",2006-02-01,1665,262,1321,243,3491
"9534","Sacramento County",2006-03-01,1748,254,1383,260,3645
"9535","Sacramento County",2006-04-01,2119,302,1472,287,4180
"9536","Sacramento County",2006-05-01,2179,295,1442,282,4198
"9537","Sacramento County",2006-06-01,2196,274,1387,258,4115
"9538","Sacramento County",2006-07-01,2247,292,1437,265,4241
"9539","Sacramento County",2006-08-01,2342,299,1420,277,4338
"9540","Sacramento County",2006-09-01,2356,302,1484,285,4427
"9541","Sacramento County",2006-10-01,2329,300,1511,288,4428
"9542","Sacramento County",2006-11-01,2280,278,1553,288,4399
"9543","Sacramento County",2006-12-01,2334,271,1433,253,4291
"9544","Sacramento County",2007-01-01,2392,334,1493,254,4473
"9545","Sacramento County",2007-02-01,2336,339,1520,238,4433
"9546","Sacramento County",2007-03-01,2403,315,1472,260,4450
"9547","Sacramento County",2007-04-01,2392,315,1472,265,4444
"9548","Sacramento County",2007-05-01,2389,331,1621,279,4620
"9549","Sacramento County",2007-06-01,2428,346,1537,281,4592
"9550","Sacramento County",2007-07-01,2444,295,1543,280,4562
"9551","Sacramento County",2007-08-01,2482,316,1576,270,4644
"9552","Sacramento County",2007-09-01,2430,328,1572,271,4601
"9553","Sacramento County",2007-10-01,2436,319,1539,286,4580
"9554","Sacramento County",2007-11-01,2474,278,1527,289,4568
"9555","Sacramento County",2007-12-01,2440,271,1407,278,4396
"9556","Sacramento County",2008-01-01,2495,268,1454,269,4486
"9557","Sacramento County",2008-02-01,2476,277,1493,266,4512
"9558","Sacramento County",2008-03-01,2485,280,1537,277,4579
"9559","Sacramento County",2008-04-01,2551,293,1570,283,4697
"9560","Sacramento County",2008-05-01,2445,257,1547,262,4511
"9561","Sacramento County",2008-06-01,2404,302,1581,255,4542
"9562","Sacramento County",2008-07-01,2432,317,1629,244,4622
"9563","Sacramento County",2008-08-01,2469,289,1617,261,4636
"9564","Sacramento County",2008-09-01,2518,283,1633,274,4708
"9565","Sacramento County",2008-10-01,2536,289,1665,278,4768
"9566","Sacramento County",2008-11-01,2494,266,1662,266,4688
"9567","Sacramento County",2008-12-01,2414,250,1536,237,4437
"9568","Sacramento County",2009-01-01,2395,267,1589,254,4505
"9569","Sacramento County",2009-02-01,2419,274,1638,256,4587
"9570","Sacramento County",2009-03-01,2412,259,1664,260,4595
"9571","Sacramento County",2009-04-01,2400,255,1656,261,4572
"9572","Sacramento County",2009-05-01,2302,257,1598,253,4410
"9573","Sacramento County",2009-06-01,2322,254,1657,257,4490
"9574","Sacramento County",2009-07-01,2304,263,1597,228,4392
"9575","Sacramento County",2009-08-01,2279,262,1693,211,4445
"9576","Sacramento County",2009-09-01,2393,282,1684,212,4571
"9577","Sacramento County",2009-10-01,2331,274,1618,218,4441
"9578","Sacramento County",2009-11-01,2231,245,1576,229,4281
"9579","Sacramento County",2009-12-01,2187,236,1549,204,4176
"9580","Sacramento County",2010-01-01,2249,232,1452,217,4150
"9581","Sacramento County",2010-02-01,2181,235,1253,194,3863
"9582","Sacramento County",2010-03-01,2138,219,1314,208,3879
"9583","Sacramento County",2010-04-01,2097,210,1302,201,3810
"9584","Sacramento County",2010-05-01,2214,241,1395,210,4060
"9585","Sacramento County",2010-06-01,2202,220,1365,214,4001
"9586","Sacramento County",2010-07-01,2246,214,1382,110,3952
"9587","Sacramento County",2010-08-01,2352,225,1443,59,4079
"9588","Sacramento County",2010-09-01,2267,226,1568,275,4336
"9589","Sacramento County",2010-10-01,2378,188,1582,287,4435
"9590","Sacramento County",2010-11-01,2325,170,1536,286,4317
"9591","Sacramento County",2010-12-01,2275,172,1456,265,4168
"9592","Sacramento County",2011-01-01,2317,183,1437,279,4216
"9593","Sacramento County",2011-02-01,2325,182,1510,296,4313
"9594","Sacramento County",2011-03-01,2233,161,1529,273,4196
"9595","Sacramento County",2011-04-01,2198,154,1328,286,3966
"9596","Sacramento County",2011-05-01,593,1715,1323,324,3955
"9597","Sacramento County",2011-06-01,2120,174,1345,268,3907
"9598","Sacramento County",2011-07-01,2135,158,1432,258,3983
"9599","Sacramento County",2011-08-01,2162,148,1542,256,4108
"9600","Sacramento County",2011-09-01,2142,150,1528,251,4071
"9601","Sacramento County",2011-10-01,2103,135,1469,248,3955
"9602","Sacramento County",2011-11-01,2083,135,1492,249,3959
"9603","Sacramento County",2011-12-01,2059,134,1451,249,3893
"9604","Sacramento County",2012-01-01,2093,141,1774,306,4314
"9605","Sacramento County",2012-02-01,2115,142,1469,279,4005
"9606","Sacramento County",2012-03-01,2043,136,1474,282,3935
"9607","Sacramento County",2012-04-01,2089,139,1462,271,3961
"9608","Sacramento County",2012-05-01,2156,142,1481,287,4066
"9609","Sacramento County",2012-06-01,2096,140,1562,293,4091
"9610","Sacramento County",2012-07-01,2145,150,1521,309,4125
"9611","Sacramento County",2012-08-01,2179,153,1664,310,4306
"9612","Sacramento County",2012-09-01,2157,160,1564,321,4202
"9613","Sacramento County",2012-10-01,2289,149,1384,242,4064
"9614","Sacramento County",2012-11-01,2235,159,1351,272,4017
"9615","Sacramento County",2012-12-01,2081,158,1294,293,3826
"9616","Sacramento County",2013-01-01,2113,161,1415,326,4015
"9617","Sacramento County",2013-02-01,2135,152,1428,328,4043
"9618","Sacramento County",2013-03-01,2168,152,1496,299,4115
"9619","Sacramento County",2013-04-01,2135,155,1507,300,4097
"9620","Sacramento County",2013-05-01,2179,147,1557,309,4192
"9621","Sacramento County",2013-06-01,2147,144,1537,345,4173
"9622","Sacramento County",2013-07-01,2180,149,1402,313,4044
"9623","Sacramento County",2013-08-01,2253,131,1417,325,4126
"9624","Sacramento County",2013-09-01,2324,153,1404,321,4202
"9625","Sacramento County",2013-10-01,2288,178,1408,323,4197
"9626","Sacramento County",2013-11-01,2311,184,1502,321,4318
"9627","Sacramento County",2013-12-01,2281,163,1457,324,4225
"9628","Sacramento County",2014-01-01,2245,154,1542,322,4263
"9629","Sacramento County",2014-02-01,2231,171,1605,326,4333
"9630","Sacramento County",2014-03-01,2244,174,1536,320,4274
"9631","Sacramento County",2014-04-01,2300,184,1545,326,4355
"9632","Sacramento County",2014-05-01,2291,186,1550,325,4352
"9633","Sacramento County",2014-06-01,2327,192,1670,310,4499
"9634","Sacramento County",2014-07-01,2411,194,1616,309,4530
"9635","Sacramento County",2014-08-01,2424,197,1545,303,4469
"9636","Sacramento County",2014-09-01,2376,215,1455,292,4338
"9637","Sacramento County",2014-10-01,2350,208,1453,291,4302
"9638","Sacramento County",2014-11-01,2164,179,1453,293,4089
"9639","Sacramento County",2014-12-01,1584,175,1904,242,3905
"9640","Sacramento County",2015-01-01,1672,191,1834,229,3926
"9641","Sacramento County",2015-02-01,1719,214,1816,217,3966
"9642","Sacramento County",2015-03-01,1758,223,1817,215,4013
"9643","Sacramento County",2015-04-01,1723,208,1863,220,4014
"9644","Sacramento County",2015-05-01,1704,201,1914,252,4071
"9645","Sacramento County",2015-06-01,1722,193,1854,253,4022
"9646","Sacramento County",2015-07-01,1764,184,1846,252,4046
"9647","Sacramento County",2015-08-01,1823,187,1944,262,4216
"9648","Sacramento County",2015-09-01,1879,193,1995,261,4328
"9649","Sacramento County",2015-10-01,1801,191,1927,249,4168
"9650","Sacramento County",2015-11-01,1778,192,1795,211,3976
"9651","Sacramento County",2015-12-01,1700,185,1714,214,3813
"9652","Sacramento County",2016-01-01,2182,198,1244,202,3826
"9653","Sacramento County",2016-02-01,2209,214,1315,196,3934
"9654","Sacramento County",2016-03-01,2184,198,1329,217,3928
"9655","Sacramento County",2016-04-01,2139,198,1354,221,3912
"9656","Sacramento County",2016-05-01,2096,213,1370,221,3900
"9657","Sacramento County",2016-06-01,2128,225,1359,221,3933
"9658","Sacramento County",2016-07-01,2121,212,1352,214,3899
"9659","Sacramento County",2016-08-01,2082,198,1401,225,3906
"9660","Sacramento County",2016-09-01,2037,192,1433,242,3904
"9661","Sacramento County",2016-10-01,2009,182,1352,234,3777
"9662","Sacramento County",2016-11-01,2021,169,1281,233,3704
"9663","Sacramento County",2016-12-01,1943,171,1264,239,3617
"9664","Sacramento County",2017-01-01,1931,172,1267,235,3605
"9665","Sacramento County",2017-02-01,1916,191,1289,209,3605
"9666","Sacramento County",2017-03-01,1773,160,1277,211,3421
"9667","Sacramento County",2017-04-01,1787,184,1267,220,3458
"9668","Sacramento County",2017-05-01,1796,187,1210,215,3408
"9669","Sacramento County",2017-06-01,1826,173,1252,216,3467
"9670","Sacramento County",2017-07-01,1894,182,1328,224,3628
"9671","Sacramento County",2017-08-01,1895,191,1349,233,3668
"9672","Sacramento County",2017-09-01,1898,199,1283,222,3602
"9673","Sacramento County",2017-10-01,1956,191,1197,233,3577
"9674","Sacramento County",2017-11-01,2024,181,1212,225,3642
"9675","Sacramento County",2017-12-01,2028,172,1190,230,3620
"9676","Sacramento County",2018-01-01,2039,197,1197,223,3656
"9677","Sacramento County",2018-02-01,1996,194,1296,226,3712
"9678","Sacramento County",2018-03-01,1932,181,1296,253,3662
"9679","Sacramento County",2018-04-01,1912,175,1269,233,3589
"9680","Sacramento County",2018-05-01,1832,176,1290,220,3518
"9681","Sacramento County",2018-06-01,1835,204,1324,240,3603
"9682","Sacramento County",2018-07-01,1845,212,1279,235,3571
"9683","Sacramento County",2018-08-01,1899,204,1315,254,3672
"9684","Sacramento County",2018-09-01,1958,211,1321,256,3746
"9685","Sacramento County",2018-10-01,1912,224,1326,254,3716
"9686","Sacramento County",2018-11-01,1892,225,1367,243,3727
"9687","Sacramento County",2018-12-01,1922,224,1281,234,3661
"9688","Sacramento County",2019-01-01,1979,217,1224,226,3646
"9689","Sacramento County",2019-02-01,2006,218,1227,212,3663
"9690","Sacramento County",2019-03-01,1955,207,1302,222,3686
"9691","Sacramento County",2019-04-01,1972,232,1284,212,3700
"9692","Sacramento County",2019-05-01,1949,222,1279,230,3680
"9693","Sacramento County",2019-06-01,1931,228,1282,205,3646
"9694","Sacramento County",2019-07-01,1949,233,1199,205,3586
"9695","Sacramento County",2019-08-01,1975,227,1242,211,3655
"9696","Sacramento County",2019-09-01,2020,257,1270,204,3751
"9697","Sacramento County",2019-10-01,2008,254,1248,210,3720
"9698","Sacramento County",2019-11-01,1961,236,1206,202,3605
"9699","Sacramento County",2019-12-01,1940,243,1133,185,3501
"9700","Sacramento County",2020-01-01,1966,243,1112,191,3512
"9701","Sacramento County",2020-02-01,1983,236,1115,212,3546
"9702","Sacramento County",2020-03-01,1919,207,1019,191,3336
"9703","San Benito County",1995-10-01,37,8,52,5,102
"9704","San Benito County",1995-11-01,37,6,49,4,96
"9705","San Benito County",1995-12-01,31,3,45,4,83
"9706","San Benito County",1996-01-01,38,4,42,5,89
"9707","San Benito County",1996-02-01,42,4,52,5,103
"9708","San Benito County",1996-03-01,39,4,57,6,106
"9709","San Benito County",1996-04-01,47,6,56,6,115
"9710","San Benito County",1996-05-01,39,5,54,9,107
"9711","San Benito County",1996-06-01,42,5,41,7,95
"9712","San Benito County",1996-07-01,47,4,48,10,109
"9713","San Benito County",1996-08-01,46,3,57,8,114
"9714","San Benito County",1996-09-01,45,3,62,7,117
"9715","San Benito County",1996-10-01,63,36,5,3,107
"9716","San Benito County",1996-11-01,66,3,41,2,112
"9717","San Benito County",1996-12-01,54,39,5,2,100
"9718","San Benito County",1997-01-01,35,6,55,5,101
"9719","San Benito County",1997-02-01,58,5,39,3,105
"9720","San Benito County",1997-03-01,40,5,48,4,97
"9721","San Benito County",1997-04-01,42,7,53,6,108
"9722","San Benito County",1997-05-01,42,5,54,5,106
"9723","San Benito County",1997-06-01,36,6,42,3,87
"9724","San Benito County",1997-07-01,40,6,46,4,96
"9725","San Benito County",1997-08-01,43,6,47,5,101
"9726","San Benito County",1997-09-01,48,7,54,3,112
"9727","San Benito County",1997-10-01,44,3,52,3,102
"9728","San Benito County",1997-11-01,36,2,46,5,89
"9729","San Benito County",1997-12-01,40,1,50,5,96
"9730","San Benito County",1998-01-01,39,5,55,5,104
"9731","San Benito County",1998-02-01,42,5,55,3,105
"9732","San Benito County",1998-03-01,37,5,59,7,108
"9733","San Benito County",1998-04-01,41,4,59,7,111
"9734","San Benito County",1998-05-01,46,5,54,9,114
"9735","San Benito County",1998-06-01,42,5,47,8,102
"9736","San Benito County",1998-07-01,41,6,47,7,101
"9737","San Benito County",1998-08-01,42,5,53,7,107
"9738","San Benito County",1998-09-01,43,4,50,5,102
"9739","San Benito County",1998-10-01,48,3,45,6,102
"9740","San Benito County",1998-11-01,43,4,50,1,98
"9741","San Benito County",1998-12-01,43,3,46,4,96
"9742","San Benito County",1999-01-01,36,5,48,6,95
"9743","San Benito County",1999-02-01,36,4,41,4,85
"9744","San Benito County",1999-03-01,42,4,46,2,94
"9745","San Benito County",1999-04-01,41,4,56,4,105
"9746","San Benito County",1999-05-01,44,3,54,5,106
"9747","San Benito County",1999-06-01,53,3,46,4,106
"9748","San Benito County",1999-07-01,56,2,50,3,111
"9749","San Benito County",1999-08-01,56,3,49,3,111
"9750","San Benito County",1999-09-01,60,4,45,5,114
"9751","San Benito County",1999-10-01,61,4,39,5,109
"9752","San Benito County",1999-11-01,53,3,38,4,98
"9753","San Benito County",1999-12-01,50,6,36,4,96
"9754","San Benito County",2000-01-01,48,4,38,6,96
"9755","San Benito County",2000-02-01,55,4,33,9,101
"9756","San Benito County",2000-03-01,53,4,36,6,99
"9757","San Benito County",2000-04-01,55,4,40,2,101
"9758","San Benito County",2000-05-01,60,7,38,3,108
"9759","San Benito County",2000-06-01,64,9,36,4,113
"9760","San Benito County",2000-07-01,60,7,38,4,109
"9761","San Benito County",2000-08-01,54,6,32,5,97
"9762","San Benito County",2000-09-01,47,4,35,7,93
"9763","San Benito County",2000-10-01,51,6,42,4,103
"9764","San Benito County",2000-11-01,49,4,50,4,107
"9765","San Benito County",2000-12-01,45,5,43,3,96
"9766","San Benito County",2001-01-01,47,6,35,2,90
"9767","San Benito County",2001-02-01,44,5,36,3,88
"9768","San Benito County",2001-03-01,46,7,38,6,97
"9769","San Benito County",2001-04-01,55,8,32,5,100
"9770","San Benito County",2001-05-01,58,9,30,6,103
"9771","San Benito County",2001-06-01,59,11,34,6,110
"9772","San Benito County",2001-07-01,65,12,30,5,112
"9773","San Benito County",2001-08-01,59,10,24,5,98
"9774","San Benito County",2001-09-01,60,6,26,7,99
"9775","San Benito County",2001-10-01,70,5,34,2,111
"9776","San Benito County",2001-11-01,58,4,35,3,100
"9777","San Benito County",2001-12-01,43,3,43,2,91
"9778","San Benito County",2002-01-01,48,6,42,5,101
"9779","San Benito County",2002-02-01,59,8,32,2,101
"9780","San Benito County",2002-03-01,61,11,34,2,108
"9781","San Benito County",2002-04-01,62,7,36,7,112
"9782","San Benito County",2002-05-01,61,6,38,5,110
"9783","San Benito County",2002-06-01,54,2,48,4,108
"9784","San Benito County",2002-07-01,52,3,45,3,103
"9785","San Benito County",2002-08-01,57,3,46,5,111
"9786","San Benito County",2002-09-01,63,7,40,5,115
"9787","San Benito County",2002-10-01,63,8,41,6,118
"9788","San Benito County",2002-11-01,66,5,42,5,118
"9789","San Benito County",2002-12-01,54,7,47,2,110
"9790","San Benito County",2003-01-01,47,6,51,4,108
"9791","San Benito County",2003-02-01,45,6,51,4,106
"9792","San Benito County",2003-03-01,40,5,41,2,88
"9793","San Benito County",2003-04-01,45,4,46,3,98
"9794","San Benito County",2003-05-01,50,3,49,5,107
"9795","San Benito County",2003-06-01,52,4,44,7,107
"9796","San Benito County",2003-07-01,53,5,48,7,113
"9797","San Benito County",2003-08-01,52,7,52,9,120
"9798","San Benito County",2003-09-01,56,6,53,10,125
"9799","San Benito County",2003-10-01,55,9,47,6,117
"9800","San Benito County",2003-11-01,53,6,46,6,111
"9801","San Benito County",2003-12-01,50,7,46,5,108
"9802","San Benito County",2004-01-01,55,8,47,6,116
"9803","San Benito County",2004-02-01,61,9,49,4,123
"9804","San Benito County",2004-03-01,65,8,42,4,119
"9805","San Benito County",2004-04-01,73,8,43,3,127
"9806","San Benito County",2004-05-01,71,8,33,5,117
"9807","San Benito County",2004-06-01,69,10,41,4,124
"9808","San Benito County",2004-07-01,76,12,40,3,131
"9809","San Benito County",2004-08-01,70,10,44,5,129
"9810","San Benito County",2004-09-01,69,9,45,6,129
"9811","San Benito County",2004-10-01,65,12,47,5,129
"9812","San Benito County",2004-11-01,68,12,38,4,122
"9813","San Benito County",2004-12-01,64,8,38,4,114
"9814","San Benito County",2005-01-01,80,8,37,4,129
"9815","San Benito County",2005-02-01,80,9,35,4,128
"9816","San Benito County",2005-03-01,70,7,42,5,124
"9817","San Benito County",2005-04-01,63,9,43,5,120
"9818","San Benito County",2005-05-01,68,10,36,6,120
"9819","San Benito County",2005-06-01,60,8,46,8,122
"9820","San Benito County",2005-07-01,78,8,38,6,130
"9821","San Benito County",2005-08-01,68,6,41,10,125
"9822","San Benito County",2005-09-01,60,8,48,7,123
"9823","San Benito County",2005-10-01,62,6,47,10,125
"9824","San Benito County",2005-11-01,63,7,51,8,129
"9825","San Benito County",2005-12-01,67,9,47,8,131
"9826","San Benito County",2006-01-01,72,7,47,5,131
"9827","San Benito County",2006-02-01,59,6,46,6,117
"9828","San Benito County",2006-03-01,60,6,47,9,122
"9829","San Benito County",2006-04-01,50,6,58,11,125
"9830","San Benito County",2006-05-01,54,6,50,12,122
"9831","San Benito County",2006-06-01,42,3,49,11,105
"9832","San Benito County",2006-07-01,66,9,44,5,124
"9833","San Benito County",2006-08-01,68,9,48,6,131
"9834","San Benito County",2006-09-01,66,9,49,6,130
"9835","San Benito County",2006-10-01,60,6,49,10,125
"9836","San Benito County",2006-11-01,61,8,47,6,122
"9837","San Benito County",2006-12-01,55,5,42,7,109
"9838","San Benito County",2007-01-01,62,9,51,5,127
"9839","San Benito County",2007-02-01,54,9,43,4,110
"9840","San Benito County",2007-03-01,68,6,42,4,120
"9841","San Benito County",2007-04-01,67,9,44,7,127
"9842","San Benito County",2007-05-01,69,12,43,6,130
"9843","San Benito County",2007-06-01,58,9,43,7,117
"9844","San Benito County",2007-07-01,60,8,32,7,107
"9845","San Benito County",2007-08-01,72,7,36,5,120
"9846","San Benito County",2007-09-01,68,7,43,4,122
"9847","San Benito County",2007-10-01,59,10,40,4,113
"9848","San Benito County",2007-11-01,56,11,42,4,113
"9849","San Benito County",2007-12-01,58,12,38,4,112
"9850","San Benito County",2008-01-01,51,9,45,5,110
"9851","San Benito County",2008-02-01,48,6,37,7,98
"9852","San Benito County",2008-03-01,60,6,49,6,121
"9853","San Benito County",2008-04-01,61,4,50,7,122
"9854","San Benito County",2008-05-01,66,4,50,8,128
"9855","San Benito County",2008-06-01,67,7,46,6,126
"9856","San Benito County",2008-07-01,73,7,34,7,121
"9857","San Benito County",2008-08-01,75,7,37,8,127
"9858","San Benito County",2008-09-01,76,9,31,6,122
"9859","San Benito County",2008-10-01,66,6,46,7,125
"9860","San Benito County",2008-11-01,60,6,41,9,116
"9861","San Benito County",2008-12-01,66,13,43,6,128
"9862","San Benito County",2009-01-01,73,14,41,4,132
"9863","San Benito County",2009-02-01,67,12,42,5,126
"9864","San Benito County",2009-03-01,64,12,44,5,125
"9865","San Benito County",2009-04-01,57,10,44,7,118
"9866","San Benito County",2009-05-01,65,10,39,6,120
"9867","San Benito County",2009-06-01,63,12,42,5,122
"9868","San Benito County",2009-07-01,71,11,35,8,125
"9869","San Benito County",2009-08-01,70,9,38,9,126
"9870","San Benito County",2009-09-01,80,11,27,5,123
"9871","San Benito County",2009-10-01,78,15,30,4,127
"9872","San Benito County",2009-11-01,72,16,28,3,119
"9873","San Benito County",2009-12-01,69,12,35,4,120
"9874","San Benito County",2010-01-01,59,9,37,5,110
"9875","San Benito County",2010-02-01,51,8,34,4,97
"9876","San Benito County",2010-03-01,66,14,35,5,120
"9877","San Benito County",2010-04-01,72,16,33,6,127
"9878","San Benito County",2010-05-01,75,11,33,8,127
"9879","San Benito County",2010-06-01,77,11,29,3,120
"9880","San Benito County",2010-07-01,85,14,30,4,133
"9881","San Benito County",2010-08-01,79,10,31,6,126
"9882","San Benito County",2010-09-01,77,11,36,7,131
"9883","San Benito County",2010-10-01,90,11,29,4,134
"9884","San Benito County",2010-11-01,82,9,35,7,133
"9885","San Benito County",2010-12-01,73,13,33,6,125
"9886","San Benito County",2011-01-01,72,14,42,5,133
"9887","San Benito County",2011-02-01,68,10,38,7,123
"9888","San Benito County",2011-03-01,72,10,33,5,120
"9889","San Benito County",2011-04-01,72,13,36,5,126
"9890","San Benito County",2011-05-01,73,10,37,8,128
"9891","San Benito County",2011-06-01,75,8,39,6,128
"9892","San Benito County",2011-07-01,74,7,41,6,128
"9893","San Benito County",2011-08-01,82,11,35,4,132
"9894","San Benito County",2011-09-01,85,15,35,4,139
"9895","San Benito County",2011-10-01,84,13,35,4,136
"9896","San Benito County",2011-11-01,83,14,38,4,139
"9897","San Benito County",2011-12-01,75,14,35,5,129
"9898","San Benito County",2012-01-01,71,14,41,6,132
"9899","San Benito County",2012-02-01,77,15,41,8,141
"9900","San Benito County",2012-03-01,69,13,44,8,134
"9901","San Benito County",2012-04-01,67,13,50,7,137
"9902","San Benito County",2012-05-01,66,15,44,6,131
"9903","San Benito County",2012-06-01,61,15,45,5,126
"9904","San Benito County",2012-07-01,68,13,45,7,133
"9905","San Benito County",2012-08-01,63,8,47,9,127
"9906","San Benito County",2012-09-01,71,16,35,7,129
"9907","San Benito County",2012-10-01,67,14,44,10,135
"9908","San Benito County",2012-11-01,71,15,43,8,137
"9909","San Benito County",2012-12-01,72,14,40,6,132
"9910","San Benito County",2013-01-01,58,11,45,8,122
"9911","San Benito County",2013-02-01,56,14,43,9,122
"9912","San Benito County",2013-03-01,50,13,41,8,112
"9913","San Benito County",2013-04-01,61,12,39,6,118
"9914","San Benito County",2013-05-01,66,8,36,7,117
"9915","San Benito County",2013-06-01,67,8,30,9,114
"9916","San Benito County",2013-07-01,72,13,30,8,123
"9917","San Benito County",2013-08-01,66,14,36,8,124
"9918","San Benito County",2013-09-01,71,15,28,9,123
"9919","San Benito County",2013-10-01,73,13,29,11,126
"9920","San Benito County",2013-11-01,84,11,22,14,131
"9921","San Benito County",2013-12-01,78,8,20,12,118
"9922","San Benito County",2014-01-01,81,13,25,8,127
"9923","San Benito County",2014-02-01,66,13,36,8,123
"9924","San Benito County",2014-03-01,72,15,35,9,131
"9925","San Benito County",2014-04-01,74,11,30,11,126
"9926","San Benito County",2014-05-01,71,15,30,9,125
"9927","San Benito County",2014-06-01,77,11,24,10,122
"9928","San Benito County",2014-07-01,86,13,28,8,135
"9929","San Benito County",2014-08-01,98,15,24,7,144
"9930","San Benito County",2014-09-01,95,28,15,8,146
"9931","San Benito County",2014-10-01,100,14,24,8,146
"9932","San Benito County",2014-11-01,89,12,22,8,131
"9933","San Benito County",2014-12-01,81,11,22,10,124
"9934","San Benito County",2015-01-01,82,11,18,10,121
"9935","San Benito County",2015-02-01,87,14,19,7,127
"9936","San Benito County",2015-03-01,97,10,24,7,138
"9937","San Benito County",2015-04-01,92,13,27,4,136
"9938","San Benito County",2015-05-01,77,10,23,7,117
"9939","San Benito County",2015-06-01,63,11,27,5,106
"9940","San Benito County",2015-07-01,68,11,25,6,110
"9941","San Benito County",2015-08-01,69,11,28,6,114
"9942","San Benito County",2015-09-01,81,9,22,5,117
"9943","San Benito County",2015-10-01,86,12,25,6,129
"9944","San Benito County",2015-11-01,90,13,24,7,134
"9945","San Benito County",2015-12-01,87,12,26,6,131
"9946","San Benito County",2016-01-01,69,8,31,9,117
"9947","San Benito County",2016-02-01,74,9,27,7,117
"9948","San Benito County",2016-03-01,66,15,33,6,120
"9949","San Benito County",2016-04-01,64,13,34,7,118
"9950","San Benito County",2016-05-01,65,15,32,6,118
"9951","San Benito County",2016-06-01,75,14,25,5,119
"9952","San Benito County",2016-07-01,74,15,22,6,117
"9953","San Benito County",2016-08-01,82,15,28,6,131
"9954","San Benito County",2016-09-01,76,14,35,5,130
"9955","San Benito County",2016-10-01,80,14,30,6,130
"9956","San Benito County",2016-11-01,65,16,32,7,120
"9957","San Benito County",2016-12-01,69,11,27,9,116
"9958","San Benito County",2017-01-01,77,13,18,6,114
"9959","San Benito County",2017-02-01,87,12,26,4,129
"9960","San Benito County",2017-03-01,76,15,29,5,125
"9961","San Benito County",2017-04-01,78,13,30,8,129
"9962","San Benito County",2017-05-01,84,11,25,10,130
"9963","San Benito County",2017-06-01,84,13,35,6,138
"9964","San Benito County",2017-07-01,85,17,28,5,135
"9965","San Benito County",2017-08-01,76,12,32,8,128
"9966","San Benito County",2017-09-01,73,9,37,9,128
"9967","San Benito County",2017-10-01,75,8,36,9,128
"9968","San Benito County",2017-11-01,68,10,36,9,123
"9969","San Benito County",2017-12-01,77,12,31,8,128
"9970","San Benito County",2018-01-01,74,13,37,10,134
"9971","San Benito County",2018-02-01,65,11,41,11,128
"9972","San Benito County",2018-03-01,59,11,39,10,119
"9973","San Benito County",2018-04-01,68,12,42,11,133
"9974","San Benito County",2018-05-01,73,14,38,8,133
"9975","San Benito County",2018-06-01,72,12,42,7,133
"9976","San Benito County",2018-07-01,70,13,42,7,132
"9977","San Benito County",2018-08-01,75,10,34,6,125
"9978","San Benito County",2018-09-01,73,14,29,5,121
"9979","San Benito County",2018-10-01,77,13,33,5,128
"9980","San Benito County",2018-11-01,73,7,32,8,120
"9981","San Benito County",2018-12-01,63,7,35,8,113
"9982","San Benito County",2019-01-01,60,8,37,8,113
"9983","San Benito County",2019-02-01,66,8,35,6,115
"9984","San Benito County",2019-03-01,66,8,39,6,119
"9985","San Benito County",2019-04-01,64,9,36,6,115
"9986","San Benito County",2019-05-01,66,9,31,9,115
"9987","San Benito County",2019-06-01,72,7,33,6,118
"9988","San Benito County",2019-07-01,71,8,35,4,118
"9989","San Benito County",2019-08-01,71,7,40,3,121
"9990","San Benito County",2019-09-01,64,9,41,5,119
"9991","San Benito County",2019-10-01,70,13,37,5,125
"9992","San Benito County",2019-11-01,70,13,36,5,124
"9993","San Benito County",2019-12-01,67,15,33,6,121
"9994","San Benito County",2020-01-01,64,12,37,7,120
"9995","San Benito County",2020-02-01,69,12,38,8,127
"9996","San Benito County",2020-03-01,62,6,31,9,108
"9997","San Bernardino County",1995-10-01,1947,268,1925,323,4463
"9998","San Bernardino County",1995-11-01,2349,303,1306,249,4207
"9999","San Bernardino County",1995-12-01,2242,272,1154,199,3867
"10000","San Bernardino County",1996-01-01,2328,282,1170,178,3958
"10001","San Bernardino County",1996-02-01,2290,258,1098,165,3811
"10002","San Bernardino County",1996-03-01,2336,262,1272,219,4089
"10003","San Bernardino County",1996-04-01,2108,338,1431,256,4133
"10004","San Bernardino County",1996-05-01,2377,340,1273,252,4242
"10005","San Bernardino County",1996-06-01,2287,314,1216,268,4085
"10006","San Bernardino County",1996-07-01,2291,296,1177,279,4043
"10007","San Bernardino County",1996-08-01,2320,295,1208,263,4086
"10008","San Bernardino County",1996-09-01,2358,324,1197,231,4110
"10009","San Bernardino County",1996-10-01,2431,303,1138,211,4083
"10010","San Bernardino County",1996-11-01,2516,308,1070,203,4097
"10011","San Bernardino County",1996-12-01,2606,304,975,190,4075
"10012","San Bernardino County",1997-01-01,2711,357,927,165,4160
"10013","San Bernardino County",1997-02-01,2900,394,1060,201,4555
"10014","San Bernardino County",1997-03-01,2943,437,1108,209,4697
"10015","San Bernardino County",1997-04-01,2926,415,1130,217,4688
"10016","San Bernardino County",1997-05-01,2952,436,1122,225,4735
"10017","San Bernardino County",1997-06-01,2950,398,1130,222,4700
"10018","San Bernardino County",1997-07-01,2739,377,1142,231,4489
"10019","San Bernardino County",1997-08-01,2873,402,1206,228,4709
"10020","San Bernardino County",1997-09-01,2987,425,1228,252,4892
"10021","San Bernardino County",1997-10-01,2941,446,1265,284,4936
"10022","San Bernardino County",1997-11-01,2997,458,1218,240,4913
"10023","San Bernardino County",1997-12-01,2943,440,1106,202,4691
"10024","San Bernardino County",1998-01-01,2991,425,1053,207,4676
"10025","San Bernardino County",1998-02-01,3113,447,1165,227,4952
"10026","San Bernardino County",1998-03-01,3112,444,1229,253,5038
"10027","San Bernardino County",1998-04-01,3113,452,1265,295,5125
"10028","San Bernardino County",1998-05-01,3057,477,1326,307,5167
"10029","San Bernardino County",1998-06-01,3117,518,1301,279,5215
"10030","San Bernardino County",1998-07-01,3070,496,1257,265,5088
"10031","San Bernardino County",1998-08-01,3157,507,1207,266,5137
"10032","San Bernardino County",1998-09-01,3176,511,1195,264,5146
"10033","San Bernardino County",1998-10-01,3085,457,1162,257,4961
"10034","San Bernardino County",1998-11-01,3132,442,1137,245,4956
"10035","San Bernardino County",1998-12-01,3027,421,1051,223,4722
"10036","San Bernardino County",1999-01-01,3060,449,1059,209,4777
"10037","San Bernardino County",1999-02-01,3041,456,1089,225,4811
"10038","San Bernardino County",1999-03-01,3091,475,1113,231,4910
"10039","San Bernardino County",1999-04-01,3750,590,447,114,4901
"10040","San Bernardino County",1999-05-01,3109,479,1069,236,4893
"10041","San Bernardino County",1999-06-01,3014,459,1070,238,4781
"10042","San Bernardino County",1999-07-01,3064,466,1095,255,4880
"10043","San Bernardino County",1999-08-01,3112,489,1154,247,5002
"10044","San Bernardino County",1999-09-01,3103,482,1195,252,5032
"10045","San Bernardino County",1999-10-01,3148,511,1207,264,5130
"10046","San Bernardino County",1999-11-01,3152,489,1154,268,5063
"10047","San Bernardino County",1999-12-01,3093,464,1046,242,4845
"10048","San Bernardino County",2000-01-01,3222,483,1020,235,4960
"10049","San Bernardino County",2000-02-01,3232,474,1075,246,5027
"10050","San Bernardino County",2000-03-01,3316,513,1077,262,5168
"10051","San Bernardino County",2000-04-01,3270,507,1143,271,5191
"10052","San Bernardino County",2000-05-01,3201,500,1178,246,5125
"10053","San Bernardino County",2000-06-01,3158,627,1167,121,5073
"10054","San Bernardino County",2000-07-01,3151,514,1216,241,5122
"10055","San Bernardino County",2000-08-01,3104,496,1230,240,5070
"10056","San Bernardino County",2000-09-01,3116,466,1209,270,5061
"10057","San Bernardino County",2000-10-01,3242,467,1216,301,5226
"10058","San Bernardino County",2000-11-01,3103,467,1196,322,5088
"10059","San Bernardino County",2000-12-01,3094,466,1109,285,4954
"10060","San Bernardino County",2001-01-01,3159,442,1076,275,4952
"10061","San Bernardino County",2001-02-01,3207,466,1136,254,5063
"10062","San Bernardino County",2001-03-01,3285,472,1196,278,5231
"10063","San Bernardino County",2001-04-01,3273,470,1189,292,5224
"10064","San Bernardino County",2001-05-01,3166,463,1173,282,5084
"10065","San Bernardino County",2001-06-01,3191,460,1148,271,5070
"10066","San Bernardino County",2001-07-01,3295,430,1113,267,5105
"10067","San Bernardino County",2001-08-01,3188,424,1062,232,4906
"10068","San Bernardino County",2001-09-01,3208,430,996,234,4868
"10069","San Bernardino County",2001-10-01,3145,427,1030,246,4848
"10070","San Bernardino County",2001-11-01,3084,437,983,208,4712
"10071","San Bernardino County",2001-12-01,3058,426,926,185,4595
"10072","San Bernardino County",2002-01-01,3205,417,975,203,4800
"10073","San Bernardino County",2002-02-01,3277,443,1015,226,4961
"10074","San Bernardino County",2002-03-01,3203,472,1077,245,4997
"10075","San Bernardino County",2002-04-01,3147,491,1107,236,4981
"10076","San Bernardino County",2002-05-01,3184,489,1274,252,5199
"10077","San Bernardino County",2002-06-01,3173,483,1193,250,5099
"10078","San Bernardino County",2002-07-01,3208,484,1158,249,5099
"10079","San Bernardino County",2002-08-01,3246,472,1190,271,5179
"10080","San Bernardino County",2002-09-01,3238,458,1136,256,5088
"10081","San Bernardino County",2002-10-01,3203,450,1180,244,5077
"10082","San Bernardino County",2002-11-01,3100,452,1171,234,4957
"10083","San Bernardino County",2002-12-01,3141,437,1099,221,4898
"10084","San Bernardino County",2003-01-01,3353,450,1045,215,5063
"10085","San Bernardino County",2003-02-01,3420,469,1103,226,5218
"10086","San Bernardino County",2003-03-01,3421,464,1093,227,5205
"10087","San Bernardino County",2003-04-01,3400,432,1175,244,5251
"10088","San Bernardino County",2003-05-01,3150,455,1160,257,5022
"10089","San Bernardino County",2003-06-01,3476,478,1184,267,5405
"10090","San Bernardino County",2003-07-01,3391,463,1194,279,5327
"10091","San Bernardino County",2003-08-01,3444,473,1189,270,5376
"10092","San Bernardino County",2003-09-01,3299,489,1225,264,5277
"10093","San Bernardino County",2003-10-01,3338,502,1152,225,5217
"10094","San Bernardino County",2003-11-01,3369,496,1100,241,5206
"10095","San Bernardino County",2003-12-01,3334,495,1043,230,5102
"10096","San Bernardino County",2004-01-01,3436,477,1089,228,5230
"10097","San Bernardino County",2004-02-01,3434,475,1107,231,5247
"10098","San Bernardino County",2004-03-01,3484,468,1152,239,5343
"10099","San Bernardino County",2004-04-01,3483,488,1182,271,5424
"10100","San Bernardino County",2004-05-01,3411,492,1179,287,5369
"10101","San Bernardino County",2004-06-01,3503,499,1210,282,5494
"10102","San Bernardino County",2004-07-01,3491,485,1206,272,5454
"10103","San Bernardino County",2004-08-01,3501,506,1159,275,5441
"10104","San Bernardino County",2004-09-01,3625,485,1136,284,5530
"10105","San Bernardino County",2004-10-01,3476,527,1107,275,5385
"10106","San Bernardino County",2004-11-01,3454,521,1063,265,5303
"10107","San Bernardino County",2004-12-01,3364,494,1028,268,5154
"10108","San Bernardino County",2005-01-01,3414,542,1036,257,5249
"10109","San Bernardino County",2005-02-01,3416,499,1036,259,5210
"10110","San Bernardino County",2005-03-01,3644,534,1077,244,5499
"10111","San Bernardino County",2005-04-01,3644,510,1092,247,5493
"10112","San Bernardino County",2005-05-01,3622,542,1131,256,5551
"10113","San Bernardino County",2005-06-01,3688,546,1174,276,5684
"10114","San Bernardino County",2005-07-01,3674,556,1147,273,5650
"10115","San Bernardino County",2005-08-01,3760,537,1146,294,5737
"10116","San Bernardino County",2005-09-01,3804,570,1123,292,5789
"10117","San Bernardino County",2005-10-01,3703,517,1133,297,5650
"10118","San Bernardino County",2005-11-01,3364,407,1072,292,5135
"10119","San Bernardino County",2005-12-01,3315,422,967,245,4949
"10120","San Bernardino County",2006-01-01,3626,422,956,222,5226
"10121","San Bernardino County",2006-02-01,3832,607,927,245,5611
"10122","San Bernardino County",2006-03-01,3832,607,927,245,5611
"10123","San Bernardino County",2006-04-01,3516,533,1074,254,5377
"10124","San Bernardino County",2006-05-01,3666,504,1097,261,5528
"10125","San Bernardino County",2006-06-01,3485,502,1168,263,5418
"10126","San Bernardino County",2006-07-01,3570,516,1149,286,5521
"10127","San Bernardino County",2006-08-01,3576,513,1111,305,5505
"10128","San Bernardino County",2006-09-01,3510,528,1128,303,5469
"10129","San Bernardino County",2006-10-01,3563,540,1148,289,5540
"10130","San Bernardino County",2006-11-01,3536,529,784,282,5131
"10131","San Bernardino County",2006-12-01,3235,498,1395,310,5438
"10132","San Bernardino County",2007-01-01,3625,559,1055,260,5499
"10133","San Bernardino County",2007-02-01,3638,537,1089,255,5519
"10134","San Bernardino County",2007-03-01,3745,542,1025,257,5569
"10135","San Bernardino County",2007-04-01,3637,533,1067,244,5481
"10136","San Bernardino County",2007-05-01,3727,537,1081,232,5577
"10137","San Bernardino County",2007-06-01,3707,529,1057,240,5533
"10138","San Bernardino County",2007-07-01,3761,559,1020,236,5576
"10139","San Bernardino County",2007-08-01,3741,562,1064,234,5601
"10140","San Bernardino County",2007-09-01,3744,569,1033,235,5581
"10141","San Bernardino County",2007-10-01,3680,571,1054,229,5534
"10142","San Bernardino County",2007-11-01,3742,549,977,239,5507
"10143","San Bernardino County",2007-12-01,3702,542,971,236,5451
"10144","San Bernardino County",2008-01-01,3738,556,901,228,5423
"10145","San Bernardino County",2008-02-01,3583,549,939,232,5303
"10146","San Bernardino County",2008-03-01,3742,556,1012,240,5550
"10147","San Bernardino County",2008-04-01,3632,562,1033,247,5474
"10148","San Bernardino County",2008-05-01,3582,566,1091,247,5486
"10149","San Bernardino County",2008-06-01,3633,566,1104,247,5550
"10150","San Bernardino County",2008-07-01,3673,538,1095,257,5563
"10151","San Bernardino County",2008-08-01,3586,564,1078,267,5495
"10152","San Bernardino County",2008-09-01,3761,584,1066,270,5681
"10153","San Bernardino County",2008-10-01,3669,560,1063,256,5548
"10154","San Bernardino County",2008-11-01,3676,562,1029,246,5513
"10155","San Bernardino County",2008-12-01,3680,529,978,224,5411
"10156","San Bernardino County",2009-01-01,3783,570,982,232,5567
"10157","San Bernardino County",2009-02-01,3888,572,1016,235,5711
"10158","San Bernardino County",2009-03-01,3922,556,1057,234,5769
"10159","San Bernardino County",2009-04-01,3935,580,1105,226,5846
"10160","San Bernardino County",2009-05-01,3867,589,1061,251,5768
"10161","San Bernardino County",2009-06-01,3933,584,1061,250,5828
"10162","San Bernardino County",2009-07-01,3904,580,1084,258,5826
"10163","San Bernardino County",2009-08-01,4000,579,1084,239,5902
"10164","San Bernardino County",2009-09-01,4013,579,1145,248,5985
"10165","San Bernardino County",2009-10-01,4083,590,1092,246,6011
"10166","San Bernardino County",2009-11-01,3901,600,1048,265,5814
"10167","San Bernardino County",2009-12-01,3776,601,1014,238,5629
"10168","San Bernardino County",2010-01-01,3769,753,867,253,5642
"10169","San Bernardino County",2010-02-01,3894,735,684,182,5495
"10170","San Bernardino County",2010-03-01,3845,755,694,200,5494
"10171","San Bernardino County",2010-04-01,3794,741,703,201,5439
"10172","San Bernardino County",2010-05-01,3844,759,733,190,5526
"10173","San Bernardino County",2010-06-01,3925,803,722,202,5652
"10174","San Bernardino County",2010-07-01,3988,816,714,209,5727
"10175","San Bernardino County",2010-08-01,3993,812,734,238,5777
"10176","San Bernardino County",2010-09-01,3891,790,742,218,5641
"10177","San Bernardino County",2010-10-01,3919,762,784,236,5701
"10178","San Bernardino County",2010-11-01,3768,741,767,244,5520
"10179","San Bernardino County",2010-12-01,3663,681,727,204,5275
"10180","San Bernardino County",2011-01-01,3811,524,751,180,5266
"10181","San Bernardino County",2011-02-01,3769,552,802,181,5304
"10182","San Bernardino County",2011-03-01,3675,543,797,179,5194
"10183","San Bernardino County",2011-04-01,3691,626,728,171,5216
"10184","San Bernardino County",2011-05-01,3708,540,828,185,5261
"10185","San Bernardino County",2011-06-01,3740,551,762,184,5237
"10186","San Bernardino County",2011-07-01,3935,579,793,191,5498
"10187","San Bernardino County",2011-08-01,3910,567,830,200,5507
"10188","San Bernardino County",2011-09-01,3889,556,837,215,5497
"10189","San Bernardino County",2011-10-01,3755,528,865,193,5341
"10190","San Bernardino County",2011-11-01,3599,483,972,194,5248
"10191","San Bernardino County",2011-12-01,3519,542,970,218,5249
"10192","San Bernardino County",2012-01-01,3618,499,1072,171,5360
"10193","San Bernardino County",2012-02-01,3643,492,1020,176,5331
"10194","San Bernardino County",2012-03-01,3678,469,1066,175,5388
"10195","San Bernardino County",2012-04-01,3601,478,1167,187,5433
"10196","San Bernardino County",2012-05-01,3605,464,1112,176,5357
"10197","San Bernardino County",2012-06-01,3716,452,1046,159,5373
"10198","San Bernardino County",2012-07-01,3726,425,1042,225,5418
"10199","San Bernardino County",2012-08-01,3746,480,1145,181,5552
"10200","San Bernardino County",2012-09-01,3743,494,1085,158,5480
"10201","San Bernardino County",2012-10-01,3743,480,1193,160,5576
"10202","San Bernardino County",2012-11-01,3741,481,1214,192,5628
"10203","San Bernardino County",2012-12-01,3668,487,1290,179,5624
"10204","San Bernardino County",2013-01-01,3744,509,1294,163,5710
"10205","San Bernardino County",2013-02-01,3827,520,1231,173,5751
"10206","San Bernardino County",2013-03-01,3826,515,1264,180,5785
"10207","San Bernardino County",2013-04-01,3813,596,1347,169,5925
"10208","San Bernardino County",2013-05-01,3797,530,1471,160,5958
"10209","San Bernardino County",2013-06-01,3882,549,1383,138,5952
"10210","San Bernardino County",2013-07-01,3787,548,1390,145,5870
"10211","San Bernardino County",2013-08-01,3733,541,1414,221,5909
"10212","San Bernardino County",2013-09-01,3855,555,1330,233,5973
"10213","San Bernardino County",2013-10-01,3827,449,1340,191,5807
"10214","San Bernardino County",2013-11-01,3837,556,1301,181,5875
"10215","San Bernardino County",2013-12-01,3772,512,1220,185,5689
"10216","San Bernardino County",2014-01-01,3869,512,1215,183,5779
"10217","San Bernardino County",2014-02-01,3860,509,1159,206,5734
"10218","San Bernardino County",2014-03-01,3908,487,1113,211,5719
"10219","San Bernardino County",2014-04-01,3880,547,1179,175,5781
"10220","San Bernardino County",2014-05-01,3808,554,1194,206,5762
"10221","San Bernardino County",2014-06-01,3762,533,1240,212,5747
"10222","San Bernardino County",2014-07-01,3856,538,1201,215,5810
"10223","San Bernardino County",2014-08-01,3920,543,1179,198,5840
"10224","San Bernardino County",2014-09-01,3844,519,1125,182,5670
"10225","San Bernardino County",2014-10-01,3765,603,1074,226,5668
"10226","San Bernardino County",2014-11-01,3523,572,1106,250,5451
"10227","San Bernardino County",2014-12-01,3284,553,1138,223,5198
"10228","San Bernardino County",2015-01-01,3304,577,1110,223,5214
"10229","San Bernardino County",2015-02-01,3350,592,1105,239,5286
"10230","San Bernardino County",2015-03-01,3337,583,1045,232,5197
"10231","San Bernardino County",2015-04-01,3292,563,1014,227,5096
"10232","San Bernardino County",2015-05-01,3325,546,964,233,5068
"10233","San Bernardino County",2015-06-01,3427,566,932,231,5156
"10234","San Bernardino County",2015-07-01,3561,546,916,249,5272
"10235","San Bernardino County",2015-08-01,3537,562,893,241,5233
"10236","San Bernardino County",2015-09-01,3544,578,928,230,5280
"10237","San Bernardino County",2015-10-01,3621,589,831,204,5245
"10238","San Bernardino County",2015-11-01,3541,577,868,225,5211
"10239","San Bernardino County",2015-12-01,3454,556,855,209,5074
"10240","San Bernardino County",2016-01-01,3471,554,884,206,5115
"10241","San Bernardino County",2016-02-01,3521,589,883,248,5241
"10242","San Bernardino County",2016-03-01,3382,589,1006,209,5186
"10243","San Bernardino County",2016-04-01,3421,588,969,208,5186
"10244","San Bernardino County",2016-05-01,3575,484,1079,183,5321
"10245","San Bernardino County",2016-06-01,3713,624,958,231,5526
"10246","San Bernardino County",2016-07-01,3734,618,890,213,5455
"10247","San Bernardino County",2016-08-01,3693,627,934,217,5471
"10248","San Bernardino County",2016-09-01,3761,643,936,235,5575
"10249","San Bernardino County",2016-10-01,3828,617,967,242,5654
"10250","San Bernardino County",2016-11-01,3774,591,936,248,5549
"10251","San Bernardino County",2016-12-01,3687,623,970,222,5502
"10252","San Bernardino County",2017-01-01,3589,604,1026,235,5454
"10253","San Bernardino County",2017-02-01,3613,618,1070,245,5546
"10254","San Bernardino County",2017-03-01,3490,599,1153,264,5506
"10255","San Bernardino County",2017-04-01,3510,619,1159,261,5549
"10256","San Bernardino County",2017-05-01,3565,624,1169,283,5641
"10257","San Bernardino County",2017-06-01,3571,625,1158,272,5626
"10258","San Bernardino County",2017-07-01,3601,611,1140,263,5615
"10259","San Bernardino County",2017-08-01,3562,610,1207,294,5673
"10260","San Bernardino County",2017-09-01,3557,572,1191,303,5623
"10261","San Bernardino County",2017-10-01,3424,572,1217,290,5503
"10262","San Bernardino County",2017-11-01,3388,609,1181,253,5431
"10263","San Bernardino County",2017-12-01,3265,577,1218,256,5316
"10264","San Bernardino County",2018-01-01,3301,598,1229,253,5381
"10265","San Bernardino County",2018-02-01,3254,574,1272,268,5368
"10266","San Bernardino County",2018-03-01,3185,552,1267,286,5290
"10267","San Bernardino County",2018-04-01,3218,577,1281,281,5357
"10268","San Bernardino County",2018-05-01,3234,560,1313,262,5369
"10269","San Bernardino County",2018-06-01,3376,575,1268,255,5474
"10270","San Bernardino County",2018-07-01,3431,588,1275,243,5537
"10271","San Bernardino County",2018-08-01,3478,597,1338,248,5661
"10272","San Bernardino County",2018-09-01,3414,606,1329,250,5599
"10273","San Bernardino County",2018-10-01,3408,597,1364,246,5615
"10274","San Bernardino County",2018-11-01,3557,461,1366,225,5609
"10275","San Bernardino County",2018-12-01,3349,563,1315,231,5458
"10276","San Bernardino County",2019-01-01,3512,430,1267,215,5424
"10277","San Bernardino County",2019-02-01,3529,458,1291,202,5480
"10278","San Bernardino County",2019-03-01,3560,429,1312,190,5491
"10279","San Bernardino County",2019-04-01,3623,417,1296,207,5543
"10280","San Bernardino County",2019-05-01,3574,432,1317,202,5525
"10281","San Bernardino County",2019-06-01,3540,430,1343,190,5503
"10282","San Bernardino County",2019-07-01,3614,445,1272,183,5514
"10283","San Bernardino County",2019-08-01,3697,449,1290,206,5642
"10284","San Bernardino County",2019-09-01,3635,448,1318,203,5604
"10285","San Bernardino County",2019-10-01,3602,427,1265,194,5488
"10286","San Bernardino County",2019-11-01,3623,410,1206,209,5448
"10287","San Bernardino County",2019-12-01,3545,412,1182,194,5333
"10288","San Bernardino County",2020-01-01,3633,425,1158,189,5405
"10289","San Bernardino County",2020-02-01,3635,437,1243,191,5506
"10290","San Bernardino County",2020-03-01,3639,427,1173,186,5425
"10291","San Diego County",1995-10-01,2640,354,2313,346,5653
"10292","San Diego County",1995-11-01,2743,377,2294,315,5729
"10293","San Diego County",1995-12-01,2659,383,2154,298,5494
"10294","San Diego County",1996-01-01,2706,359,2063,336,5464
"10295","San Diego County",1996-02-01,2706,359,2171,336,5572
"10296","San Diego County",1996-03-01,2630,373,2412,321,5736
"10297","San Diego County",1996-04-01,2555,365,2172,335,5427
"10298","San Diego County",1996-05-01,2557,365,2162,332,5416
"10299","San Diego County",1996-06-01,2545,396,2179,325,5445
"10300","San Diego County",1996-07-01,2556,385,2311.07,361.74,5613.81
"10301","San Diego County",1996-08-01,2505,361,2349.97,371.16,5587.13
"10302","San Diego County",1996-09-01,2523,383,2313.53,357.07,5576.6
"10303","San Diego County",1996-10-01,2579,392,2346.07,365.03,5682.1
"10304","San Diego County",1996-11-01,2609,419,2296.14,374.97,5699.11
"10305","San Diego County",1996-12-01,2634,380,2247.51,348.35,5609.86
"10306","San Diego County",1997-01-01,2629,387,2277.45,349.26,5642.71
"10307","San Diego County",1997-02-01,2712,427,2377.36,364.21,5880.57
"10308","San Diego County",1997-03-01,2732,413,2431.91,378.45,5955.36
"10309","San Diego County",1997-04-01,2594.87,412,2480.66,386.9,5874.43
"10310","San Diego County",1997-05-01,2581.9,376,2519.93,394.55,5872.38
"10311","San Diego County",1997-06-01,2558.1,548.33,2303.44,386,5795.87
"10312","San Diego County",1997-07-01,2575.19,426.23,2435.13,413.23,5849.78
"10313","San Diego County",1997-08-01,2616.19,379,2415.65,449.74,5860.58
"10314","San Diego County",1997-09-01,2647.32,384,2345.93,409.7,5786.95
"10315","San Diego County",1997-10-01,2597.9,399,2567.68,429.1,5993.68
"10316","San Diego County",1997-11-01,2627.63,423,2461.7,442.77,5955.1
"10317","San Diego County",1997-12-01,2645.48,446,2393,420,5904.48
"10318","San Diego County",1998-01-01,2652.13,412,2446.81,411.04,5921.98
"10319","San Diego County",1998-02-01,2736.25,414,2486.14,433.32,6069.71
"10320","San Diego County",1998-03-01,2675.87,437,2544.22,454.62,6111.71
"10321","San Diego County",1998-04-01,2600.17,406.73,2520.67,444.77,5972.34
"10322","San Diego County",1998-05-01,2615.52,408,2520.93,400.74,5945.19
"10323","San Diego County",1998-06-01,2741.63,436.83,2504.8,412.77,6096.03
"10324","San Diego County",1998-07-01,2702,513.81,2320.93,388.32,5925.06
"10325","San Diego County",1998-08-01,2906,407,2628.23,370.23,6311.46
"10326","San Diego County",1998-09-01,2564.27,409,2411,359.87,5744.14
"10327","San Diego County",1998-10-01,2539,419,2373.05,375.44,5706.49
"10328","San Diego County",1998-11-01,2539.52,419.39,2342.67,376.48,5678.06
"10329","San Diego County",1998-12-01,2583,384,2301.83,392.8,5661.63
"10330","San Diego County",1999-01-01,2545,390,2181.83,360.42,5477.25
"10331","San Diego County",1999-02-01,2544.21,390.96,2236.79,371.14,5543.1
"10332","San Diego County",1999-03-01,2550.1,413.55,2215.71,494.9,5674.26
"10333","San Diego County",1999-04-01,2418.4,358.73,2169.96,412.17,5359.26
"10334","San Diego County",1999-05-01,2390.06,381,2098.39,403.29,5272.74
"10335","San Diego County",1999-06-01,2504,403,1901,351,5159
"10336","San Diego County",1999-07-01,2481,413,2215,383,5492
"10337","San Diego County",1999-08-01,2387,432,2227,370,5416
"10338","San Diego County",1999-09-01,2410,445,2147,372,5374
"10339","San Diego County",1999-10-01,2392,415,2076,365,5248
"10340","San Diego County",1999-11-01,2031,391,2342,394,5158
"10341","San Diego County",1999-12-01,2301.5,383,1947,356.5,4988
"10342","San Diego County",2000-01-01,2340,417,1905,337,4999
"10343","San Diego County",2000-02-01,2446,451,1951,352,5200
"10344","San Diego County",2000-03-01,2380,433,2080,381,5274
"10345","San Diego County",2000-04-01,2387,419,2153,395,5354
"10346","San Diego County",2000-05-01,2604,427,1902,371,5304
"10347","San Diego County",2000-06-01,2348,447,2107,375,5277
"10348","San Diego County",2000-07-01,2352,431,2027,353,5163
"10349","San Diego County",2000-08-01,2396,424,1965,351,5136
"10350","San Diego County",2000-09-01,2472,436,1948,352,5208
"10351","San Diego County",2000-10-01,2385,418,2023,364,5190
"10352","San Diego County",2000-11-01,2355,390,1956,324,5025
"10353","San Diego County",2000-12-01,2321,391,1767,296,4775
"10354","San Diego County",2001-01-01,2304,377,1757,289,4727
"10355","San Diego County",2001-02-01,2363,390,1825,309,4887
"10356","San Diego County",2001-03-01,2282,398,1946,331,4957
"10357","San Diego County",2001-04-01,2220,398,1957,363,4938
"10358","San Diego County",2001-05-01,2270,413,1912,341,4936
"10359","San Diego County",2001-06-01,2265,400,1923,346,4934
"10360","San Diego County",2001-07-01,2229,387,1762,317,4695
"10361","San Diego County",2001-08-01,2304,427,1757,305,4793
"10362","San Diego County",2001-09-01,2366,448,1819,316,4949
"10363","San Diego County",2001-10-01,2343,433,1866,319,4961
"10364","San Diego County",2001-11-01,2416,426,1869,313,5024
"10365","San Diego County",2001-12-01,2306,410,1842,299,4857
"10366","San Diego County",2002-01-01,2436,396,1812,295,4939
"10367","San Diego County",2002-02-01,2403,386,1767,291,4847
"10368","San Diego County",2002-03-01,2393,393,1806,302,4894
"10369","San Diego County",2002-04-01,2628,403,1616,295,4942
"10370","San Diego County",2002-05-01,2626,395,1627,288,4936
"10371","San Diego County",2002-06-01,2567,406,1685,257,4915
"10372","San Diego County",2002-07-01,2451,383,1719,277,4830
"10373","San Diego County",2002-08-01,2492,390,1736,270,4888
"10374","San Diego County",2002-09-01,2566,398,1703,275,4942
"10375","San Diego County",2002-10-01,2553,419,1728,290,4990
"10376","San Diego County",2002-11-01,2587,422,1708,301,5018
"10377","San Diego County",2002-12-01,2526,390,1695,301,4912
"10378","San Diego County",2003-01-01,2469,405,1631,285,4790
"10379","San Diego County",2003-02-01,2541,425,1684,279,4929
"10380","San Diego County",2003-03-01,2624,464,1654,291,5033
"10381","San Diego County",2003-04-01,2540,461,1726,286,5013
"10382","San Diego County",2003-05-01,2571,432,1736,291,5030
"10383","San Diego County",2003-06-01,2757,480,1742,285,5264
"10384","San Diego County",2003-07-01,2740,439,1796,285,5260
"10385","San Diego County",2003-08-01,2768,350,1812,247,5177
"10386","San Diego County",2003-09-01,2635,441,1787,291,5154
"10387","San Diego County",2003-10-01,2701,448,1738,271,5158
"10388","San Diego County",2003-11-01,2716,438,1709,254,5117
"10389","San Diego County",2003-12-01,2695,447,1592,244,4978
"10390","San Diego County",2004-01-01,2797,502,1613,242,5154
"10391","San Diego County",2004-02-01,2951,512,1587,252,5302
"10392","San Diego County",2004-03-01,2936,524,1668,280,5408
"10393","San Diego County",2004-04-01,2833,507,1815,325,5480
"10394","San Diego County",2004-05-01,2805,485,1827,339,5456
"10395","San Diego County",2004-06-01,2823,477,1865,348,5513
"10396","San Diego County",2004-07-01,2744,479,1867,373,5463
"10397","San Diego County",2004-08-01,2765,493,1878,366,5502
"10398","San Diego County",2004-09-01,2816,480,1895,363,5554
"10399","San Diego County",2004-10-01,2850,487,1683,322,5342
"10400","San Diego County",2004-11-01,2924,503,1645,300,5372
"10401","San Diego County",2004-12-01,2855,490,1570,324,5239
"10402","San Diego County",2005-01-01,2910,484,1599,316,5309
"10403","San Diego County",2005-02-01,2985,507,1648,309,5449
"10404","San Diego County",2005-03-01,2949,473,1751,314,5487
"10405","San Diego County",2005-04-01,2858,439,1788,334,5419
"10406","San Diego County",2005-05-01,2864,474,1805,333,5476
"10407","San Diego County",2005-06-01,2883,497,1792,325,5497
"10408","San Diego County",2005-07-01,2894,487,1791,326,5498
"10409","San Diego County",2005-08-01,2917,490,1783,359,5549
"10410","San Diego County",2005-09-01,2963,528,1832,376,5699
"10411","San Diego County",2005-10-01,2972,492,1817,361,5642
"10412","San Diego County",2005-11-01,2988,500,1766,357,5611
"10413","San Diego County",2005-12-01,2880,443,1727,353,5403
"10414","San Diego County",2006-01-01,2856,472,1710,344,5382
"10415","San Diego County",2006-02-01,2862,485,1740,361,5448
"10416","San Diego County",2006-03-01,2818,467,1811,375,5471
"10417","San Diego County",2006-04-01,2755,475,1752,380,5362
"10418","San Diego County",2006-05-01,2737,504,1717,374,5332
"10419","San Diego County",2006-06-01,2711,482,1721,378,5292
"10420","San Diego County",2006-07-01,2735,471,1641,401,5248
"10421","San Diego County",2006-08-01,2785,479,1654,397,5315
"10422","San Diego County",2006-09-01,2847,486,1646,390,5369
"10423","San Diego County",2006-10-01,2890,495,1673,383,5441
"10424","San Diego County",2006-11-01,2988,512,1697,383,5580
"10425","San Diego County",2006-12-01,2941,491,1655,380,5467
"10426","San Diego County",2007-01-01,2878,470,1616,360,5324
"10427","San Diego County",2007-02-01,2876,481,1574,355,5286
"10428","San Diego County",2007-03-01,2872,477,1558,346,5253
"10429","San Diego County",2007-04-01,2823,467,1568,332,5190
"10430","San Diego County",2007-05-01,2825,480,1502,312,5119
"10431","San Diego County",2007-06-01,2853,477,1599,311,5240
"10432","San Diego County",2007-07-01,2846,497,1683,343,5369
"10433","San Diego County",2007-08-01,2828,484,1752,373,5437
"10434","San Diego County",2007-09-01,2917,476,1803,387,5583
"10435","San Diego County",2007-10-01,2926,469,1803,359,5557
"10436","San Diego County",2007-11-01,2879,464,1726,351,5420
"10437","San Diego County",2007-12-01,2857,461,1664,359,5341
"10438","San Diego County",2008-01-01,2805,470,1650,360,5285
"10439","San Diego County",2008-02-01,2870,471,1691,368,5400
"10440","San Diego County",2008-03-01,2881,470,1728,397,5476
"10441","San Diego County",2008-04-01,2953,468,1709,409,5539
"10442","San Diego County",2008-05-01,2848,485,1752,411,5496
"10443","San Diego County",2008-06-01,2812,480,1721,398,5411
"10444","San Diego County",2008-07-01,2838,489,1713,383,5423
"10445","San Diego County",2008-08-01,2882,475,1744,399,5500
"10446","San Diego County",2008-09-01,3001,494,1690,402,5587
"10447","San Diego County",2008-10-01,2916,474,1703,406,5499
"10448","San Diego County",2008-11-01,2849,457,1720,377,5403
"10449","San Diego County",2008-12-01,2732,447,1665,370,5214
"10450","San Diego County",2009-01-01,2780,438,1577,356,5151
"10451","San Diego County",2009-02-01,2918,473,1595,360,5346
"10452","San Diego County",2009-03-01,2936,471,1632,360,5399
"10453","San Diego County",2009-04-01,2929,422,1679,351,5381
"10454","San Diego County",2009-05-01,2946,441,1734,355,5476
"10455","San Diego County",2009-06-01,2762,439,1779,331,5311
"10456","San Diego County",2009-07-01,2823,448,1686,327,5284
"10457","San Diego County",2009-08-01,2746,447,1655,332,5180
"10458","San Diego County",2009-09-01,2750,442,1619,343,5154
"10459","San Diego County",2009-10-01,2768,423,1559,362,5112
"10460","San Diego County",2009-11-01,2779,399,1574,340,5092
"10461","San Diego County",2009-12-01,2663,385,1496,322,4866
"10462","San Diego County",2010-01-01,2373,389,1777,297,4836
"10463","San Diego County",2010-02-01,2722,424,1230,257,4633
"10464","San Diego County",2010-03-01,2311,384,1689,322,4706
"10465","San Diego County",2010-04-01,2780,411,1339,302,4832
"10466","San Diego County",2010-05-01,2724,401,1424,329,4878
"10467","San Diego County",2010-06-01,2756,426,1430,334,4946
"10468","San Diego County",2010-07-01,2722,401,1469,326,4918
"10469","San Diego County",2010-08-01,2706,409,1472,311,4898
"10470","San Diego County",2010-09-01,2729,435,1487,321,4972
"10471","San Diego County",2010-10-01,2731,440,1474,317,4962
"10472","San Diego County",2010-11-01,2696,426,1413,312,4847
"10473","San Diego County",2010-12-01,2611,395,1371,303,4680
"10474","San Diego County",2011-01-01,2672,409,1434,301,4816
"10475","San Diego County",2011-02-01,2572,416,1625,296,4909
"10476","San Diego County",2011-03-01,2581,396,1671,310,4958
"10477","San Diego County",2011-04-01,2508,369,1629,331,4837
"10478","San Diego County",2011-05-01,2447,371,1677,319,4814
"10479","San Diego County",2011-06-01,2418,354,1666,333,4771
"10480","San Diego County",2011-07-01,2470,382,1675,322,4849
"10481","San Diego County",2011-08-01,2461,405,1594,327,4787
"10482","San Diego County",2011-09-01,2444,407,1646,359,4856
"10483","San Diego County",2011-10-01,2426,410,1705,400,4941
"10484","San Diego County",2011-11-01,2349,388,1822,398,4957
"10485","San Diego County",2011-12-01,2361,384,1874,374,4993
"10486","San Diego County",2012-01-01,2469,399,1840,376,5084
"10487","San Diego County",2012-02-01,2460,387,1853,389,5089
"10488","San Diego County",2012-03-01,2438,378,1996,422,5234
"10489","San Diego County",2012-04-01,2444,386,2010,421,5261
"10490","San Diego County",2012-05-01,2365,371,2046,444,5226
"10491","San Diego County",2012-06-01,2440,407,2033,444,5324
"10492","San Diego County",2012-07-01,2521,415,2010,436,5382
"10493","San Diego County",2012-08-01,2530,392,1949,437,5308
"10494","San Diego County",2012-09-01,2565,417,2045,417,5444
"10495","San Diego County",2012-10-01,2536,404,2059,433,5432
"10496","San Diego County",2012-11-01,2571,400,2016,418,5405
"10497","San Diego County",2012-12-01,2513,392,2010,402,5317
"10498","San Diego County",2013-01-01,2545,411,2045,426,5427
"10499","San Diego County",2013-02-01,2611,397,2106,458,5572
"10500","San Diego County",2013-03-01,2656,410,2111,445,5622
"10501","San Diego County",2013-04-01,2655,442,2115,419,5631
"10502","San Diego County",2013-05-01,2658,461,2150,443,5712
"10503","San Diego County",2013-06-01,2700,460,2193,445,5798
"10504","San Diego County",2013-07-01,2723,472,2290,483,5968
"10505","San Diego County",2013-08-01,2693,476,2362,468,5999
"10506","San Diego County",2013-09-01,2700,488,2404,485,6077
"10507","San Diego County",2013-10-01,2717,479,2406,489,6091
"10508","San Diego County",2013-11-01,2723,439,2491,488,6141
"10509","San Diego County",2013-12-01,2601,419,2528,468,6016
"10510","San Diego County",2014-01-01,2588,430,2498,484,6000
"10511","San Diego County",2014-02-01,2599,447,2585,503,6134
"10512","San Diego County",2014-03-01,2516,436,2531,525,6008
"10513","San Diego County",2014-04-01,2519,443,2520,523,6005
"10514","San Diego County",2014-05-01,2526,451,2526,518,6021
"10515","San Diego County",2014-06-01,2682,478,2424,513,6097
"10516","San Diego County",2014-07-01,2634,486,2464,535,6119
"10517","San Diego County",2014-08-01,2668,489,2449,536,6142
"10518","San Diego County",2014-09-01,2677,481,2459,569,6186
"10519","San Diego County",2014-10-01,2630,477,2443,568,6118
"10520","San Diego County",2014-11-01,2484,417,2375,541,5817
"10521","San Diego County",2014-12-01,2246,353,2284,500,5383
"10522","San Diego County",2015-01-01,2146,340,2160,485,5131
"10523","San Diego County",2015-02-01,2269,366,2133,440,5208
"10524","San Diego County",2015-03-01,2207,368,2077,462,5114
"10525","San Diego County",2015-04-01,2258,370,2075,464,5167
"10526","San Diego County",2015-05-01,2233,367,2109,472,5181
"10527","San Diego County",2015-06-01,2194,369,2241,477,5281
"10528","San Diego County",2015-07-01,2285,404,2023,385,5097
"10529","San Diego County",2015-08-01,2340,412,1980,391,5123
"10530","San Diego County",2015-09-01,2327,423,2056,388,5194
"10531","San Diego County",2015-10-01,2347,441,2101,413,5302
"10532","San Diego County",2015-11-01,2263,395,2300,539,5497
"10533","San Diego County",2015-12-01,2156,369,2271,538,5334
"10534","San Diego County",2016-01-01,2206,383,2152,512,5253
"10535","San Diego County",2016-02-01,2319,409,2180,488,5396
"10536","San Diego County",2016-03-01,2357,404,2224,511,5496
"10537","San Diego County",2016-04-01,2351,410,2280,493,5534
"10538","San Diego County",2016-05-01,2412,433,2320,503,5669
"10539","San Diego County",2016-06-01,2343,426,2420,502,5691
"10540","San Diego County",2016-07-01,2383,440,2416,514,5753
"10541","San Diego County",2016-08-01,2398,450,2415,520,5783
"10542","San Diego County",2016-09-01,2554,460,2439,518,5971
"10543","San Diego County",2016-10-01,2501,495,2467,487,5950
"10544","San Diego County",2016-11-01,2474,428,2506,519,5928
"10545","San Diego County",2016-12-01,2488,428,2427,503,5846
"10546","San Diego County",2017-01-01,2559,438,2386,511,5894
"10547","San Diego County",2017-02-01,2637,443,2380,506,5966
"10548","San Diego County",2017-03-01,2580,426,2458,507,5971
"10549","San Diego County",2017-04-01,2557,440,2481,477,5955
"10550","San Diego County",2017-05-01,2500,468,2542,522,6032
"10551","San Diego County",2017-06-01,2539,461,2541,515,6056
"10552","San Diego County",2017-07-01,2624,479,2391,503,5997
"10553","San Diego County",2017-08-01,2634,479,2398,497,6008
"10554","San Diego County",2017-09-01,2609,492,2379,516,5996
"10555","San Diego County",2017-10-01,2531,477,2427,517,5952
"10556","San Diego County",2017-11-01,2463,461,2493,499,5916
"10557","San Diego County",2017-12-01,2387,420,2419,477,5703
"10558","San Diego County",2018-01-01,2395,430,2433,482,5740
"10559","San Diego County",2018-02-01,2457,436,2518,509,5920
"10560","San Diego County",2018-03-01,2433,437,2577,484,5931
"10561","San Diego County",2018-04-01,2376,430,2551,471,5828
"10562","San Diego County",2018-05-01,2277,429,2552,456,5714
"10563","San Diego County",2018-06-01,2342,459,2471,455,5727
"10564","San Diego County",2018-07-01,2402,478,2341,456,5677
"10565","San Diego County",2018-08-01,2493,465,2363,485,5806
"10566","San Diego County",2018-09-01,2477,483,2427,485,5872
"10567","San Diego County",2018-10-01,2504,493,2420,480,5897
"10568","San Diego County",2018-11-01,2531,483,2459,463,5936
"10569","San Diego County",2018-12-01,2472,451,2396,464,5783
"10570","San Diego County",2019-01-01,2553,436,2314,475,5778
"10571","San Diego County",2019-02-01,2555,471,2408,476,5910
"10572","San Diego County",2019-03-01,2553,474,2475,509,6011
"10573","San Diego County",2019-04-01,2610,480,2471,506,6067
"10574","San Diego County",2019-05-01,2598,464,2545,516,6123
"10575","San Diego County",2019-06-01,2628,472,2431,497,6028
"10576","San Diego County",2019-07-01,2655,452,2384,498,5989
"10577","San Diego County",2019-08-01,2641,466,2452,505,6064
"10578","San Diego County",2019-09-01,2607,479,2446,504,6036
"10579","San Diego County",2019-10-01,2579,446,2430,516,5971
"10580","San Diego County",2019-11-01,2512,410,2337,510,5769
"10581","San Diego County",2019-12-01,2466,398,2251,464,5579
"10582","San Diego County",2020-01-01,2504,403,2297,453,5657
"10583","San Diego County",2020-02-01,2555,441,2314,475,5785
"10584","San Diego County",2020-03-01,2496,427,2097,456,5476
"10585","San Francisco County",1995-10-01,1285,168,353,62,1868
"10586","San Francisco County",1995-11-01,1323,159,367,51,1900
"10587","San Francisco County",1995-12-01,1403,166,300,40,1909
"10588","San Francisco County",1996-01-01,1345,182,361,69,1957
"10589","San Francisco County",1996-02-01,1313,195,379,77,1964
"10590","San Francisco County",1996-03-01,1250,196,380,80,1906
"10591","San Francisco County",1996-04-01,1268,199,382,81,1930
"10592","San Francisco County",1996-05-01,1285,200,385,81,1951
"10593","San Francisco County",1996-06-01,1269,196,377,76,1918
"10594","San Francisco County",1996-07-01,511,73,1101,264,1949
"10595","San Francisco County",1996-08-01,570,67,1118,152,1907
"10596","San Francisco County",1996-09-01,719,94,1039,144,1996
"10597","San Francisco County",1996-10-01,641,78,1134,154,2007
"10598","San Francisco County",1996-11-01,712,80,1061,142,1995
"10599","San Francisco County",1996-12-01,705,80,1050,146,1981
"10600","San Francisco County",1997-01-01,1352,136,442,85,2015
"10601","San Francisco County",1997-02-01,1353,136,441,85,2015
"10602","San Francisco County",1997-03-01,1329,126,453,79,1987
"10603","San Francisco County",1997-04-01,1098,127,444,70,1739
"10604","San Francisco County",1997-05-01,1042,122,517,92,1773
"10605","San Francisco County",1997-06-01,1062,136,473,69,1740
"10606","San Francisco County",1997-07-01,1060,127,472,83,1742
"10607","San Francisco County",1997-08-01,1063,129,415,76,1683
"10608","San Francisco County",1997-09-01,1103,147,388,79,1717
"10609","San Francisco County",1997-10-01,1151,129,418,94,1792
"10610","San Francisco County",1997-11-01,937,458,292,164,1851
"10611","San Francisco County",1997-12-01,1199,277,289,62,1827
"10612","San Francisco County",1998-01-01,1238,140,471,75,1924
"10613","San Francisco County",1998-02-01,1185,134,469,84,1872
"10614","San Francisco County",1998-03-01,1139,143,459,86,1827
"10615","San Francisco County",1998-04-01,1222,139,532,88,1981
"10616","San Francisco County",1998-05-01,1210,136,564,97,2007
"10617","San Francisco County",1998-06-01,1255,145,498,87,1985
"10618","San Francisco County",1998-07-01,1292,159,488,76,2015
"10619","San Francisco County",1998-08-01,1357,159,560,86,2162
"10620","San Francisco County",1998-09-01,1330,169,487,79,2065
"10621","San Francisco County",1998-10-01,1387,175,516,83,2161
"10622","San Francisco County",1998-11-01,1398,170,504,84,2156
"10623","San Francisco County",1998-12-01,1325,151,471,91,2038
"10624","San Francisco County",1999-01-01,1339,139,480,88,2046
"10625","San Francisco County",1999-02-01,1387,120,486,80,2073
"10626","San Francisco County",1999-03-01,1359,141,503,89,2092
"10627","San Francisco County",1999-04-01,1384,148,486,91,2109
"10628","San Francisco County",1999-05-01,1423,157,467,88,2135
"10629","San Francisco County",1999-06-01,1426,184,481,82,2173
"10630","San Francisco County",1999-07-01,1398,179,488,78,2143
"10631","San Francisco County",1999-08-01,1371,174,482,70,2097
"10632","San Francisco County",1999-09-01,1413,161,472,82,2128
"10633","San Francisco County",1999-10-01,1398,185,473,78,2134
"10634","San Francisco County",1999-11-01,1450,173,447,78,2148
"10635","San Francisco County",1999-12-01,1381,165,423,75,2044
"10636","San Francisco County",2000-01-01,1390,259,453,75,2114
"10637","San Francisco County",2000-02-01,1776,265,106,13,2160
"10638","San Francisco County",2000-03-01,1657,243,136,17,2053
"10639","San Francisco County",2000-04-01,1555,227,147,24,1953
"10640","San Francisco County",2000-05-01,1509,226,137,28,1900
"10641","San Francisco County",2000-06-01,1471,187,158,28,1844
"10642","San Francisco County",2000-07-01,1378,178,175,24,1755
"10643","San Francisco County",2000-08-01,1316,183,187,27,1713
"10644","San Francisco County",2000-09-01,1336,188,213,29,1766
"10645","San Francisco County",2000-10-01,1326,181,209,40,1756
"10646","San Francisco County",2000-11-01,1310,193,224,34,1761
"10647","San Francisco County",2000-12-01,1289,177,223,31,1720
"10648","San Francisco County",2001-01-01,1286,201,227,27,1741
"10649","San Francisco County",2001-02-01,1495,221,92,12,1820
"10650","San Francisco County",2001-03-01,1513,223,126,20,1882
"10651","San Francisco County",2001-04-01,1541,226,146,22,1935
"10652","San Francisco County",2001-05-01,1378,209,126,27,1740
"10653","San Francisco County",2001-06-01,1358,174,149,24,1705
"10654","San Francisco County",2001-07-01,1402,182,178,24,1786
"10655","San Francisco County",2001-08-01,1391,196,202,24,1813
"10656","San Francisco County",2001-09-01,1336,188,214,28,1766
"10657","San Francisco County",2001-10-01,1446,198,229,39,1912
"10658","San Francisco County",2001-11-01,1415,209,242,37,1903
"10659","San Francisco County",2001-12-01,1425,196,248,31,1900
"10660","San Francisco County",2002-01-01,1660,240,123,7,2030
"10661","San Francisco County",2002-02-01,1451,197,322,62,2032
"10662","San Francisco County",2002-03-01,1457,190,328,70,2045
"10663","San Francisco County",2002-04-01,1492,207,339,68,2106
"10664","San Francisco County",2002-05-01,1489,222,319,67,2097
"10665","San Francisco County",2002-06-01,1475,197,354,66,2092
"10666","San Francisco County",2002-07-01,1475,194,355,66,2090
"10667","San Francisco County",2002-08-01,1489,177,350,66,2082
"10668","San Francisco County",2002-09-01,1641,229,259,34,2163
"10669","San Francisco County",2002-10-01,1667,222,270,34,2193
"10670","San Francisco County",2002-11-01,1579,181,383,72,2215
"10671","San Francisco County",2002-12-01,1581,181,361,67,2190
"10672","San Francisco County",2003-01-01,1535,182,375,72,2164
"10673","San Francisco County",2003-02-01,1489,180,400,86,2155
"10674","San Francisco County",2003-03-01,1403,166,395,78,2042
"10675","San Francisco County",2003-04-01,1333,152,367,66,1918
"10676","San Francisco County",2003-05-01,1303,153,391,63,1910
"10677","San Francisco County",2003-06-01,1298,154,396,65,1913
"10678","San Francisco County",2003-07-01,1304,135,395,65,1899
"10679","San Francisco County",2003-08-01,1300,150,362,56,1868
"10680","San Francisco County",2003-09-01,1370,157,338,56,1921
"10681","San Francisco County",2003-10-01,1366,151,341,57,1915
"10682","San Francisco County",2003-11-01,1299,140,352,69,1860
"10683","San Francisco County",2003-12-01,1249,141,343,51,1784
"10684","San Francisco County",2004-01-01,1276,139,318,55,1788
"10685","San Francisco County",2004-02-01,1295,145,309,56,1805
"10686","San Francisco County",2004-03-01,1287,155,318,60,1820
"10687","San Francisco County",2004-04-01,1243,181,315,64,1803
"10688","San Francisco County",2004-05-01,1212,152,328,61,1753
"10689","San Francisco County",2004-06-01,1162,127,344,56,1689
"10690","San Francisco County",2004-07-01,1151,144,334,51,1680
"10691","San Francisco County",2004-08-01,1198,146,331,51,1726
"10692","San Francisco County",2004-09-01,1215,172,321,57,1765
"10693","San Francisco County",2004-10-01,1218,141,361,57,1777
"10694","San Francisco County",2004-11-01,1258,159,328,64,1809
"10695","San Francisco County",2004-12-01,1238,148,337,64,1787
"10696","San Francisco County",2005-01-01,1230,150,328,64,1772
"10697","San Francisco County",2005-02-01,1243,151,330,54,1778
"10698","San Francisco County",2005-03-01,1246,167,341,57,1811
"10699","San Francisco County",2005-04-01,1234,162,361,61,1818
"10700","San Francisco County",2005-05-01,1269,147,353,74,1843
"10701","San Francisco County",2005-06-01,1231,153,340,51,1775
"10702","San Francisco County",2005-07-01,1198,143,333,55,1729
"10703","San Francisco County",2005-08-01,1196,155,342,53,1746
"10704","San Francisco County",2005-09-01,1206,164,330,40,1740
"10705","San Francisco County",2005-10-01,1250,164,313,39,1766
"10706","San Francisco County",2005-11-01,1290,154,322,52,1818
"10707","San Francisco County",2005-12-01,1271,140,323,47,1781
"10708","San Francisco County",2006-01-01,1262,147,331,45,1785
"10709","San Francisco County",2006-02-01,1334,156,325,47,1862
"10710","San Francisco County",2006-03-01,1311,164,306,45,1826
"10711","San Francisco County",2006-04-01,1264,152,300,49,1765
"10712","San Francisco County",2006-05-01,1265,169,320,60,1814
"10713","San Francisco County",2006-06-01,1295,170,360,56,1881
"10714","San Francisco County",2006-07-01,1318,162,358,51,1889
"10715","San Francisco County",2006-08-01,1319,159,376,54,1908
"10716","San Francisco County",2006-09-01,1295,164,402,59,1920
"10717","San Francisco County",2006-10-01,1308,156,407,61,1932
"10718","San Francisco County",2006-11-01,1349,173,387,66,1975
"10719","San Francisco County",2006-12-01,1320,163,373,55,1911
"10720","San Francisco County",2007-01-01,1333,176,379,56,1944
"10721","San Francisco County",2007-02-01,1321,194,385,56,1956
"10722","San Francisco County",2007-03-01,1286,184,375,52,1897
"10723","San Francisco County",2007-04-01,1297,178,371,53,1899
"10724","San Francisco County",2007-05-01,1340,176,396,24,1936
"10725","San Francisco County",2007-06-01,1298,23,546,53,1920
"10726","San Francisco County",2007-07-01,1286,196,408,20,1910
"10727","San Francisco County",2007-08-01,1365,204,362,57,1988
"10728","San Francisco County",2007-09-01,1432,192,354,54,2032
"10729","San Francisco County",2007-10-01,1418,180,358,60,2016
"10730","San Francisco County",2007-11-01,1437,193,345,60,2035
"10731","San Francisco County",2007-12-01,1426,192,352,55,2025
"10732","San Francisco County",2008-01-01,1456,203,366,60,2085
"10733","San Francisco County",2008-02-01,1477,209,345,58,2089
"10734","San Francisco County",2008-03-01,1506,213,366,62,2147
"10735","San Francisco County",2008-04-01,1440,200,386,64,2090
"10736","San Francisco County",2008-05-01,1409,199,382,68,2058
"10737","San Francisco County",2008-06-01,1343,173,371,77,1964
"10738","San Francisco County",2008-07-01,1327,181,329,72,1909
"10739","San Francisco County",2008-08-01,1335,164,338,71,1908
"10740","San Francisco County",2008-09-01,1401,175,316,72,1964
"10741","San Francisco County",2008-10-01,1449,184,308,69,2010
"10742","San Francisco County",2008-11-01,1435,182,320,69,2006
"10743","San Francisco County",2008-12-01,1414,162,308,69,1953
"10744","San Francisco County",2009-01-01,1379,156,313,70,1918
"10745","San Francisco County",2009-02-01,1376,156,318,64,1914
"10746","San Francisco County",2009-03-01,1380,160,317,60,1917
"10747","San Francisco County",2009-04-01,1385,165,299,66,1915
"10748","San Francisco County",2009-05-01,1336,162,292,66,1856
"10749","San Francisco County",2009-06-01,1313,169,288,57,1827
"10750","San Francisco County",2009-07-01,1330,162,294,57,1843
"10751","San Francisco County",2009-08-01,1402,175,303,50,1930
"10752","San Francisco County",2009-09-01,1528,213,302,56,2099
"10753","San Francisco County",2009-10-01,1441,205,296,65,2007
"10754","San Francisco County",2009-11-01,1493,205,282,62,2042
"10755","San Francisco County",2009-12-01,1430,198,280,62,1970
"10756","San Francisco County",2010-01-01,1446,193,299,58,1996
"10757","San Francisco County",2010-02-01,1425,184,297,55,1961
"10758","San Francisco County",2010-03-01,1395,159,324,60,1938
"10759","San Francisco County",2010-04-01,1248,147,256,44,1695
"10760","San Francisco County",2010-05-01,1148,158,236,47,1589
"10761","San Francisco County",2010-06-01,1182,156,247,46,1631
"10762","San Francisco County",2010-07-01,1204,156,252,46,1658
"10763","San Francisco County",2010-08-01,1227,151,261,43,1682
"10764","San Francisco County",2010-09-01,1291,150,252,39,1732
"10765","San Francisco County",2010-10-01,1298,154,253,49,1754
"10766","San Francisco County",2010-11-01,1300,140,239,43,1722
"10767","San Francisco County",2010-12-01,1269,139,246,44,1698
"10768","San Francisco County",2011-01-01,1251,155,257,47,1710
"10769","San Francisco County",2011-02-01,1315,139,267,41,1762
"10770","San Francisco County",2011-03-01,1277,123,274,46,1720
"10771","San Francisco County",2011-04-01,1234,119,250,35,1638
"10772","San Francisco County",2011-05-01,1155,116,236,34,1541
"10773","San Francisco County",2011-06-01,1137,108,230,32,1507
"10774","San Francisco County",2011-07-01,1083,132,222,12,1449
"10775","San Francisco County",2011-08-01,1047,111,223,32,1413
"10776","San Francisco County",2011-09-01,1038,118,221,34,1411
"10777","San Francisco County",2011-10-01,1081,110,218,33,1442
"10778","San Francisco County",2011-11-01,1140,96,232,29,1497
"10779","San Francisco County",2011-12-01,1164,101,196,31,1492
"10780","San Francisco County",2012-01-01,1188,118,201,36,1543
"10781","San Francisco County",2012-02-01,1203,170,211,40,1624
"10782","San Francisco County",2012-03-01,1165,115,251,43,1574
"10783","San Francisco County",2012-04-01,1190,118,200,35,1543
"10784","San Francisco County",2012-05-01,1180,118,200,35,1533
"10785","San Francisco County",2012-06-01,1126,110,230,32,1498
"10786","San Francisco County",2012-07-01,1125,133,233,9,1500
"10787","San Francisco County",2012-08-01,1125,111,239,19,1494
"10788","San Francisco County",2012-09-01,1106,104,263,41,1514
"10789","San Francisco County",2012-10-01,1141,105,229,32,1507
"10790","San Francisco County",2012-11-01,1153,103,236,31,1523
"10791","San Francisco County",2012-12-01,1172,93,200,29,1494
"10792","San Francisco County",2013-01-01,1164,103,198,31,1496
"10793","San Francisco County",2013-02-01,1121,106,230,32,1489
"10794","San Francisco County",2013-03-01,1110,103,239,38,1490
"10795","San Francisco County",2013-04-01,1162,113,192,33,1500
"10796","San Francisco County",2013-05-01,1120,123,247,27,1517
"10797","San Francisco County",2013-06-01,1071,110,257,27,1465
"10798","San Francisco County",2013-07-01,1063,133,212,9,1417
"10799","San Francisco County",2013-08-01,1001,113,209,19,1342
"10800","San Francisco County",2013-09-01,923,91,236,36,1286
"10801","San Francisco County",2013-10-01,969,99,192,30,1290
"10802","San Francisco County",2013-11-01,956,104,168,18,1246
"10803","San Francisco County",2013-12-01,932,94,165,16,1207
"10804","San Francisco County",2014-01-01,964,109,168,19,1260
"10805","San Francisco County",2014-02-01,991,106,174,19,1290
"10806","San Francisco County",2014-03-01,986,108,173,19,1286
"10807","San Francisco County",2014-04-01,964,105,170,19,1258
"10808","San Francisco County",2014-05-01,957,100,169,18,1244
"10809","San Francisco County",2014-06-01,961,101,170,18,1250
"10810","San Francisco County",2014-07-01,980,99,174,17,1270
"10811","San Francisco County",2014-08-01,974,100,172,18,1264
"10812","San Francisco County",2014-09-01,995,102,175,18,1290
"10813","San Francisco County",2014-10-01,977,105,173,19,1274
"10814","San Francisco County",2014-11-01,954,105,169,19,1247
"10815","San Francisco County",2014-12-01,865,92,152,16,1125
"10816","San Francisco County",2015-01-01,861,89,151,16,1117
"10817","San Francisco County",2015-02-01,893,88,158,15,1154
"10818","San Francisco County",2015-03-01,884,90,156,16,1146
"10819","San Francisco County",2015-04-01,891,83,157,15,1146
"10820","San Francisco County",2015-05-01,899,86,159,15,1159
"10821","San Francisco County",2015-06-01,920,88,163,16,1187
"10822","San Francisco County",2015-07-01,940,92,165,16,1213
"10823","San Francisco County",2015-08-01,939,94,167,17,1217
"10824","San Francisco County",2015-09-01,953,89,168,16,1226
"10825","San Francisco County",2015-10-01,955,97,168,17,1237
"10826","San Francisco County",2015-11-01,970,96,170,16,1252
"10827","San Francisco County",2015-12-01,933,97,165,17,1212
"10828","San Francisco County",2016-01-01,945,105,167,19,1236
"10829","San Francisco County",2016-02-01,975,111,171,20,1277
"10830","San Francisco County",2016-03-01,966,104,171,18,1259
"10831","San Francisco County",2016-04-01,950,100,168,18,1236
"10832","San Francisco County",2016-05-01,954,105,168,19,1246
"10833","San Francisco County",2016-06-01,975,105,172,18,1270
"10834","San Francisco County",2016-07-01,1010,110,177,19,1316
"10835","San Francisco County",2016-08-01,1014,114,179,20,1327
"10836","San Francisco County",2016-09-01,998,114,176,20,1308
"10837","San Francisco County",2016-10-01,1014,110,179,19,1322
"10838","San Francisco County",2016-11-01,1032,108,182,19,1341
"10839","San Francisco County",2016-12-01,998,115,177,20,1310
"10840","San Francisco County",2017-01-01,996,103,175,18,1292
"10841","San Francisco County",2017-02-01,978,90,172,16,1256
"10842","San Francisco County",2017-03-01,956,87,169,15,1227
"10843","San Francisco County",2017-04-01,978,94,173,17,1262
"10844","San Francisco County",2017-05-01,951,93,168,16,1228
"10845","San Francisco County",2017-06-01,944,91,168,16,1219
"10846","San Francisco County",2017-07-01,944,87,166,15,1212
"10847","San Francisco County",2017-08-01,983,87,174,15,1259
"10848","San Francisco County",2017-09-01,985,94,174,17,1270
"10849","San Francisco County",2017-10-01,994,89,176,16,1275
"10850","San Francisco County",2017-11-01,990,91,175,16,1272
"10851","San Francisco County",2017-12-01,990,90,175,16,1271
"10852","San Francisco County",2018-01-01,972,94,172,17,1255
"10853","San Francisco County",2018-02-01,989,95,175,17,1276
"10854","San Francisco County",2018-03-01,939,87,166,15,1207
"10855","San Francisco County",2018-04-01,944,95,167,17,1223
"10856","San Francisco County",2018-05-01,953,101,168,18,1240
"10857","San Francisco County",2018-06-01,957,98,169,17,1241
"10858","San Francisco County",2018-07-01,991,98,175,17,1281
"10859","San Francisco County",2018-08-01,1013,108,179,19,1319
"10860","San Francisco County",2018-09-01,978,122,173,22,1295
"10861","San Francisco County",2018-10-01,984,132,174,23,1313
"10862","San Francisco County",2018-11-01,1004,130,177,23,1334
"10863","San Francisco County",2018-12-01,1037,131,183,23,1374
"10864","San Francisco County",2019-01-01,1047,122,185,22,1376
"10865","San Francisco County",2019-02-01,1006,119,177,21,1323
"10866","San Francisco County",2019-03-01,966,103,170,18,1257
"10867","San Francisco County",2019-04-01,992,107,176,19,1294
"10868","San Francisco County",2019-05-01,987,112,228,20,1347
"10869","San Francisco County",2019-06-01,980,112,173,20,1285
"10870","San Francisco County",2019-07-01,961,109,169,19,1258
"10871","San Francisco County",2019-08-01,935,105,164,18,1222
"10872","San Francisco County",2019-09-01,953,111,168,20,1252
"10873","San Francisco County",2019-10-01,953,111,168,20,1252
"10874","San Francisco County",2019-11-01,945,100,167,18,1230
"10875","San Francisco County",2019-12-01,909,96,160,17,1182
"10876","San Francisco County",2020-01-01,901,88,159,15,1163
"10877","San Francisco County",2020-02-01,870,80,154,14,1118
"10878","San Francisco County",2020-03-01,774,70,136,12,992
"10879","San Joaquin County",1995-10-01,514,73,520,59,1166
"10880","San Joaquin County",1995-11-01,516,72,508,57,1153
"10881","San Joaquin County",1995-12-01,521,74,473,52,1120
"10882","San Joaquin County",1996-01-01,516,73,485,54,1128
"10883","San Joaquin County",1996-02-01,528,73,490,68,1159
"10884","San Joaquin County",1996-03-01,523,66,504,97,1190
"10885","San Joaquin County",1996-04-01,499,66,521,101,1187
"10886","San Joaquin County",1996-05-01,486,70,522,105,1183
"10887","San Joaquin County",1996-06-01,507,75,510,102,1194
"10888","San Joaquin County",1996-07-01,506,78,504,110,1198
"10889","San Joaquin County",1996-08-01,520,69,491,100,1180
"10890","San Joaquin County",1996-09-01,519,66,483,104,1172
"10891","San Joaquin County",1996-10-01,494,73,499,106,1172
"10892","San Joaquin County",1996-11-01,477,71,471,104,1123
"10893","San Joaquin County",1996-12-01,463,76,478,103,1120
"10894","San Joaquin County",1997-01-01,490,70,472,104,1136
"10895","San Joaquin County",1997-02-01,499,75,491,105,1170
"10896","San Joaquin County",1997-03-01,503,87,506,102,1198
"10897","San Joaquin County",1997-04-01,475,89,508,99,1171
"10898","San Joaquin County",1997-05-01,476,92,494,100,1162
"10899","San Joaquin County",1997-06-01,501,88,494,94,1177
"10900","San Joaquin County",1997-07-01,490,91,518,98,1197
"10901","San Joaquin County",1997-08-01,489,87,510,107,1193
"10902","San Joaquin County",1997-09-01,534,103,513,93,1243
"10903","San Joaquin County",1997-10-01,548,96,530,98,1272
"10904","San Joaquin County",1997-11-01,535,78,521,101,1235
"10905","San Joaquin County",1997-12-01,497,71,501,107,1176
"10906","San Joaquin County",1998-01-01,504,70,477,110,1161
"10907","San Joaquin County",1998-02-01,502,67,504,107,1180
"10908","San Joaquin County",1998-03-01,484,76,501,104,1165
"10909","San Joaquin County",1998-04-01,510,77,511,96,1194
"10910","San Joaquin County",1998-05-01,522,76,498,108,1204
"10911","San Joaquin County",1998-06-01,512,77,538,114,1241
"10912","San Joaquin County",1998-07-01,518,80,553,109,1260
"10913","San Joaquin County",1998-08-01,474,72,545,128,1219
"10914","San Joaquin County",1998-09-01,463,65,559,116,1203
"10915","San Joaquin County",1998-10-01,447,70,582,121,1220
"10916","San Joaquin County",1998-11-01,467,64,573,114,1218
"10917","San Joaquin County",1998-12-01,453,66,555,109,1183
"10918","San Joaquin County",1999-01-01,462,78,566,113,1219
"10919","San Joaquin County",1999-02-01,450,78,591,113,1232
"10920","San Joaquin County",1999-03-01,438,78,568,121,1205
"10921","San Joaquin County",1999-04-01,442,77,544,127,1190
"10922","San Joaquin County",1999-05-01,428,85,546,123,1182
"10923","San Joaquin County",1999-06-01,460,80,542,113,1195
"10924","San Joaquin County",1999-07-01,450,68,544,113,1175
"10925","San Joaquin County",1999-08-01,454,75,529,111,1169
"10926","San Joaquin County",1999-09-01,480,83,560,108,1231
"10927","San Joaquin County",1999-10-01,451,75,597,112,1235
"10928","San Joaquin County",1999-11-01,471,79,605,118,1273
"10929","San Joaquin County",1999-12-01,431,65,564,118,1178
"10930","San Joaquin County",2000-01-01,429,59,537,125,1150
"10931","San Joaquin County",2000-02-01,471,67,584,123,1245
"10932","San Joaquin County",2000-03-01,483,62,576,115,1236
"10933","San Joaquin County",2000-04-01,462,66,581,117,1226
"10934","San Joaquin County",2000-05-01,465,71,589,112,1237
"10935","San Joaquin County",2000-06-01,480,68,577,117,1242
"10936","San Joaquin County",2000-07-01,473,66,575,125,1239
"10937","San Joaquin County",2000-08-01,475,65,557,110,1207
"10938","San Joaquin County",2000-09-01,515,82,570,116,1283
"10939","San Joaquin County",2000-10-01,496,78,567,109,1250
"10940","San Joaquin County",2000-11-01,482,65,566,109,1222
"10941","San Joaquin County",2000-12-01,482,71,527,92,1172
"10942","San Joaquin County",2001-01-01,514,66,508,101,1189
"10943","San Joaquin County",2001-02-01,528,69,538,110,1245
"10944","San Joaquin County",2001-03-01,543,79,565,104,1291
"10945","San Joaquin County",2001-04-01,533,71,565,110,1279
"10946","San Joaquin County",2001-05-01,518,79,564,108,1269
"10947","San Joaquin County",2001-06-01,511,81,552,105,1249
"10948","San Joaquin County",2001-07-01,534,78,507,98,1217
"10949","San Joaquin County",2001-08-01,520,81,517,98,1216
"10950","San Joaquin County",2001-09-01,544,89,536,95,1264
"10951","San Joaquin County",2001-10-01,537,91,530,95,1253
"10952","San Joaquin County",2001-11-01,544,85,509,94,1232
"10953","San Joaquin County",2001-12-01,496,74,465,88,1123
"10954","San Joaquin County",2002-01-01,538,87,479,90,1194
"10955","San Joaquin County",2002-02-01,560,71,483,91,1205
"10956","San Joaquin County",2002-03-01,564,80,524,85,1253
"10957","San Joaquin County",2002-04-01,539,82,502,80,1203
"10958","San Joaquin County",2002-05-01,522,85,479,72,1158
"10959","San Joaquin County",2002-06-01,533,79,483,70,1165
"10960","San Joaquin County",2002-07-01,546,86,490,74,1196
"10961","San Joaquin County",2002-08-01,549,81,501,78,1209
"10962","San Joaquin County",2002-09-01,567,93,482,74,1216
"10963","San Joaquin County",2002-10-01,555,88,485,75,1203
"10964","San Joaquin County",2002-11-01,551,89,487,85,1212
"10965","San Joaquin County",2002-12-01,568,81,454,86,1189
"10966","San Joaquin County",2003-01-01,606,88,452,79,1225
"10967","San Joaquin County",2003-02-01,594,101,473,78,1246
"10968","San Joaquin County",2003-03-01,594,104,521,85,1304
"10969","San Joaquin County",2003-04-01,606,93,507,86,1292
"10970","San Joaquin County",2003-05-01,631,91,504,81,1307
"10971","San Joaquin County",2003-06-01,617,97,517,79,1310
"10972","San Joaquin County",2003-07-01,637,89,510,84,1320
"10973","San Joaquin County",2003-08-01,628,91,507,97,1323
"10974","San Joaquin County",2003-09-01,638,89,515,94,1336
"10975","San Joaquin County",2003-10-01,636,101,505,90,1332
"10976","San Joaquin County",2003-11-01,598,100,512,94,1304
"10977","San Joaquin County",2003-12-01,595,80,491,88,1254
"10978","San Joaquin County",2004-01-01,616,86,491,89,1282
"10979","San Joaquin County",2004-02-01,633,105,512,87,1337
"10980","San Joaquin County",2004-03-01,622,105,434,93,1254
"10981","San Joaquin County",2004-04-01,605,105,517,93,1320
"10982","San Joaquin County",2004-05-01,618,101,531,104,1354
"10983","San Joaquin County",2004-06-01,596,101,488,107,1292
"10984","San Joaquin County",2004-07-01,606,98,446,107,1257
"10985","San Joaquin County",2004-08-01,627,111,411,102,1251
"10986","San Joaquin County",2004-09-01,640,108,399,104,1251
"10987","San Joaquin County",2004-10-01,628,93,410,102,1233
"10988","San Joaquin County",2004-11-01,653,101,403,100,1257
"10989","San Joaquin County",2004-12-01,650,92,381,103,1226
"10990","San Joaquin County",2005-01-01,657,93,404,105,1259
"10991","San Joaquin County",2005-02-01,676,98,424,106,1304
"10992","San Joaquin County",2005-03-01,666,105,423,95,1289
"10993","San Joaquin County",2005-04-01,658,115,445,92,1310
"10994","San Joaquin County",2005-05-01,668,127,434,93,1322
"10995","San Joaquin County",2005-06-01,675,121,436,95,1327
"10996","San Joaquin County",2005-07-01,688,120,453,100,1361
"10997","San Joaquin County",2005-08-01,705,114,473,103,1395
"10998","San Joaquin County",2005-09-01,723,126,453,106,1408
"10999","San Joaquin County",2005-10-01,742,130,440,105,1417
"11000","San Joaquin County",2005-11-01,739,128,435,100,1402
"11001","San Joaquin County",2005-12-01,696,118,462,98,1374
"11002","San Joaquin County",2006-01-01,755,109,468,103,1435
"11003","San Joaquin County",2006-02-01,746,116,451,101,1414
"11004","San Joaquin County",2006-03-01,719,111,498,99,1427
"11005","San Joaquin County",2006-04-01,716,118,488,98,1420
"11006","San Joaquin County",2006-05-01,730,134,480,106,1450
"11007","San Joaquin County",2006-06-01,721,133,478,102,1434
"11008","San Joaquin County",2006-07-01,701,109,520,117,1447
"11009","San Joaquin County",2006-08-01,698,102,541,121,1462
"11010","San Joaquin County",2006-09-01,711,108,543,113,1475
"11011","San Joaquin County",2006-10-01,718,114,545,113,1490
"11012","San Joaquin County",2006-11-01,737,102,471,111,1421
"11013","San Joaquin County",2006-12-01,709,99,469,107,1384
"11014","San Joaquin County",2007-01-01,727,121,569,102,1519
"11015","San Joaquin County",2007-02-01,751,127,593,106,1577
"11016","San Joaquin County",2007-03-01,727,129,604,110,1570
"11017","San Joaquin County",2007-04-01,746,129,614,115,1604
"11018","San Joaquin County",2007-05-01,822,122,601,116,1661
"11019","San Joaquin County",2007-06-01,782,108,624,113,1627
"11020","San Joaquin County",2007-07-01,755,106,644,122,1627
"11021","San Joaquin County",2007-08-01,737,102,643,123,1605
"11022","San Joaquin County",2007-09-01,759,115,640,109,1623
"11023","San Joaquin County",2007-10-01,706,107,622,111,1546
"11024","San Joaquin County",2007-11-01,720,98,622,112,1552
"11025","San Joaquin County",2007-12-01,705,96,605,109,1515
"11026","San Joaquin County",2008-01-01,717,108,579,112,1516
"11027","San Joaquin County",2008-02-01,721,100,590,113,1524
"11028","San Joaquin County",2008-03-01,718,96,608,117,1539
"11029","San Joaquin County",2008-04-01,729,105,612,111,1557
"11030","San Joaquin County",2008-05-01,731,110,589,107,1537
"11031","San Joaquin County",2008-06-01,762,109,558,112,1541
"11032","San Joaquin County",2008-07-01,761,101,559,115,1536
"11033","San Joaquin County",2008-08-01,754,96,575,117,1542
"11034","San Joaquin County",2008-09-01,750,97,567,113,1527
"11035","San Joaquin County",2008-10-01,732,97,574,111,1514
"11036","San Joaquin County",2008-11-01,754,96,559,111,1520
"11037","San Joaquin County",2008-12-01,722,95,515,99,1431
"11038","San Joaquin County",2009-01-01,743,94,536,94,1467
"11039","San Joaquin County",2009-02-01,787,105,592,110,1594
"11040","San Joaquin County",2009-03-01,821,90,574,108,1593
"11041","San Joaquin County",2009-04-01,822,92,529,110,1553
"11042","San Joaquin County",2009-05-01,827,98,528,109,1562
"11043","San Joaquin County",2009-06-01,794,104,565,105,1568
"11044","San Joaquin County",2009-07-01,795,95,544,95,1529
"11045","San Joaquin County",2009-08-01,841,99,553,102,1595
"11046","San Joaquin County",2009-09-01,839,99,548,100,1586
"11047","San Joaquin County",2009-10-01,783,101,486,95,1465
"11048","San Joaquin County",2009-11-01,740,109,453,90,1392
"11049","San Joaquin County",2009-12-01,689,103,432,85,1309
"11050","San Joaquin County",2010-01-01,720,110,433,88,1351
"11051","San Joaquin County",2010-02-01,704,99,443,81,1327
"11052","San Joaquin County",2010-03-01,690,100,421,73,1284
"11053","San Joaquin County",2010-04-01,707,99,404,73,1283
"11054","San Joaquin County",2010-05-01,701,93,445,88,1327
"11055","San Joaquin County",2010-06-01,720,100,367,89,1276
"11056","San Joaquin County",2010-07-01,736,97,356,83,1272
"11057","San Joaquin County",2010-08-01,760,99,462,71,1392
"11058","San Joaquin County",2010-09-01,762,109,371,65,1307
"11059","San Joaquin County",2010-10-01,735,96,332,65,1228
"11060","San Joaquin County",2010-11-01,721,93,315,66,1195
"11061","San Joaquin County",2010-12-01,678,99,331,56,1164
"11062","San Joaquin County",2011-01-01,682,94,324,55,1155
"11063","San Joaquin County",2011-02-01,711,87,332,67,1197
"11064","San Joaquin County",2011-03-01,677,95,357,71,1200
"11065","San Joaquin County",2011-04-01,668,97,359,67,1191
"11066","San Joaquin County",2011-05-01,611,97,354,65,1127
"11067","San Joaquin County",2011-06-01,600,91,361,68,1120
"11068","San Joaquin County",2011-07-01,619,92,321,52,1084
"11069","San Joaquin County",2011-08-01,639,93,306,53,1091
"11070","San Joaquin County",2011-09-01,671,97,288,53,1109
"11071","San Joaquin County",2011-10-01,708,93,315,63,1179
"11072","San Joaquin County",2011-11-01,698,83,339,68,1188
"11073","San Joaquin County",2011-12-01,708,69,319,67,1163
"11074","San Joaquin County",2012-01-01,740,74,338,60,1212
"11075","San Joaquin County",2012-02-01,720,80,377,57,1234
"11076","San Joaquin County",2012-03-01,725,77,369,58,1229
"11077","San Joaquin County",2012-04-01,756,84,380,60,1280
"11078","San Joaquin County",2012-05-01,760,95,382,60,1297
"11079","San Joaquin County",2012-06-01,743,86,403,60,1292
"11080","San Joaquin County",2012-07-01,738,91,427,56,1312
"11081","San Joaquin County",2012-08-01,805,83,417,52,1357
"11082","San Joaquin County",2012-09-01,808,79,455,56,1398
"11083","San Joaquin County",2012-10-01,822,71,459,57,1409
"11084","San Joaquin County",2012-11-01,822,85,469,51,1427
"11085","San Joaquin County",2012-12-01,836,81,467,55,1439
"11086","San Joaquin County",2013-01-01,836,88,447,60,1431
"11087","San Joaquin County",2013-02-01,861,88,449,58,1456
"11088","San Joaquin County",2013-03-01,807,92,477,57,1433
"11089","San Joaquin County",2013-04-01,786,110,480,58,1434
"11090","San Joaquin County",2013-05-01,791,113,476,78,1458
"11091","San Joaquin County",2013-06-01,811,105,471,81,1468
"11092","San Joaquin County",2013-07-01,798,101,466,78,1443
"11093","San Joaquin County",2013-08-01,807,102,463,76,1448
"11094","San Joaquin County",2013-09-01,811,112,454,74,1451
"11095","San Joaquin County",2013-10-01,782,93,478,81,1434
"11096","San Joaquin County",2013-11-01,753,98,470,73,1394
"11097","San Joaquin County",2013-12-01,754,88,457,72,1371
"11098","San Joaquin County",2014-01-01,797,99,457,68,1421
"11099","San Joaquin County",2014-02-01,808,108,472,68,1456
"11100","San Joaquin County",2014-03-01,799,105,488,71,1463
"11101","San Joaquin County",2014-04-01,819,113,458,76,1466
"11102","San Joaquin County",2014-05-01,813,103,465,75,1456
"11103","San Joaquin County",2014-06-01,822,98,466,65,1451
"11104","San Joaquin County",2014-07-01,833,101,433,65,1432
"11105","San Joaquin County",2014-08-01,830,103,448,69,1450
"11106","San Joaquin County",2014-09-01,823,93,440,70,1426
"11107","San Joaquin County",2014-10-01,824,90,455,70,1439
"11108","San Joaquin County",2014-11-01,790,83,423,65,1361
"11109","San Joaquin County",2014-12-01,746,73,372,53,1244
"11110","San Joaquin County",2015-01-01,757,76,362,41,1236
"11111","San Joaquin County",2015-02-01,749,74,369,49,1241
"11112","San Joaquin County",2015-03-01,736,84,365,43,1228
"11113","San Joaquin County",2015-04-01,717,81,352,46,1196
"11114","San Joaquin County",2015-05-01,740,81,329,47,1197
"11115","San Joaquin County",2015-06-01,728,79,357,57,1221
"11116","San Joaquin County",2015-07-01,720,88,373,60,1241
"11117","San Joaquin County",2015-08-01,732,93,369,55,1249
"11118","San Joaquin County",2015-09-01,731,95,348,61,1235
"11119","San Joaquin County",2015-10-01,771,93,337,66,1267
"11120","San Joaquin County",2015-11-01,813,94,304,60,1271
"11121","San Joaquin County",2015-12-01,770,82,311,48,1211
"11122","San Joaquin County",2016-01-01,776,84,305,47,1212
"11123","San Joaquin County",2016-02-01,788,99,333,53,1273
"11124","San Joaquin County",2016-03-01,770,91,373,59,1293
"11125","San Joaquin County",2016-04-01,763,104,367,79,1313
"11126","San Joaquin County",2016-05-01,746,95,358,61,1260
"11127","San Joaquin County",2016-06-01,730,105,357,49,1241
"11128","San Joaquin County",2016-07-01,765,107,355,56,1283
"11129","San Joaquin County",2016-08-01,768,108,358,53,1287
"11130","San Joaquin County",2016-09-01,798,115,382,59,1354
"11131","San Joaquin County",2016-10-01,762,102,372,54,1290
"11132","San Joaquin County",2016-11-01,753,99,380,51,1283
"11133","San Joaquin County",2016-12-01,721,101,374,44,1240
"11134","San Joaquin County",2017-01-01,752,110,375,53,1290
"11135","San Joaquin County",2017-02-01,788,111,369,45,1313
"11136","San Joaquin County",2017-03-01,785,111,376,51,1323
"11137","San Joaquin County",2017-04-01,799,102,397,60,1358
"11138","San Joaquin County",2017-05-01,825,110,390,53,1378
"11139","San Joaquin County",2017-06-01,841,115,409,59,1424
"11140","San Joaquin County",2017-07-01,822,108,397,59,1386
"11141","San Joaquin County",2017-08-01,864,107,379,59,1409
"11142","San Joaquin County",2017-09-01,843,113,374,49,1379
"11143","San Joaquin County",2017-10-01,818,106,360,51,1335
"11144","San Joaquin County",2017-11-01,800,110,339,43,1292
"11145","San Joaquin County",2017-12-01,838,110,324,48,1320
"11146","San Joaquin County",2018-01-01,880,107,312,48,1347
"11147","San Joaquin County",2018-02-01,857,110,325,46,1338
"11148","San Joaquin County",2018-03-01,803,101,313,52,1269
"11149","San Joaquin County",2018-04-01,784,94,313,50,1241
"11150","San Joaquin County",2018-05-01,803,89,305,50,1247
"11151","San Joaquin County",2018-06-01,729,83,369,57,1238
"11152","San Joaquin County",2018-07-01,737,87,394,62,1280
"11153","San Joaquin County",2018-08-01,770,97,380,58,1305
"11154","San Joaquin County",2018-09-01,787,100,354,63,1304
"11155","San Joaquin County",2018-10-01,766,112,345,69,1292
"11156","San Joaquin County",2018-11-01,802,111,306,63,1282
"11157","San Joaquin County",2018-12-01,807,116,306,66,1295
"11158","San Joaquin County",2019-01-01,755,95,288,53,1191
"11159","San Joaquin County",2019-02-01,830,107,343,63,1343
"11160","San Joaquin County",2019-03-01,831,111,328,65,1335
"11161","San Joaquin County",2019-04-01,846,120,329,66,1361
"11162","San Joaquin County",2019-05-01,863,129,317,75,1384
"11163","San Joaquin County",2019-06-01,847,111,337,76,1371
"11164","San Joaquin County",2019-07-01,833,118,342,83,1376
"11165","San Joaquin County",2019-08-01,863,117,369,75,1424
"11166","San Joaquin County",2019-09-01,867,115,371,69,1422
"11167","San Joaquin County",2019-10-01,852,113,352,74,1391
"11168","San Joaquin County",2019-11-01,816,113,333,69,1331
"11169","San Joaquin County",2019-12-01,818,110,316,65,1309
"11170","San Joaquin County",2020-01-01,866,121,312,61,1360
"11171","San Joaquin County",2020-02-01,858,128,331,65,1382
"11172","San Joaquin County",2020-03-01,856,117,304,58,1335
"11173","San Luis Obispo County",1995-11-01,157,19,233,30,439
"11174","San Luis Obispo County",1995-12-01,111,14,199,23,347
"11175","San Luis Obispo County",1996-01-01,110,9,230,27,376
"11176","San Luis Obispo County",1996-02-01,107,10,242,28,387
"11177","San Luis Obispo County",1996-03-01,100,10,264,29,403
"11178","San Luis Obispo County",1996-04-01,105,14,209,28,356
"11179","San Luis Obispo County",1996-05-01,99,13,197,32,341
"11180","San Luis Obispo County",1996-06-01,115,14,184,29,342
"11181","San Luis Obispo County",1996-07-01,111,11,182,25,329
"11182","San Luis Obispo County",1996-08-01,121,15,185,25,346
"11183","San Luis Obispo County",1996-09-01,115,13,182,34,344
"11184","San Luis Obispo County",1996-10-01,116,16,180,34,346
"11185","San Luis Obispo County",1996-11-01,135,17,181,33,366
"11186","San Luis Obispo County",1996-12-01,114,13,206,30,363
"11187","San Luis Obispo County",1997-01-01,107,11,217,32,367
"11188","San Luis Obispo County",1997-02-01,117,13,212,28,370
"11189","San Luis Obispo County",1997-03-01,112,12,185,33,342
"11190","San Luis Obispo County",1997-04-01,117,14,185,34,350
"11191","San Luis Obispo County",1997-05-01,112,12,185,33,342
"11192","San Luis Obispo County",1997-06-01,117,13,212,28,370
"11193","San Luis Obispo County",1997-07-01,136,15,203,31,385
"11194","San Luis Obispo County",1997-08-01,132,16,209,29,386
"11195","San Luis Obispo County",1997-09-01,127,17,181,33,358
"11196","San Luis Obispo County",1997-10-01,108,22,231,26,387
"11197","San Luis Obispo County",1997-11-01,114,27,207,31,379
"11198","San Luis Obispo County",1997-12-01,123,15,212,34,384
"11199","San Luis Obispo County",1998-01-01,140,26,206,29,401
"11200","San Luis Obispo County",1998-02-01,136,26,217,35,414
"11201","San Luis Obispo County",1998-03-01,125,20,223,41,409
"11202","San Luis Obispo County",1998-04-01,121,21,219,44,405
"11203","San Luis Obispo County",1998-05-01,112,21,227,39,399
"11204","San Luis Obispo County",1998-06-01,117,22,226,40,405
"11205","San Luis Obispo County",1998-07-01,126,21,233,40,420
"11206","San Luis Obispo County",1998-08-01,144,20,221,41,426
"11207","San Luis Obispo County",1998-09-01,128,14,216,40,398
"11208","San Luis Obispo County",1998-10-01,113,16,217,31,377
"11209","San Luis Obispo County",1998-11-01,113,15,201,27,356
"11210","San Luis Obispo County",1998-12-01,112,14,198,24,348
"11211","San Luis Obispo County",1999-01-01,109,12,223,26,370
"11212","San Luis Obispo County",1999-02-01,111,13,219,34,377
"11213","San Luis Obispo County",1999-03-01,100,15,220,36,371
"11214","San Luis Obispo County",1999-04-01,100,13,227,39,379
"11215","San Luis Obispo County",1999-05-01,99,12,238,35,384
"11216","San Luis Obispo County",1999-06-01,111,12,204,36,363
"11217","San Luis Obispo County",1999-07-01,128,13,212,28,381
"11218","San Luis Obispo County",1999-08-01,128,13,233,27,401
"11219","San Luis Obispo County",1999-09-01,131,16,209,28,384
"11220","San Luis Obispo County",1999-10-01,128,18,201,29,376
"11221","San Luis Obispo County",1999-11-01,131,17,197,26,371
"11222","San Luis Obispo County",1999-12-01,124,13,182,20,339
"11223","San Luis Obispo County",2000-01-01,118,15,225,25,383
"11224","San Luis Obispo County",2000-02-01,108,19,239,29,395
"11225","San Luis Obispo County",2000-03-01,106,11,235,33,385
"11226","San Luis Obispo County",2000-04-01,116,14,200,24,354
"11227","San Luis Obispo County",2000-05-01,108,11,197,24,340
"11228","San Luis Obispo County",2000-06-01,111,14,205,29,359
"11229","San Luis Obispo County",2000-07-01,112,12,215,35,374
"11230","San Luis Obispo County",2000-08-01,103,19,189,40,351
"11231","San Luis Obispo County",2000-09-01,108,19,207,33,367
"11232","San Luis Obispo County",2000-10-01,126,17,196,31,370
"11233","San Luis Obispo County",2000-11-01,122,20,206,31,379
"11234","San Luis Obispo County",2000-12-01,118,22,204,23,367
"11235","San Luis Obispo County",2001-01-01,114,17,207,35,373
"11236","San Luis Obispo County",2001-02-01,123,19,200,32,374
"11237","San Luis Obispo County",2001-03-01,128,23,198,35,384
"11238","San Luis Obispo County",2001-04-01,110,17,193,42,362
"11239","San Luis Obispo County",2001-05-01,99,18,200,38,355
"11240","San Luis Obispo County",2001-06-01,110,20,176,28,334
"11241","San Luis Obispo County",2001-07-01,122,19,175,23,339
"11242","San Luis Obispo County",2001-08-01,130,16,178,23,347
"11243","San Luis Obispo County",2001-09-01,124,19,183,19,345
"11244","San Luis Obispo County",2001-10-01,125,22,177,20,344
"11245","San Luis Obispo County",2001-11-01,133,21,188,23,365
"11246","San Luis Obispo County",2001-12-01,118,19,176,24,337
"11247","San Luis Obispo County",2002-01-01,131,21,181,21,354
"11248","San Luis Obispo County",2002-02-01,146,23,177,21,367
"11249","San Luis Obispo County",2002-03-01,146,23,177,21,367
"11250","San Luis Obispo County",2002-04-01,148,20,166,23,357
"11251","San Luis Obispo County",2002-05-01,145,24,180,27,376
"11252","San Luis Obispo County",2002-06-01,151,22,204,28,405
"11253","San Luis Obispo County",2002-07-01,146,28,204,25,403
"11254","San Luis Obispo County",2002-08-01,142,22,207,28,399
"11255","San Luis Obispo County",2002-09-01,163,26,211,33,433
"11256","San Luis Obispo County",2002-10-01,170,24,202,30,426
"11257","San Luis Obispo County",2002-11-01,149,23,211,31,414
"11258","San Luis Obispo County",2002-12-01,140,25,186,23,374
"11259","San Luis Obispo County",2003-01-01,157,29,202,26,414
"11260","San Luis Obispo County",2003-02-01,147,24,204,31,406
"11261","San Luis Obispo County",2003-03-01,157,27,233,29,446
"11262","San Luis Obispo County",2003-04-01,146,26,228,34,434
"11263","San Luis Obispo County",2003-05-01,141,25,222,34,422
"11264","San Luis Obispo County",2003-06-01,149,26,221,38,434
"11265","San Luis Obispo County",2003-07-01,143,24,223,26,416
"11266","San Luis Obispo County",2003-08-01,134,26,211,28,399
"11267","San Luis Obispo County",2003-09-01,148,22,201,28,399
"11268","San Luis Obispo County",2003-10-01,177,32,224,37,470
"11269","San Luis Obispo County",2003-11-01,190,33,220,37,480
"11270","San Luis Obispo County",2003-12-01,163,24,207,39,433
"11271","San Luis Obispo County",2004-01-01,156,33,222,33,444
"11272","San Luis Obispo County",2004-02-01,176,33,238,33,480
"11273","San Luis Obispo County",2004-03-01,174,30,213,40,457
"11274","San Luis Obispo County",2004-04-01,167,37,210,41,455
"11275","San Luis Obispo County",2004-05-01,168,33,221,37,459
"11276","San Luis Obispo County",2004-06-01,168,33,221,37,459
"11277","San Luis Obispo County",2004-07-01,168,33,221,37,459
"11278","San Luis Obispo County",2004-08-01,168,33,221,37,459
"11279","San Luis Obispo County",2004-09-01,168,33,221,37,459
"11280","San Luis Obispo County",2004-10-01,168,33,223,37,461
"11281","San Luis Obispo County",2004-11-01,168,33,223,37,461
"11282","San Luis Obispo County",2004-12-01,168,33,223,37,461
"11283","San Luis Obispo County",2005-01-01,166,33,220,37,456
"11284","San Luis Obispo County",2005-02-01,177,35,234,39,485
"11285","San Luis Obispo County",2005-03-01,197,39,262,43,541
"11286","San Luis Obispo County",2005-04-01,219,42,225,54,540
"11287","San Luis Obispo County",2005-05-01,177,36,269,56,538
"11288","San Luis Obispo County",2005-06-01,181,32,245,47,505
"11289","San Luis Obispo County",2005-07-01,169,35,240,40,484
"11290","San Luis Obispo County",2005-08-01,165,30,259,41,495
"11291","San Luis Obispo County",2005-09-01,169,32,257,39,497
"11292","San Luis Obispo County",2005-10-01,197,33,252,50,532
"11293","San Luis Obispo County",2005-11-01,195,33,244,43,515
"11294","San Luis Obispo County",2005-12-01,185,27,208,58,478
"11295","San Luis Obispo County",2006-01-01,190,26,232,48,496
"11296","San Luis Obispo County",2006-02-01,187,31,243,58,519
"11297","San Luis Obispo County",2006-03-01,197,27,255,64,543
"11298","San Luis Obispo County",2006-04-01,215,37,245,49,546
"11299","San Luis Obispo County",2006-05-01,200,34,250,38,522
"11300","San Luis Obispo County",2006-06-01,191,41,221,55,508
"11301","San Luis Obispo County",2006-07-01,181,29,248,33,491
"11302","San Luis Obispo County",2006-08-01,201,32,249,38,520
"11303","San Luis Obispo County",2006-09-01,195,33,275,45,548
"11304","San Luis Obispo County",2006-10-01,196,34,260,51,541
"11305","San Luis Obispo County",2006-11-01,207,43,247,47,544
"11306","San Luis Obispo County",2006-12-01,193,43,228,46,510
"11307","San Luis Obispo County",2007-01-01,177,34,234,48,493
"11308","San Luis Obispo County",2007-02-01,181,32,221,46,480
"11309","San Luis Obispo County",2007-03-01,194,28,228,38,488
"11310","San Luis Obispo County",2007-04-01,178,24,248,41,491
"11311","San Luis Obispo County",2007-05-01,189,28,253,44,514
"11312","San Luis Obispo County",2007-06-01,191,29,268,49,537
"11313","San Luis Obispo County",2007-07-01,209,34,259,40,542
"11314","San Luis Obispo County",2007-08-01,221,35,236,39,531
"11315","San Luis Obispo County",2007-09-01,221,44,226,36,527
"11316","San Luis Obispo County",2007-10-01,216,36,227,43,522
"11317","San Luis Obispo County",2007-11-01,228,34,226,42,530
"11318","San Luis Obispo County",2007-12-01,191,30,223,40,484
"11319","San Luis Obispo County",2008-01-01,200,33,236,44,513
"11320","San Luis Obispo County",2008-02-01,201,28,241,46,516
"11321","San Luis Obispo County",2008-03-01,222,27,232,57,538
"11322","San Luis Obispo County",2008-04-01,218,31,232,50,531
"11323","San Luis Obispo County",2008-05-01,200,31,230,48,509
"11324","San Luis Obispo County",2008-06-01,199,26,225,47,497
"11325","San Luis Obispo County",2008-07-01,188,29,225,38,480
"11326","San Luis Obispo County",2008-08-01,208,24,213,46,491
"11327","San Luis Obispo County",2008-09-01,214,26,212,50,502
"11328","San Luis Obispo County",2008-10-01,206,21,208,46,481
"11329","San Luis Obispo County",2008-11-01,204,22,167,40,433
"11330","San Luis Obispo County",2008-12-01,197,26,213,35,471
"11331","San Luis Obispo County",2009-01-01,191,24,229,40,484
"11332","San Luis Obispo County",2009-02-01,183,19,230,38,470
"11333","San Luis Obispo County",2009-03-01,200,27,233,35,495
"11334","San Luis Obispo County",2009-04-01,204,32,232,37,505
"11335","San Luis Obispo County",2009-05-01,179,40,229,36,484
"11336","San Luis Obispo County",2009-06-01,207,43,210,44,504
"11337","San Luis Obispo County",2009-07-01,219,41,206,45,511
"11338","San Luis Obispo County",2009-08-01,232,38,219,44,533
"11339","San Luis Obispo County",2009-09-01,212,32,235,49,528
"11340","San Luis Obispo County",2009-10-01,223,35,210,44,512
"11341","San Luis Obispo County",2009-11-01,215,34,221,33,503
"11342","San Luis Obispo County",2009-12-01,219,32,199,31,481
"11343","San Luis Obispo County",2010-01-01,239,31,184,31,485
"11344","San Luis Obispo County",2010-02-01,228,29,183,27,467
"11345","San Luis Obispo County",2010-03-01,234,31,202,32,499
"11346","San Luis Obispo County",2010-04-01,222,26,197,37,482
"11347","San Luis Obispo County",2010-05-01,186,28,189,37,440
"11348","San Luis Obispo County",2010-06-01,194,24,189,38,445
"11349","San Luis Obispo County",2010-07-01,225,33,184,38,480
"11350","San Luis Obispo County",2010-08-01,223,28,195,37,483
"11351","San Luis Obispo County",2010-09-01,245,28,174,36,483
"11352","San Luis Obispo County",2010-10-01,252,33,185,40,510
"11353","San Luis Obispo County",2010-11-01,243,34,177,36,490
"11354","San Luis Obispo County",2010-12-01,222,34,170,32,458
"11355","San Luis Obispo County",2011-01-01,224,35,202,38,499
"11356","San Luis Obispo County",2011-02-01,227,36,190,42,495
"11357","San Luis Obispo County",2011-03-01,220,36,205,49,510
"11358","San Luis Obispo County",2011-04-01,242,37,181,37,497
"11359","San Luis Obispo County",2011-05-01,238,37,184,39,498
"11360","San Luis Obispo County",2011-06-01,253,43,191,39,526
"11361","San Luis Obispo County",2011-07-01,275,45,186,41,547
"11362","San Luis Obispo County",2011-08-01,282,42,196,42,562
"11363","San Luis Obispo County",2011-09-01,305,39,207,42,593
"11364","San Luis Obispo County",2011-10-01,282,43,223,39,587
"11365","San Luis Obispo County",2011-11-01,267,42,242,34,585
"11366","San Luis Obispo County",2011-12-01,265,52,242,37,596
"11367","San Luis Obispo County",2012-01-01,278,53,240,47,618
"11368","San Luis Obispo County",2012-02-01,283,49,242,51,625
"11369","San Luis Obispo County",2012-03-01,269,44,233,51,597
"11370","San Luis Obispo County",2012-04-01,256,47,242,52,597
"11371","San Luis Obispo County",2012-05-01,270,48,246,47,611
"11372","San Luis Obispo County",2012-06-01,270,47,255,52,624
"11373","San Luis Obispo County",2012-07-01,282,57,246,50,635
"11374","San Luis Obispo County",2012-08-01,295,61,239,37,632
"11375","San Luis Obispo County",2012-09-01,277,54,263,25,619
"11376","San Luis Obispo County",2012-10-01,295,53,266,46,660
"11377","San Luis Obispo County",2012-11-01,299,54,268,54,675
"11378","San Luis Obispo County",2012-12-01,302,51,263,56,672
"11379","San Luis Obispo County",2013-01-01,302,58,279,54,693
"11380","San Luis Obispo County",2013-02-01,298,56,291,52,697
"11381","San Luis Obispo County",2013-03-01,291,52,298,60,701
"11382","San Luis Obispo County",2013-04-01,299,53,289,59,700
"11383","San Luis Obispo County",2013-05-01,280,53,291,53,677
"11384","San Luis Obispo County",2013-06-01,285,57,287,57,686
"11385","San Luis Obispo County",2013-07-01,277,55,270,62,664
"11386","San Luis Obispo County",2013-08-01,297,63,266,54,680
"11387","San Luis Obispo County",2013-09-01,302,66,286,54,708
"11388","San Luis Obispo County",2013-10-01,295,56,277,50,678
"11389","San Luis Obispo County",2013-11-01,304,57,276,44,681
"11390","San Luis Obispo County",2013-12-01,310,56,273,51,690
"11391","San Luis Obispo County",2014-01-01,329,55,268,62,714
"11392","San Luis Obispo County",2014-02-01,340,57,256,54,707
"11393","San Luis Obispo County",2014-03-01,317,53,254,48,672
"11394","San Luis Obispo County",2014-04-01,297,56,276,43,672
"11395","San Luis Obispo County",2014-05-01,282,56,290,52,680
"11396","San Luis Obispo County",2014-06-01,309,54,273,55,691
"11397","San Luis Obispo County",2014-07-01,322,56,268,57,703
"11398","San Luis Obispo County",2014-08-01,305,58,289,60,712
"11399","San Luis Obispo County",2014-09-01,301,53,275,59,688
"11400","San Luis Obispo County",2014-10-01,296,53,270,57,676
"11401","San Luis Obispo County",2014-11-01,254,49,259,52,614
"11402","San Luis Obispo County",2014-12-01,207,31,238,44,520
"11403","San Luis Obispo County",2015-01-01,206,28,255,41,530
"11404","San Luis Obispo County",2015-02-01,216,29,266,42,553
"11405","San Luis Obispo County",2015-03-01,208,26,257,38,529
"11406","San Luis Obispo County",2015-04-01,203,26,224,37,490
"11407","San Luis Obispo County",2015-05-01,225,25,221,37,508
"11408","San Luis Obispo County",2015-06-01,223,31,236,36,526
"11409","San Luis Obispo County",2015-07-01,231,33,241,39,544
"11410","San Luis Obispo County",2015-08-01,246,43,239,40,568
"11411","San Luis Obispo County",2015-09-01,251,41,231,42,565
"11412","San Luis Obispo County",2015-10-01,254,31,224,41,550
"11413","San Luis Obispo County",2015-11-01,207,28,240,43,518
"11414","San Luis Obispo County",2015-12-01,197,33,227,38,495
"11415","San Luis Obispo County",2016-01-01,165,24,217,25,431
"11416","San Luis Obispo County",2016-02-01,209,36,246,39,530
"11417","San Luis Obispo County",2016-03-01,213,38,252,37,540
"11418","San Luis Obispo County",2016-04-01,219,42,241,39,541
"11419","San Luis Obispo County",2016-05-01,221,36,239,39,535
"11420","San Luis Obispo County",2016-06-01,216,44,233,38,531
"11421","San Luis Obispo County",2016-07-01,228,47,227,43,545
"11422","San Luis Obispo County",2016-08-01,248,39,233,48,568
"11423","San Luis Obispo County",2016-09-01,252,42,222,36,552
"11424","San Luis Obispo County",2016-10-01,259,39,221,28,547
"11425","San Luis Obispo County",2016-11-01,258,30,224,33,545
"11426","San Luis Obispo County",2016-12-01,269,38,203,34,544
"11427","San Luis Obispo County",2017-01-01,266,39,222,29,556
"11428","San Luis Obispo County",2017-02-01,262,48,232,30,572
"11429","San Luis Obispo County",2017-03-01,254,43,238,38,573
"11430","San Luis Obispo County",2017-04-01,261,53,240,40,594
"11431","San Luis Obispo County",2017-05-01,250,53,241,39,583
"11432","San Luis Obispo County",2017-06-01,246,52,237,45,580
"11433","San Luis Obispo County",2017-07-01,246,43,257,48,594
"11434","San Luis Obispo County",2017-08-01,256,51,241,51,599
"11435","San Luis Obispo County",2017-09-01,247,54,253,52,606
"11436","San Luis Obispo County",2017-10-01,239,53,241,41,574
"11437","San Luis Obispo County",2017-11-01,220,41,227,39,527
"11438","San Luis Obispo County",2017-12-01,219,43,208,39,509
"11439","San Luis Obispo County",2018-01-01,226,43,209,41,519
"11440","San Luis Obispo County",2018-02-01,221,32,214,50,517
"11441","San Luis Obispo County",2018-03-01,208,24,211,49,492
"11442","San Luis Obispo County",2018-04-01,226,31,224,45,526
"11443","San Luis Obispo County",2018-05-01,225,34,224,39,522
"11444","San Luis Obispo County",2018-06-01,238,31,224,45,538
"11445","San Luis Obispo County",2018-07-01,253,35,231,45,564
"11446","San Luis Obispo County",2018-08-01,245,31,226,44,546
"11447","San Luis Obispo County",2018-09-01,252,34,219,38,543
"11448","San Luis Obispo County",2018-10-01,269,38,213,32,552
"11449","San Luis Obispo County",2018-11-01,251,34,216,37,538
"11450","San Luis Obispo County",2018-12-01,266,35,190,32,523
"11451","San Luis Obispo County",2019-01-01,271,37,184,38,530
"11452","San Luis Obispo County",2019-02-01,283,41,186,43,553
"11453","San Luis Obispo County",2019-03-01,256,39,208,37,540
"11454","San Luis Obispo County",2019-04-01,253,43,220,39,555
"11455","San Luis Obispo County",2019-05-01,255,41,216,34,546
"11456","San Luis Obispo County",2019-06-01,266,45,218,48,577
"11457","San Luis Obispo County",2019-07-01,265,50,218,58,591
"11458","San Luis Obispo County",2019-08-01,265,45,213,53,576
"11459","San Luis Obispo County",2019-09-01,268,38,200,46,552
"11460","San Luis Obispo County",2019-10-01,248,39,186,45,518
"11461","San Luis Obispo County",2019-11-01,243,34,173,37,487
"11462","San Luis Obispo County",2019-12-01,253,34,168,34,489
"11463","San Luis Obispo County",2020-01-01,252,39,168,34,493
"11464","San Luis Obispo County",2020-02-01,258,38,170,42,508
"11465","San Luis Obispo County",2020-03-01,261,41,159,39,500
"11466","San Mateo County",1995-10-01,375,48,571,101,1095
"11467","San Mateo County",1995-11-01,379,49,566,91,1085
"11468","San Mateo County",1995-12-01,368,51,561,78,1058
"11469","San Mateo County",1996-01-01,416,46,536,81,1079
"11470","San Mateo County",1996-02-01,442,45,533,80,1100
"11471","San Mateo County",1996-03-01,470,28,521,74,1093
"11472","San Mateo County",1996-04-01,293,32,682,73,1080
"11473","San Mateo County",1996-05-01,312,34,637,75,1058
"11474","San Mateo County",1996-06-01,312,39,648,88,1087
"11475","San Mateo County",1996-07-01,323,44,670,97,1134
"11476","San Mateo County",1996-08-01,419,53,620,95,1187
"11477","San Mateo County",1996-09-01,318,49,730,107,1204
"11478","San Mateo County",1996-10-01,306,43,705,97,1151
"11479","San Mateo County",1996-11-01,304,66,670,70,1110
"11480","San Mateo County",1996-12-01,310,38,672,89,1109
"11481","San Mateo County",1997-01-01,314,36,633,83,1066
"11482","San Mateo County",1997-02-01,323,40,723,90,1176
"11483","San Mateo County",1997-03-01,315,43,718,95,1171
"11484","San Mateo County",1997-04-01,308,41,708,87,1144
"11485","San Mateo County",1997-05-01,303,41,702,91,1137
"11486","San Mateo County",1997-06-01,384,49,591,77,1101
"11487","San Mateo County",1997-07-01,313,42,674,84,1113
"11488","San Mateo County",1997-08-01,314,42,692,89,1137
"11489","San Mateo County",1997-09-01,312,40,768,31,1151
"11490","San Mateo County",1997-10-01,310,46,579,100,1035
"11491","San Mateo County",1997-11-01,310,48,577,100,1035
"11492","San Mateo County",1997-12-01,305,67,625,69,1066
"11493","San Mateo County",1998-01-01,306,43,668,96,1113
"11494","San Mateo County",1998-02-01,309,45,659,100,1113
"11495","San Mateo County",1998-03-01,326,45,723,94,1188
"11496","San Mateo County",1998-04-01,454,60,613,76,1203
"11497","San Mateo County",1998-05-01,439,44,662,88,1233
"11498","San Mateo County",1998-06-01,441,50,672,98,1261
"11499","San Mateo County",1998-07-01,500,0,678,103,1281
"11500","San Mateo County",1998-08-01,448,52,678,103,1281
"11501","San Mateo County",1998-09-01,434,50,647,102,1233
"11502","San Mateo County",1998-10-01,527,0,617,105,1249
"11503","San Mateo County",1998-11-01,457,46,656,96,1255
"11504","San Mateo County",1998-12-01,500,421,212,89,1222
"11505","San Mateo County",1999-01-01,510,44,574,88,1216
"11506","San Mateo County",1999-02-01,511,50,586,100,1247
"11507","San Mateo County",1999-03-01,518,50,606,101,1275
"11508","San Mateo County",1999-04-01,507,52,574,100,1233
"11509","San Mateo County",1999-05-01,508,50,565,101,1224
"11510","San Mateo County",1999-06-01,500,51,570,102,1223
"11511","San Mateo County",1999-07-01,495,54,575,109,1233
"11512","San Mateo County",1999-08-01,470,54,550,109,1183
"11513","San Mateo County",1999-09-01,481,49,547,102,1179
"11514","San Mateo County",1999-10-01,489,44,535,92,1160
"11515","San Mateo County",1999-11-01,482,44,525,86,1137
"11516","San Mateo County",1999-12-01,495,42,492,79,1108
"11517","San Mateo County",2000-01-01,496,41,483,79,1099
"11518","San Mateo County",2000-02-01,520,44,516,83,1163
"11519","San Mateo County",2000-03-01,502,41,512,82,1137
"11520","San Mateo County",2000-04-01,513,44,523,90,1170
"11521","San Mateo County",2000-05-01,506,47,517,91,1161
"11522","San Mateo County",2000-06-01,497,40,500,82,1119
"11523","San Mateo County",2000-07-01,482,35,482,78,1077
"11524","San Mateo County",2000-08-01,471,35,478,74,1058
"11525","San Mateo County",2000-09-01,484,37,492,72,1085
"11526","San Mateo County",2000-10-01,492,40,489,77,1098
"11527","San Mateo County",2000-11-01,487,35,479,69,1070
"11528","San Mateo County",2000-12-01,466,38,459,73,1036
"11529","San Mateo County",2001-01-01,475,40,468,76,1059
"11530","San Mateo County",2001-02-01,483,44,467,84,1078
"11531","San Mateo County",2001-03-01,494,46,471,92,1103
"11532","San Mateo County",2001-04-01,488,44,473,87,1092
"11533","San Mateo County",2001-05-01,492,48,464,96,1100
"11534","San Mateo County",2001-06-01,492,48,474,93,1107
"11535","San Mateo County",2001-07-01,493,48,464,90,1095
"11536","San Mateo County",2001-08-01,475,45,439,87,1046
"11537","San Mateo County",2001-09-01,480,46,441,91,1058
"11538","San Mateo County",2001-10-01,493,44,449,82,1068
"11539","San Mateo County",2001-11-01,487,45,444,82,1058
"11540","San Mateo County",2001-12-01,466,46,421,83,1016
"11541","San Mateo County",2002-01-01,491,46,441,86,1064
"11542","San Mateo County",2002-02-01,491,44,449,84,1068
"11543","San Mateo County",2002-03-01,479,45,452,86,1062
"11544","San Mateo County",2002-04-01,474,43,447,84,1048
"11545","San Mateo County",2002-05-01,473,40,448,77,1038
"11546","San Mateo County",2002-06-01,483,38,461,77,1059
"11547","San Mateo County",2002-07-01,478,36,445,73,1032
"11548","San Mateo County",2002-08-01,475,36,465,54,1030
"11549","San Mateo County",2002-09-01,468,38,431,74,1011
"11550","San Mateo County",2002-10-01,455,39,427,76,997
"11551","San Mateo County",2002-11-01,457,40,422,79,998
"11552","San Mateo County",2002-12-01,442,39,410,77,968
"11553","San Mateo County",2003-01-01,465,36,430,71,1002
"11554","San Mateo County",2003-02-01,483,32,442,75,1032
"11555","San Mateo County",2003-03-01,474,39,434,75,1022
"11556","San Mateo County",2003-04-01,484,45,437,84,1050
"11557","San Mateo County",2003-05-01,496,49,447,85,1077
"11558","San Mateo County",2003-06-01,515,54,423,81,1073
"11559","San Mateo County",2003-07-01,522,53,398,80,1053
"11560","San Mateo County",2003-08-01,521,52,422,79,1074
"11561","San Mateo County",2003-09-01,530,54,436,82,1102
"11562","San Mateo County",2003-10-01,535,54,442,81,1112
"11563","San Mateo County",2003-11-01,485,53,474,79,1091
"11564","San Mateo County",2003-12-01,483,48,462,67,1060
"11565","San Mateo County",2004-01-01,492,59,461,60,1072
"11566","San Mateo County",2004-02-01,518,74,466,64,1122
"11567","San Mateo County",2004-03-01,569,67,461,65,1162
"11568","San Mateo County",2004-04-01,583,66,463,71,1183
"11569","San Mateo County",2004-05-01,550,59,468,77,1154
"11570","San Mateo County",2004-06-01,495,67,476,79,1117
"11571","San Mateo County",2004-07-01,484,58,483,82,1107
"11572","San Mateo County",2004-08-01,467,56,500,84,1107
"11573","San Mateo County",2004-09-01,468,63,493,86,1110
"11574","San Mateo County",2004-10-01,481,55,486,77,1099
"11575","San Mateo County",2004-11-01,466,58,470,71,1065
"11576","San Mateo County",2004-12-01,434,74,442,51,1001
"11577","San Mateo County",2005-01-01,438,65,443,65,1011
"11578","San Mateo County",2005-02-01,470,59,466,69,1064
"11579","San Mateo County",2005-03-01,457,60,475,66,1058
"11580","San Mateo County",2005-04-01,459,68,462,72,1061
"11581","San Mateo County",2005-05-01,465,63,461,78,1067
"11582","San Mateo County",2005-06-01,462,64,449,77,1052
"11583","San Mateo County",2005-07-01,472,61,432,82,1047
"11584","San Mateo County",2005-08-01,506,63,445,77,1091
"11585","San Mateo County",2005-09-01,511,56,463,75,1105
"11586","San Mateo County",2005-10-01,509,61,438,70,1078
"11587","San Mateo County",2005-11-01,540,73,445,78,1136
"11588","San Mateo County",2005-12-01,509,62,410,73,1054
"11589","San Mateo County",2006-01-01,510,66,412,76,1064
"11590","San Mateo County",2006-02-01,525,72,457,70,1124
"11591","San Mateo County",2006-03-01,494,67,478,73,1112
"11592","San Mateo County",2006-04-01,465,79,480,65,1089
"11593","San Mateo County",2006-05-01,488,84,451,65,1088
"11594","San Mateo County",2006-06-01,536,76,427,78,1117
"11595","San Mateo County",2006-07-01,536,70,428,77,1111
"11596","San Mateo County",2006-08-01,543,72,451,78,1144
"11597","San Mateo County",2006-09-01,526,83,459,83,1151
"11598","San Mateo County",2006-10-01,516,91,454,83,1144
"11599","San Mateo County",2006-11-01,503,90,464,83,1140
"11600","San Mateo County",2006-12-01,505,76,439,74,1094
"11601","San Mateo County",2007-01-01,532,82,471,74,1159
"11602","San Mateo County",2007-02-01,537,81,492,92,1202
"11603","San Mateo County",2007-03-01,521,88,504,90,1203
"11604","San Mateo County",2007-04-01,529,89,501,81,1200
"11605","San Mateo County",2007-05-01,541,85,505,77,1208
"11606","San Mateo County",2007-06-01,576,88,513,75,1252
"11607","San Mateo County",2007-07-01,582,81,524,83,1270
"11608","San Mateo County",2007-08-01,560,78,518,87,1243
"11609","San Mateo County",2007-09-01,567,72,509,91,1239
"11610","San Mateo County",2007-10-01,532,65,484,83,1164
"11611","San Mateo County",2007-11-01,491,64,493,89,1137
"11612","San Mateo County",2007-12-01,489,59,466,93,1107
"11613","San Mateo County",2008-01-01,458,63,474,89,1084
"11614","San Mateo County",2008-02-01,606,81,349,60,1096
"11615","San Mateo County",2008-03-01,635,79,354,63,1131
"11616","San Mateo County",2008-04-01,659,93,336,64,1152
"11617","San Mateo County",2008-05-01,657,83,352,65,1157
"11618","San Mateo County",2008-06-01,661,88,346,60,1155
"11619","San Mateo County",2008-07-01,656,87,337,60,1140
"11620","San Mateo County",2008-08-01,660,77,339,60,1136
"11621","San Mateo County",2008-09-01,644,77,331,54,1106
"11622","San Mateo County",2008-10-01,662,72,301,54,1089
"11623","San Mateo County",2008-11-01,666,69,323,53,1111
"11624","San Mateo County",2008-12-01,680,85,306,52,1123
"11625","San Mateo County",2009-01-01,699,91,301,52,1143
"11626","San Mateo County",2009-02-01,674,87,337,59,1157
"11627","San Mateo County",2009-03-01,657,67,346,55,1125
"11628","San Mateo County",2009-04-01,661,81,348,52,1142
"11629","San Mateo County",2009-05-01,658,73,351,49,1131
"11630","San Mateo County",2009-06-01,649,74,342,54,1119
"11631","San Mateo County",2009-07-01,669,77,336,54,1136
"11632","San Mateo County",2009-08-01,619,75,329,56,1079
"11633","San Mateo County",2009-09-01,626,77,313,59,1075
"11634","San Mateo County",2009-10-01,608,70,324,60,1062
"11635","San Mateo County",2009-11-01,607,68,335,48,1058
"11636","San Mateo County",2009-12-01,588,61,325,50,1024
"11637","San Mateo County",2010-01-01,638,74,288,46,1046
"11638","San Mateo County",2010-02-01,652,81,258,32,1023
"11639","San Mateo County",2010-03-01,662,78,267,42,1049
"11640","San Mateo County",2010-04-01,673,78,264,45,1060
"11641","San Mateo County",2010-05-01,690,86,281,46,1103
"11642","San Mateo County",2010-06-01,666,80,278,42,1066
"11643","San Mateo County",2010-07-01,622,75,275,37,1009
"11644","San Mateo County",2010-08-01,620,78,261,43,1002
"11645","San Mateo County",2010-09-01,662,83,224,55,1024
"11646","San Mateo County",2010-10-01,675,76,235,49,1035
"11647","San Mateo County",2010-11-01,667,77,239,45,1028
"11648","San Mateo County",2010-12-01,649,79,236,45,1009
"11649","San Mateo County",2011-01-01,647,81,226,47,1001
"11650","San Mateo County",2011-02-01,630,80,236,48,994
"11651","San Mateo County",2011-03-01,630,80,236,48,994
"11652","San Mateo County",2011-04-01,643,85,218,43,989
"11653","San Mateo County",2011-05-01,629,76,229,47,981
"11654","San Mateo County",2011-06-01,635,73,236,53,997
"11655","San Mateo County",2011-07-01,643,69,233,47,992
"11656","San Mateo County",2011-08-01,631,68,243,47,989
"11657","San Mateo County",2011-09-01,624,72,240,43,979
"11658","San Mateo County",2011-10-01,621,67,242,39,969
"11659","San Mateo County",2011-11-01,563,64,269,53,949
"11660","San Mateo County",2011-12-01,532,63,268,50,913
"11661","San Mateo County",2012-01-01,547,64,281,51,943
"11662","San Mateo County",2012-02-01,547,63,306,59,975
"11663","San Mateo County",2012-03-01,557,66,314,55,992
"11664","San Mateo County",2012-04-01,540,73,328,58,999
"11665","San Mateo County",2012-05-01,525,78,327,64,994
"11666","San Mateo County",2012-06-01,565,80,328,65,1038
"11667","San Mateo County",2012-07-01,577,66,312,61,1016
"11668","San Mateo County",2012-08-01,547,72,289,52,960
"11669","San Mateo County",2012-09-01,540,73,304,56,973
"11670","San Mateo County",2012-10-01,544,63,309,48,964
"11671","San Mateo County",2012-11-01,537,65,295,54,951
"11672","San Mateo County",2012-12-01,542,70,310,61,983
"11673","San Mateo County",2013-01-01,540,72,304,66,982
"11674","San Mateo County",2013-02-01,564,83,334,72,1053
"11675","San Mateo County",2013-03-01,537,72,340,82,1031
"11676","San Mateo County",2013-04-01,532,71,342,77,1022
"11677","San Mateo County",2013-05-01,532,70,390,71,1063
"11678","San Mateo County",2013-06-01,549,73,358,73,1053
"11679","San Mateo County",2013-07-01,571,80,330,72,1053
"11680","San Mateo County",2013-08-01,587,67,346,76,1076
"11681","San Mateo County",2013-09-01,571,63,362,68,1064
"11682","San Mateo County",2013-10-01,589,73,346,63,1071
"11683","San Mateo County",2013-11-01,600,68,350,63,1081
"11684","San Mateo County",2013-12-01,564,73,332,59,1028
"11685","San Mateo County",2014-01-01,578,76,326,64,1044
"11686","San Mateo County",2014-02-01,586,83,349,73,1091
"11687","San Mateo County",2014-03-01,609,73,340,70,1092
"11688","San Mateo County",2014-04-01,674,70,272,70,1086
"11689","San Mateo County",2014-05-01,649,75,303,63,1090
"11690","San Mateo County",2014-06-01,677,80,316,14,1087
"11691","San Mateo County",2014-07-01,646,85,275,61,1067
"11692","San Mateo County",2014-08-01,609,85,276,60,1030
"11693","San Mateo County",2014-09-01,563,89,326,54,1032
"11694","San Mateo County",2014-10-01,581,89,277,62,1009
"11695","San Mateo County",2014-11-01,540,73,265,57,935
"11696","San Mateo County",2014-12-01,461,55,230,47,793
"11697","San Mateo County",2015-01-01,491,58,176,38,763
"11698","San Mateo County",2015-02-01,454,51,218,45,768
"11699","San Mateo County",2015-03-01,517,56,210,43,826
"11700","San Mateo County",2015-04-01,525,48,270,8,851
"11701","San Mateo County",2015-05-01,511,54,237,52,854
"11702","San Mateo County",2015-06-01,500,52,237,51,840
"11703","San Mateo County",2015-07-01,491,58,256,48,853
"11704","San Mateo County",2015-08-01,514,58,243,53,868
"11705","San Mateo County",2015-09-01,529,53,248,55,885
"11706","San Mateo County",2015-10-01,552,66,263,47,928
"11707","San Mateo County",2015-11-01,476,60,314,47,897
"11708","San Mateo County",2015-12-01,456,56,308,49,869
"11709","San Mateo County",2016-01-01,461,57,301,46,865
"11710","San Mateo County",2016-02-01,487,59,260,46,852
"11711","San Mateo County",2016-03-01,492,58,254,48,852
"11712","San Mateo County",2016-04-01,520,63,279,47,909
"11713","San Mateo County",2016-05-01,516,62,286,49,913
"11714","San Mateo County",2016-06-01,555,55,286,52,948
"11715","San Mateo County",2016-07-01,572,61,296,51,980
"11716","San Mateo County",2016-08-01,570,61,273,56,960
"11717","San Mateo County",2016-09-01,589,66,286,57,998
"11718","San Mateo County",2016-10-01,593,60,291,52,996
"11719","San Mateo County",2016-11-01,603,63,282,53,1001
"11720","San Mateo County",2016-12-01,590,55,274,52,971
"11721","San Mateo County",2017-01-01,598,69,272,43,982
"11722","San Mateo County",2017-02-01,609,75,299,50,1033
"11723","San Mateo County",2017-03-01,598,82,307,58,1045
"11724","San Mateo County",2017-04-01,601,71,288,54,1014
"11725","San Mateo County",2017-05-01,580,60,306,56,1002
"11726","San Mateo County",2017-06-01,565,63,332,59,1019
"11727","San Mateo County",2017-07-01,567,57,337,52,1013
"11728","San Mateo County",2017-08-01,602,67,313,46,1028
"11729","San Mateo County",2017-09-01,579,72,315,44,1010
"11730","San Mateo County",2017-10-01,579,63,307,51,1000
"11731","San Mateo County",2017-11-01,566,72,308,53,999
"11732","San Mateo County",2017-12-01,590,72,280,58,1000
"11733","San Mateo County",2018-01-01,580,70,304,59,1013
"11734","San Mateo County",2018-02-01,555,71,326,67,1019
"11735","San Mateo County",2018-03-01,518,71,340,64,993
"11736","San Mateo County",2018-04-01,503,74,325,58,960
"11737","San Mateo County",2018-05-01,533,64,284,62,943
"11738","San Mateo County",2018-06-01,559,62,290,59,970
"11739","San Mateo County",2018-07-01,559,58,314,63,994
"11740","San Mateo County",2018-08-01,572,59,313,50,994
"11741","San Mateo County",2018-09-01,588,66,291,50,995
"11742","San Mateo County",2018-10-01,585,72,299,48,1004
"11743","San Mateo County",2018-11-01,581,77,290,46,994
"11744","San Mateo County",2018-12-01,590,66,268,54,978
"11745","San Mateo County",2019-01-01,600,73,273,54,1000
"11746","San Mateo County",2019-02-01,598,77,274,56,1005
"11747","San Mateo County",2019-03-01,603,70,286,62,1021
"11748","San Mateo County",2019-04-01,598,78,313,58,1047
"11749","San Mateo County",2019-05-01,608,83,305,53,1049
"11750","San Mateo County",2019-06-01,592,67,292,58,1009
"11751","San Mateo County",2019-07-01,589,69,303,56,1017
"11752","San Mateo County",2019-08-01,598,67,324,53,1042
"11753","San Mateo County",2019-09-01,593,68,325,50,1036
"11754","San Mateo County",2019-10-01,597,67,313,44,1021
"11755","San Mateo County",2019-11-01,580,62,310,48,1000
"11756","San Mateo County",2019-12-01,554,62,299,43,958
"11757","San Mateo County",2020-01-01,551,64,297,41,953
"11758","San Mateo County",2020-02-01,561,76,290,47,974
"11759","San Mateo County",2020-03-01,518,60,262,47,887
"11760","Santa Barbara County",1995-10-01,392,51,448,67,958
"11761","Santa Barbara County",1995-11-01,371,40,451,71,933
"11762","Santa Barbara County",1995-12-01,368,33,452,54,907
"11763","Santa Barbara County",1996-01-01,374,41,447,54,916
"11764","Santa Barbara County",1996-02-01,379,49,480,54,962
"11765","Santa Barbara County",1996-03-01,370,44,479,67,960
"11766","Santa Barbara County",1996-04-01,386,41,448,63,938
"11767","Santa Barbara County",1996-05-01,376,44,441,51,912
"11768","Santa Barbara County",1996-06-01,406,51,429,53,939
"11769","Santa Barbara County",1996-07-01,412,52,431,54,949
"11770","Santa Barbara County",1996-08-01,387,52,444,54,937
"11771","Santa Barbara County",1996-09-01,387,46,455,55,943
"11772","Santa Barbara County",1996-10-01,362,59,454,56,931
"11773","Santa Barbara County",1996-11-01,335,55,440,54,884
"11774","Santa Barbara County",1996-12-01,307,42,412,53,814
"11775","Santa Barbara County",1997-01-01,311,52,387,44,794
"11776","Santa Barbara County",1997-02-01,327,59,416,61,863
"11777","Santa Barbara County",1997-03-01,345,51,446,72,914
"11778","Santa Barbara County",1997-04-01,357,43,457,66,923
"11779","Santa Barbara County",1997-05-01,367,51,446,71,935
"11780","Santa Barbara County",1997-06-01,370,47,453,78,948
"11781","Santa Barbara County",1997-07-01,363,44,465,75,947
"11782","Santa Barbara County",1997-08-01,404,45,470,66,985
"11783","Santa Barbara County",1997-09-01,393,47,323,225,988
"11784","Santa Barbara County",1997-10-01,404,53,498,59,1014
"11785","Santa Barbara County",1997-11-01,363,56,533,60,1012
"11786","Santa Barbara County",1997-12-01,338,48,494,62,942
"11787","Santa Barbara County",1998-01-01,358,55,476,66,955
"11788","Santa Barbara County",1998-02-01,385,59,491,64,999
"11789","Santa Barbara County",1998-03-01,397,66,513,63,1039
"11790","Santa Barbara County",1998-04-01,378,63,486,55,982
"11791","Santa Barbara County",1998-05-01,348,64,469,59,940
"11792","Santa Barbara County",1998-06-01,361,70,436,52,919
"11793","Santa Barbara County",1998-07-01,347,58,443,68,916
"11794","Santa Barbara County",1998-08-01,369,64,458,61,952
"11795","Santa Barbara County",1998-09-01,379,62,457,63,961
"11796","Santa Barbara County",1998-10-01,397,66,444,60,967
"11797","Santa Barbara County",1998-11-01,364,73,441,44,922
"11798","Santa Barbara County",1998-12-01,357,64,407,46,874
"11799","Santa Barbara County",1999-01-01,379,33,424,91,927
"11800","Santa Barbara County",1999-02-01,376,67,462,62,967
"11801","Santa Barbara County",1999-03-01,374,63,446,58,941
"11802","Santa Barbara County",1999-04-01,367,61,423,61,912
"11803","Santa Barbara County",1999-05-01,365,68,409,58,900
"11804","Santa Barbara County",1999-06-01,377,59,389,66,891
"11805","Santa Barbara County",1999-07-01,386,59,354,53,852
"11806","Santa Barbara County",1999-08-01,395,63,336,55,849
"11807","Santa Barbara County",1999-09-01,390,65,366,49,870
"11808","Santa Barbara County",1999-10-01,421,70,373,44,908
"11809","Santa Barbara County",1999-11-01,387,67,405,51,910
"11810","Santa Barbara County",1999-12-01,390,54,401,55,900
"11811","Santa Barbara County",2000-01-01,398,59,377,56,890
"11812","Santa Barbara County",2000-02-01,388,54,381,57,880
"11813","Santa Barbara County",2000-03-01,382,59,400,45,886
"11814","Santa Barbara County",2000-04-01,359,51,428,42,880
"11815","Santa Barbara County",2000-05-01,370,48,415,53,886
"11816","Santa Barbara County",2000-06-01,359,56,411,53,879
"11817","Santa Barbara County",2000-07-01,356,53,414,49,872
"11818","Santa Barbara County",2000-08-01,334,56,430,48,868
"11819","Santa Barbara County",2000-09-01,351,55,415,46,867
"11820","Santa Barbara County",2000-10-01,359,58,397,54,868
"11821","Santa Barbara County",2000-11-01,381,56,383,47,867
"11822","Santa Barbara County",2000-12-01,362,61,355,45,823
"11823","Santa Barbara County",2001-01-01,400,61,346,46,853
"11824","Santa Barbara County",2001-02-01,403,59,358,49,869
"11825","Santa Barbara County",2001-03-01,386,61,376,51,874
"11826","Santa Barbara County",2001-04-01,420,55,336,56,867
"11827","Santa Barbara County",2001-05-01,429,69,336,45,879
"11828","Santa Barbara County",2001-06-01,447,67,337,47,898
"11829","Santa Barbara County",2001-07-01,439,59,322,51,871
"11830","Santa Barbara County",2001-08-01,424,53,300,50,827
"11831","Santa Barbara County",2001-09-01,432,56,299,45,832
"11832","Santa Barbara County",2001-10-01,428,61,283,27,799
"11833","Santa Barbara County",2001-11-01,457,62,270,25,814
"11834","Santa Barbara County",2001-12-01,403,53,278,25,759
"11835","Santa Barbara County",2002-01-01,396,59,282,25,762
"11836","Santa Barbara County",2002-02-01,409,60,278,30,777
"11837","Santa Barbara County",2002-03-01,438,60,273,39,810
"11838","Santa Barbara County",2002-04-01,430,68,269,45,812
"11839","Santa Barbara County",2002-05-01,435,71,280,40,826
"11840","Santa Barbara County",2002-06-01,467,68,268,36,839
"11841","Santa Barbara County",2002-07-01,454,69,283,37,843
"11842","Santa Barbara County",2002-08-01,465,77,295,53,890
"11843","Santa Barbara County",2002-09-01,454,66,298,58,876
"11844","Santa Barbara County",2002-10-01,473,60,299,46,878
"11845","Santa Barbara County",2002-11-01,438,64,307,41,850
"11846","Santa Barbara County",2002-12-01,433,62,293,41,829
"11847","Santa Barbara County",2003-01-01,456,71,301,43,871
"11848","Santa Barbara County",2003-02-01,451,77,305,40,873
"11849","Santa Barbara County",2003-03-01,442,73,328,44,887
"11850","Santa Barbara County",2003-04-01,447,76,321,47,891
"11851","Santa Barbara County",2003-05-01,435,79,340,46,900
"11852","Santa Barbara County",2003-06-01,431,79,314,47,871
"11853","Santa Barbara County",2003-07-01,436,79,325,49,889
"11854","Santa Barbara County",2003-08-01,456,79,320,40,895
"11855","Santa Barbara County",2003-09-01,468,89,332,31,920
"11856","Santa Barbara County",2003-10-01,468,87,324,40,919
"11857","Santa Barbara County",2003-11-01,459,78,338,49,924
"11858","Santa Barbara County",2003-12-01,433,79,331,43,886
"11859","Santa Barbara County",2004-01-01,437,83,312,46,878
"11860","Santa Barbara County",2004-02-01,446,87,322,38,893
"11861","Santa Barbara County",2004-03-01,491,87,322,39,939
"11862","Santa Barbara County",2004-04-01,511,86,300,38,935
"11863","Santa Barbara County",2004-05-01,490,90,291,40,911
"11864","Santa Barbara County",2004-06-01,505,86,273,47,911
"11865","Santa Barbara County",2004-07-01,519,83,281,48,931
"11866","Santa Barbara County",2004-08-01,511,91,289,38,929
"11867","Santa Barbara County",2004-09-01,559,94,283,40,976
"11868","Santa Barbara County",2004-10-01,528,85,282,41,936
"11869","Santa Barbara County",2004-11-01,551,104,253,19,927
"11870","Santa Barbara County",2004-12-01,566,110,253,24,953
"11871","Santa Barbara County",2005-01-01,557,116,265,34,972
"11872","Santa Barbara County",2005-02-01,574,113,295,37,1019
"11873","Santa Barbara County",2005-03-01,569,103,293,51,1016
"11874","Santa Barbara County",2005-04-01,584,87,284,51,1006
"11875","Santa Barbara County",2005-05-01,579,92,291,50,1012
"11876","Santa Barbara County",2005-06-01,574,93,319,54,1040
"11877","Santa Barbara County",2005-07-01,534,89,301,53,977
"11878","Santa Barbara County",2005-08-01,543,93,264,47,947
"11879","Santa Barbara County",2005-09-01,545,99,266,45,955
"11880","Santa Barbara County",2005-10-01,520,98,273,53,944
"11881","Santa Barbara County",2005-11-01,515,107,277,41,940
"11882","Santa Barbara County",2005-12-01,498,105,300,41,944
"11883","Santa Barbara County",2006-01-01,545,104,274,44,967
"11884","Santa Barbara County",2006-02-01,498,96,305,53,952
"11885","Santa Barbara County",2006-03-01,514,90,314,63,981
"11886","Santa Barbara County",2006-04-01,532,102,297,59,990
"11887","Santa Barbara County",2006-05-01,542,95,298,56,991
"11888","Santa Barbara County",2006-06-01,511,94,310,52,967
"11889","Santa Barbara County",2006-07-01,524,102,308,56,990
"11890","Santa Barbara County",2006-08-01,547,111,296,61,1015
"11891","Santa Barbara County",2006-09-01,541,117,282,58,998
"11892","Santa Barbara County",2006-10-01,515,118,300,47,980
"11893","Santa Barbara County",2006-11-01,531,102,284,47,964
"11894","Santa Barbara County",2006-12-01,536,85,276,50,947
"11895","Santa Barbara County",2007-01-01,533,96,259,54,942
"11896","Santa Barbara County",2007-02-01,549,82,266,52,949
"11897","Santa Barbara County",2007-03-01,571,90,280,48,989
"11898","Santa Barbara County",2007-04-01,537,99,267,43,946
"11899","Santa Barbara County",2007-05-01,508,99,280,39,926
"11900","Santa Barbara County",2007-06-01,548,122,260,37,967
"11901","Santa Barbara County",2007-07-01,517,107,280,50,954
"11902","Santa Barbara County",2007-08-01,508,102,306,64,980
"11903","Santa Barbara County",2007-09-01,517,92,300,72,981
"11904","Santa Barbara County",2007-10-01,518,94,303,60,975
"11905","Santa Barbara County",2007-11-01,538,83,282,53,956
"11906","Santa Barbara County",2007-12-01,520,83,259,52,914
"11907","Santa Barbara County",2008-01-01,524,92,271,53,940
"11908","Santa Barbara County",2008-02-01,525,96,274,54,949
"11909","Santa Barbara County",2008-03-01,497,92,302,53,944
"11910","Santa Barbara County",2008-04-01,484,90,295,51,920
"11911","Santa Barbara County",2008-05-01,511,88,297,54,950
"11912","Santa Barbara County",2008-06-01,524,91,289,59,963
"11913","Santa Barbara County",2008-07-01,534,93,275,66,968
"11914","Santa Barbara County",2008-08-01,521,82,319,63,985
"11915","Santa Barbara County",2008-09-01,520,83,324,64,991
"11916","Santa Barbara County",2008-10-01,519,82,335,63,999
"11917","Santa Barbara County",2008-11-01,518,82,333,61,994
"11918","Santa Barbara County",2008-12-01,519,81,332,60,992
"11919","Santa Barbara County",2009-01-01,558,85,170,48,861
"11920","Santa Barbara County",2009-02-01,639,92,182,41,954
"11921","Santa Barbara County",2009-03-01,668,98,176,40,982
"11922","Santa Barbara County",2009-04-01,521,82,329,60,992
"11923","Santa Barbara County",2009-05-01,511,75,312,56,954
"11924","Santa Barbara County",2009-06-01,516,78,298,58,950
"11925","Santa Barbara County",2009-07-01,453,78,407,77,1015
"11926","Santa Barbara County",2009-08-01,644,103,193,40,980
"11927","Santa Barbara County",2009-09-01,634,112,216,31,993
"11928","Santa Barbara County",2009-10-01,638,97,204,34,973
"11929","Santa Barbara County",2009-11-01,638,94,208,33,973
"11930","Santa Barbara County",2009-12-01,621,87,195,37,940
"11931","Santa Barbara County",2010-01-01,660,86,170,37,953
"11932","Santa Barbara County",2010-02-01,569,95,197,35,896
"11933","Santa Barbara County",2010-03-01,650,115,245,32,1042
"11934","Santa Barbara County",2010-04-01,655,76,166,50,947
"11935","Santa Barbara County",2010-05-01,646,92,165,32,935
"11936","Santa Barbara County",2010-06-01,583,102,191,33,909
"11937","Santa Barbara County",2010-07-01,646,109,179,24,958
"11938","Santa Barbara County",2010-08-01,653,114,181,21,969
"11939","Santa Barbara County",2010-09-01,663,106,152,23,944
"11940","Santa Barbara County",2010-10-01,595,107,188,20,910
"11941","Santa Barbara County",2010-11-01,639,107,136,25,907
"11942","Santa Barbara County",2010-12-01,535,96,222,30,883
"11943","Santa Barbara County",2011-01-01,546,114,204,23,887
"11944","Santa Barbara County",2011-02-01,513,93,249,32,887
"11945","Santa Barbara County",2011-03-01,544,91,236,35,906
"11946","Santa Barbara County",2011-04-01,554,101,242,25,922
"11947","Santa Barbara County",2011-05-01,597,87,205,35,924
"11948","Santa Barbara County",2011-06-01,569,102,218,32,921
"11949","Santa Barbara County",2011-07-01,587,144,168,25,924
"11950","Santa Barbara County",2011-08-01,586,94,162,28,870
"11951","Santa Barbara County",2011-09-01,590,88,147,29,854
"11952","Santa Barbara County",2011-10-01,567,83,191,31,872
"11953","Santa Barbara County",2011-11-01,494,74,280,32,880
"11954","Santa Barbara County",2011-12-01,600,69,188,31,888
"11955","Santa Barbara County",2012-01-01,569,90,244,34,937
"11956","Santa Barbara County",2012-02-01,541,89,277,40,947
"11957","Santa Barbara County",2012-03-01,562,87,267,33,949
"11958","Santa Barbara County",2012-04-01,601,91,248,36,976
"11959","Santa Barbara County",2012-05-01,583,77,249,41,950
"11960","Santa Barbara County",2012-06-01,592,85,246,44,967
"11961","Santa Barbara County",2012-07-01,592,84,255,48,979
"11962","Santa Barbara County",2012-08-01,656,104,205,39,1004
"11963","Santa Barbara County",2012-09-01,646,104,247,47,1044
"11964","Santa Barbara County",2012-10-01,633,107,261,39,1040
"11965","Santa Barbara County",2012-11-01,614,104,276,36,1030
"11966","Santa Barbara County",2012-12-01,580,98,252,35,965
"11967","Santa Barbara County",2013-01-01,570,95,252,42,959
"11968","Santa Barbara County",2013-02-01,615,101,255,41,1012
"11969","Santa Barbara County",2013-03-01,617,96,250,46,1009
"11970","Santa Barbara County",2013-04-01,631,112,225,32,1000
"11971","Santa Barbara County",2013-05-01,606,104,240,42,992
"11972","Santa Barbara County",2013-06-01,614,100,247,52,1013
"11973","Santa Barbara County",2013-07-01,625,99,253,56,1033
"11974","Santa Barbara County",2013-08-01,616,103,269,57,1045
"11975","Santa Barbara County",2013-09-01,630,108,206,44,988
"11976","Santa Barbara County",2013-10-01,622,124,227,40,1013
"11977","Santa Barbara County",2013-11-01,625,138,217,43,1023
"11978","Santa Barbara County",2013-12-01,599,110,203,47,959
"11979","Santa Barbara County",2014-01-01,606,113,203,40,962
"11980","Santa Barbara County",2014-02-01,648,105,212,36,1001
"11981","Santa Barbara County",2014-03-01,666,109,220,40,1035
"11982","Santa Barbara County",2014-04-01,636,118,232,39,1025
"11983","Santa Barbara County",2014-05-01,649,116,212,37,1014
"11984","Santa Barbara County",2014-06-01,639,106,200,44,989
"11985","Santa Barbara County",2014-07-01,622,99,208,46,975
"11986","Santa Barbara County",2014-08-01,638,111,205,37,991
"11987","Santa Barbara County",2014-09-01,623,104,203,34,964
"11988","Santa Barbara County",2014-10-01,603,109,213,32,957
"11989","Santa Barbara County",2014-11-01,533,93,215,36,877
"11990","Santa Barbara County",2014-12-01,488,79,198,33,798
"11991","Santa Barbara County",2015-01-01,495,65,204,34,798
"11992","Santa Barbara County",2015-02-01,569,41,180,27,817
"11993","Santa Barbara County",2015-03-01,526,78,199,26,829
"11994","Santa Barbara County",2015-04-01,528,79,190,29,826
"11995","Santa Barbara County",2015-05-01,528,88,209,28,853
"11996","Santa Barbara County",2015-06-01,523,89,225,30,867
"11997","Santa Barbara County",2015-07-01,502,73,260,45,880
"11998","Santa Barbara County",2015-08-01,566,83,230,38,917
"11999","Santa Barbara County",2015-09-01,614,94,222,38,968
"12000","Santa Barbara County",2015-10-01,616,104,222,41,983
"12001","Santa Barbara County",2015-11-01,626,91,213,35,965
"12002","Santa Barbara County",2015-12-01,602,81,225,35,943
"12003","Santa Barbara County",2016-01-01,606,95,225,35,961
"12004","Santa Barbara County",2016-02-01,652,97,231,42,1022
"12005","Santa Barbara County",2016-03-01,652,105,247,48,1052
"12006","Santa Barbara County",2016-04-01,647,107,246,42,1042
"12007","Santa Barbara County",2016-05-01,653,97,254,43,1047
"12008","Santa Barbara County",2016-06-01,637,99,246,35,1017
"12009","Santa Barbara County",2016-07-01,646,87,245,33,1011
"12010","Santa Barbara County",2016-08-01,662,90,218,34,1004
"12011","Santa Barbara County",2016-09-01,651,97,256,29,1033
"12012","Santa Barbara County",2016-10-01,646,95,263,31,1035
"12013","Santa Barbara County",2016-11-01,632,91,246,36,1005
"12014","Santa Barbara County",2016-12-01,623,96,220,30,969
"12015","Santa Barbara County",2017-01-01,616,109,219,26,970
"12016","Santa Barbara County",2017-02-01,632,108,228,33,1001
"12017","Santa Barbara County",2017-03-01,599,96,251,41,987
"12018","Santa Barbara County",2017-04-01,645,84,243,38,1010
"12019","Santa Barbara County",2017-05-01,653,96,240,33,1022
"12020","Santa Barbara County",2017-06-01,647,89,229,38,1003
"12021","Santa Barbara County",2017-07-01,648,87,230,31,996
"12022","Santa Barbara County",2017-08-01,646,71,189,29,935
"12023","Santa Barbara County",2017-09-01,617,85,214,35,951
"12024","Santa Barbara County",2017-10-01,591,86,234,38,949
"12025","Santa Barbara County",2017-11-01,590,89,218,34,931
"12026","Santa Barbara County",2017-12-01,558,91,201,29,879
"12027","Santa Barbara County",2018-01-01,509,83,291,44,927
"12028","Santa Barbara County",2018-02-01,528,100,273,56,957
"12029","Santa Barbara County",2018-03-01,497,80,279,57,913
"12030","Santa Barbara County",2018-04-01,520,73,284,46,923
"12031","Santa Barbara County",2018-05-01,514,69,304,44,931
"12032","Santa Barbara County",2018-06-01,508,83,297,51,939
"12033","Santa Barbara County",2018-07-01,528,80,286,61,955
"12034","Santa Barbara County",2018-08-01,546,83,302,63,994
"12035","Santa Barbara County",2018-09-01,552,92,329,59,1032
"12036","Santa Barbara County",2018-10-01,525,87,333,51,996
"12037","Santa Barbara County",2018-11-01,495,91,304,49,939
"12038","Santa Barbara County",2018-12-01,498,98,273,52,921
"12039","Santa Barbara County",2019-01-01,532,95,275,51,953
"12040","Santa Barbara County",2019-02-01,554,81,299,52,986
"12041","Santa Barbara County",2019-03-01,510,75,321,58,964
"12042","Santa Barbara County",2019-04-01,498,77,308,72,955
"12043","Santa Barbara County",2019-05-01,473,73,282,60,888
"12044","Santa Barbara County",2019-06-01,492,74,286,48,900
"12045","Santa Barbara County",2019-07-01,495,72,280,51,898
"12046","Santa Barbara County",2019-08-01,509,69,276,57,911
"12047","Santa Barbara County",2019-09-01,479,63,284,55,881
"12048","Santa Barbara County",2019-10-01,448,63,289,56,856
"12049","Santa Barbara County",2019-11-01,564,68,353,55,1040
"12050","Santa Barbara County",2019-12-01,474,73,267,44,858
"12051","Santa Barbara County",2020-01-01,502,74,280,35,891
"12052","Santa Barbara County",2020-02-01,496,67,317,42,922
"12053","Santa Barbara County",2020-03-01,439,61,281,46,827
"12054","Santa Clara County",1995-10-01,2504,252,1724,237,4717
"12055","Santa Clara County",1995-11-01,2458,241,1721,230,4650
"12056","Santa Clara County",1995-12-01,2406,253,1659,247,4565
"12057","Santa Clara County",1996-01-01,2414,275,1567,236,4492
"12058","Santa Clara County",1996-02-01,2440,268,1600,254,4562
"12059","Santa Clara County",1996-03-01,2465,244,1656,272,4637
"12060","Santa Clara County",1996-04-01,2368,224,1799,289,4680
"12061","Santa Clara County",1996-05-01,2337,223,1714,263,4537
"12062","Santa Clara County",1996-06-01,2397,236,1667,256,4556
"12063","Santa Clara County",1996-07-01,2362,236,1606,292,4496
"12064","Santa Clara County",1996-08-01,2369,242,1572,239,4422
"12065","Santa Clara County",1996-09-01,2354,230,1563,249,4396
"12066","Santa Clara County",1996-10-01,2380,242,1616,261,4499
"12067","Santa Clara County",1996-11-01,2391,251,1536,231,4409
"12068","Santa Clara County",1996-12-01,2422,225,1499,225,4371
"12069","Santa Clara County",1997-01-01,2508,244,1509,225,4486
"12070","Santa Clara County",1997-02-01,2513,259,1617,250,4639
"12071","Santa Clara County",1997-03-01,2466,258,1632,242,4598
"12072","Santa Clara County",1997-04-01,2508,1325,465,224,4522
"12073","Santa Clara County",1997-05-01,2466,258,1658,244,4626
"12074","Santa Clara County",1997-06-01,2466,258,1658,245,4595
"12075","Santa Clara County",1997-07-01,2685,313,1634,222,4854
"12076","Santa Clara County",1997-08-01,2683,290,1691,248,4912
"12077","Santa Clara County",1997-09-01,2803,322,1666,257,5048
"12078","Santa Clara County",1997-10-01,2845,309,1658,273,5085
"12079","Santa Clara County",1997-11-01,2807,317,1673,275,5072
"12080","Santa Clara County",1997-12-01,2770,311,1627,258,4966
"12081","Santa Clara County",1998-01-01,2677,288,1731,271,4967
"12082","Santa Clara County",1998-02-01,2530,257,1896,303,4986
"12083","Santa Clara County",1998-03-01,2530,257,1899,303,4989
"12084","Santa Clara County",1998-04-01,2471,256,1970,294,4991
"12085","Santa Clara County",1998-05-01,2449,266,1871,305,4891
"12086","Santa Clara County",1998-06-01,2507,255,1825,303,4890
"12087","Santa Clara County",1998-07-01,2516,238,1808,284,4846
"12088","Santa Clara County",1998-08-01,2450,241,1800,295,4786
"12089","Santa Clara County",1998-09-01,2453,239,1811,314,4817
"12090","Santa Clara County",1998-10-01,2373,229,1847,305,4754
"12091","Santa Clara County",1998-11-01,2326,273,1796,292,4687
"12092","Santa Clara County",1998-12-01,2327,274,1795,295,4691
"12093","Santa Clara County",1999-01-01,2293,234,1740,290,4557
"12094","Santa Clara County",1999-02-01,2286,229,1919,306,4740
"12095","Santa Clara County",1999-03-01,2204,223,1989,319,4735
"12096","Santa Clara County",1999-04-01,2178,220,1942,313,4653
"12097","Santa Clara County",1999-05-01,2217,241,1954,316,4728
"12098","Santa Clara County",1999-06-01,2251,241,1924,318,4734
"12099","Santa Clara County",1999-07-01,2253,219,1941,335,4748
"12100","Santa Clara County",1999-08-01,2280,239,1919,301,4739
"12101","Santa Clara County",1999-09-01,2289,244,1914,297,4744
"12102","Santa Clara County",1999-10-01,2283,241,1903,296,4723
"12103","Santa Clara County",1999-11-01,2232,225,1735,247,4439
"12104","Santa Clara County",1999-12-01,2283,239,1825,273,4620
"12105","Santa Clara County",2000-01-01,2252,238,1661,255,4406
"12106","Santa Clara County",2000-02-01,2255,250,1720,281,4506
"12107","Santa Clara County",2000-03-01,2181,241,1823,281,4526
"12108","Santa Clara County",2000-04-01,2126,265,1844,302,4537
"12109","Santa Clara County",2000-05-01,2169,268,1761,308,4506
"12110","Santa Clara County",2000-06-01,2131,280,1754,294,4459
"12111","Santa Clara County",2000-07-01,2097,282,1697,290,4366
"12112","Santa Clara County",2000-08-01,2134,274,1660,274,4342
"12113","Santa Clara County",2000-09-01,2212,263,1696,281,4452
"12114","Santa Clara County",2000-10-01,2254,275,1696,309,4534
"12115","Santa Clara County",2000-11-01,2282,261,1725,309,4577
"12116","Santa Clara County",2000-12-01,2263,261,1719,287,4530
"12117","Santa Clara County",2001-01-01,2270,257,1651,275,4453
"12118","Santa Clara County",2001-02-01,2339,271,1604,253,4467
"12119","Santa Clara County",2001-03-01,2320,252,1586,252,4410
"12120","Santa Clara County",2001-04-01,2338,241,1543,236,4358
"12121","Santa Clara County",2001-05-01,2328,252,1551,228,4359
"12122","Santa Clara County",2001-06-01,2318,262,1555,221,4356
"12123","Santa Clara County",2001-07-01,2341,287,1466,213,4307
"12124","Santa Clara County",2001-08-01,2334,258,1411,214,4217
"12125","Santa Clara County",2001-09-01,2341,242,1367,206,4156
"12126","Santa Clara County",2001-10-01,2383,248,1342,197,4170
"12127","Santa Clara County",2001-11-01,2361,257,1271,170,4059
"12128","Santa Clara County",2001-12-01,2318,277,1190,163,3948
"12129","Santa Clara County",2002-01-01,2366,309,1135,163,3973
"12130","Santa Clara County",2002-02-01,2367,306,1151,162,3986
"12131","Santa Clara County",2002-03-01,2376,299,1172,177,4024
"12132","Santa Clara County",2002-04-01,2440,303,1148,185,4076
"12133","Santa Clara County",2002-05-01,2457,299,1126,184,4066
"12134","Santa Clara County",2002-06-01,2454,281,1174,197,4106
"12135","Santa Clara County",2002-07-01,2501,276,1186,190,4153
"12136","Santa Clara County",2002-08-01,2443,311,1210,183,4147
"12137","Santa Clara County",2002-09-01,2436,315,1215,183,4149
"12138","Santa Clara County",2002-10-01,2407,319,1212,188,4126
"12139","Santa Clara County",2002-11-01,2378,301,1182,193,4054
"12140","Santa Clara County",2002-12-01,2316,283,1130,176,3905
"12141","Santa Clara County",2003-01-01,2355,288,1132,167,3942
"12142","Santa Clara County",2003-02-01,2387,290,1165,168,4010
"12143","Santa Clara County",2003-03-01,2373,292,1177,179,4021
"12144","Santa Clara County",2003-04-01,2431,315,1211,179,4136
"12145","Santa Clara County",2003-05-01,2405,343,1216,182,4146
"12146","Santa Clara County",2003-06-01,2413,351,1212,191,4167
"12147","Santa Clara County",2003-07-01,2371,326,1234,207,4138
"12148","Santa Clara County",2003-08-01,2382,310,1198,194,4084
"12149","Santa Clara County",2003-09-01,2486,335,1181,167,4169
"12150","Santa Clara County",2003-10-01,2477,358,1219,196,4250
"12151","Santa Clara County",2003-11-01,2403,340,1236,212,4191
"12152","Santa Clara County",2003-12-01,2337,324,1204,193,4058
"12153","Santa Clara County",2004-01-01,2385,318,1176,173,4052
"12154","Santa Clara County",2004-02-01,2400,322,1204,175,4101
"12155","Santa Clara County",2004-03-01,2437,365,1274,203,4279
"12156","Santa Clara County",2004-04-01,2474,343,1287,206,4310
"12157","Santa Clara County",2004-05-01,2477,350,1304,211,4342
"12158","Santa Clara County",2004-06-01,2444,367,1293,205,4309
"12159","Santa Clara County",2004-07-01,2430,378,1255,209,4272
"12160","Santa Clara County",2004-08-01,2497,415,1236,210,4358
"12161","Santa Clara County",2004-09-01,2536,413,1243,212,4404
"12162","Santa Clara County",2004-10-01,2432,404,1235,223,4294
"12163","Santa Clara County",2004-11-01,2558,395,1245,228,4426
"12164","Santa Clara County",2004-12-01,2577,361,1119,189,4246
"12165","Santa Clara County",2005-01-01,2602,378,1112,186,4278
"12166","Santa Clara County",2005-02-01,2740,383,1100,189,4412
"12167","Santa Clara County",2005-03-01,2774,384,1155,204,4517
"12168","Santa Clara County",2005-04-01,2701,372,1294,212,4579
"12169","Santa Clara County",2005-05-01,2685,410,1258,212,4565
"12170","Santa Clara County",2005-06-01,2786,392,1303,229,4710
"12171","Santa Clara County",2005-07-01,2777,448,1342,231,4798
"12172","Santa Clara County",2005-08-01,2734,416,1373,247,4770
"12173","Santa Clara County",2005-09-01,2750,411,1338,219,4718
"12174","Santa Clara County",2005-10-01,2744,432,1344,223,4743
"12175","Santa Clara County",2005-11-01,2775,446,1410,234,4865
"12176","Santa Clara County",2005-12-01,2653,435,1406,214,4708
"12177","Santa Clara County",2006-01-01,2611,415,1388,222,4636
"12178","Santa Clara County",2006-02-01,2686,398,1417,230,4731
"12179","Santa Clara County",2006-03-01,2588,369,1465,266,4688
"12180","Santa Clara County",2006-04-01,2552,370,1469,262,4653
"12181","Santa Clara County",2006-05-01,2541,375,1459,277,4652
"12182","Santa Clara County",2006-06-01,2481,340,1438,256,4515
"12183","Santa Clara County",2006-07-01,2502,348,1382,242,4474
"12184","Santa Clara County",2006-08-01,2542,347,1415,238,4542
"12185","Santa Clara County",2006-09-01,2590,360,1451,230,4631
"12186","Santa Clara County",2006-10-01,2727,366,1400,224,4717
"12187","Santa Clara County",2006-11-01,2642,389,1408,225,4664
"12188","Santa Clara County",2006-12-01,2568,347,1326,231,4472
"12189","Santa Clara County",2007-01-01,2619,360,1297,231,4507
"12190","Santa Clara County",2007-02-01,2642,369,1306,232,4549
"12191","Santa Clara County",2007-03-01,2678,364,1346,250,4638
"12192","Santa Clara County",2007-04-01,2725,375,1350,248,4698
"12193","Santa Clara County",2007-05-01,2695,402,1412,246,4755
"12194","Santa Clara County",2007-06-01,2710,403,1389,234,4736
"12195","Santa Clara County",2007-07-01,2735,393,1324,224,4676
"12196","Santa Clara County",2007-08-01,2774,374,1307,229,4684
"12197","Santa Clara County",2007-09-01,2780,379,1388,242,4789
"12198","Santa Clara County",2007-10-01,2716,385,1413,233,4747
"12199","Santa Clara County",2007-11-01,2742,384,1337,238,4701
"12200","Santa Clara County",2007-12-01,2707,340,1231,224,4502
"12201","Santa Clara County",2008-01-01,2746,340,1164,199,4449
"12202","Santa Clara County",2008-02-01,2804,356,1196,207,4563
"12203","Santa Clara County",2008-03-01,2806,350,1173,200,4529
"12204","Santa Clara County",2008-04-01,2787,361,1207,188,4543
"12205","Santa Clara County",2008-05-01,2738,383,1263,207,4591
"12206","Santa Clara County",2008-06-01,2733,392,1263,219,4607
"12207","Santa Clara County",2008-07-01,2759,402,1310,217,4688
"12208","Santa Clara County",2008-08-01,2793,380,1300,214,4687
"12209","Santa Clara County",2008-09-01,2811,395,1212,212,4630
"12210","Santa Clara County",2008-10-01,2817,398,1133,231,4579
"12211","Santa Clara County",2008-11-01,2762,387,1167,207,4523
"12212","Santa Clara County",2008-12-01,2674,379,1110,186,4349
"12213","Santa Clara County",2009-01-01,2704,378,1075,171,4328
"12214","Santa Clara County",2009-02-01,2649,365,1120,188,4322
"12215","Santa Clara County",2009-03-01,2641,379,1122,206,4348
"12216","Santa Clara County",2009-04-01,2613,372,1126,211,4322
"12217","Santa Clara County",2009-05-01,2653,331,1158,210,4352
"12218","Santa Clara County",2009-06-01,2595,337,1147,200,4279
"12219","Santa Clara County",2009-07-01,2547,358,1186,207,4298
"12220","Santa Clara County",2009-08-01,2495,357,1200,218,4270
"12221","Santa Clara County",2009-09-01,2606,380,1158,213,4357
"12222","Santa Clara County",2009-10-01,2605,388,1168,213,4374
"12223","Santa Clara County",2009-11-01,2531,371,1125,197,4224
"12224","Santa Clara County",2009-12-01,2501,327,1023,183,4034
"12225","Santa Clara County",2010-01-01,2545,350,910,152,3957
"12226","Santa Clara County",2010-02-01,2587,363,898,154,4002
"12227","Santa Clara County",2010-03-01,2540,355,894,166,3955
"12228","Santa Clara County",2010-04-01,2564,361,871,164,3960
"12229","Santa Clara County",2010-05-01,2433,351,867,174,3825
"12230","Santa Clara County",2010-06-01,2431,315,824,173,3743
"12231","Santa Clara County",2010-07-01,2392,315,849,167,3723
"12232","Santa Clara County",2010-08-01,2417,335,842,155,3749
"12233","Santa Clara County",2010-09-01,2425,336,856,167,3784
"12234","Santa Clara County",2010-10-01,2447,339,845,147,3778
"12235","Santa Clara County",2010-11-01,2420,325,774,141,3660
"12236","Santa Clara County",2010-12-01,2389,340,715,110,3554
"12237","Santa Clara County",2011-01-01,2462,332,701,115,3610
"12238","Santa Clara County",2011-02-01,2412,295,746,135,3588
"12239","Santa Clara County",2011-03-01,2315,312,754,126,3507
"12240","Santa Clara County",2011-04-01,2408,331,731,133,3603
"12241","Santa Clara County",2011-05-01,2375,305,789,150,3619
"12242","Santa Clara County",2011-06-01,2301,306,836,148,3591
"12243","Santa Clara County",2011-07-01,2256,300,871,168,3595
"12244","Santa Clara County",2011-08-01,2179,291,879,177,3526
"12245","Santa Clara County",2011-09-01,2169,297,870,170,3506
"12246","Santa Clara County",2011-10-01,2159,303,845,153,3460
"12247","Santa Clara County",2011-11-01,2152,309,830,145,3436
"12248","Santa Clara County",2011-12-01,2159,289,823,144,3415
"12249","Santa Clara County",2012-01-01,2192,288,851,143,3474
"12250","Santa Clara County",2012-02-01,2176,304,908,162,3550
"12251","Santa Clara County",2012-03-01,2165,294,911,157,3527
"12252","Santa Clara County",2012-04-01,2194,288,908,163,3553
"12253","Santa Clara County",2012-05-01,2184,305,929,172,3590
"12254","Santa Clara County",2012-06-01,2209,317,961,178,3665
"12255","Santa Clara County",2012-07-01,2265,305,967,196,3733
"12256","Santa Clara County",2012-08-01,2229,284,977,191,3681
"12257","Santa Clara County",2012-09-01,2261,314,965,172,3712
"12258","Santa Clara County",2012-10-01,2281,311,970,175,3737
"12259","Santa Clara County",2012-11-01,2312,332,938,178,3760
"12260","Santa Clara County",2012-12-01,2256,299,904,176,3635
"12261","Santa Clara County",2013-01-01,2292,297,896,170,3655
"12262","Santa Clara County",2013-02-01,2322,293,962,182,3759
"12263","Santa Clara County",2013-03-01,2347,312,1015,200,3874
"12264","Santa Clara County",2013-04-01,2373,317,1009,210,3909
"12265","Santa Clara County",2013-05-01,2408,323,1049,201,3981
"12266","Santa Clara County",2013-06-01,2495,331,1022,216,4064
"12267","Santa Clara County",2013-07-01,2577,348,994,214,4133
"12268","Santa Clara County",2013-08-01,2554,340,934,203,4031
"12269","Santa Clara County",2013-09-01,2613,360,916,200,4089
"12270","Santa Clara County",2013-10-01,2633,371,952,206,4162
"12271","Santa Clara County",2013-11-01,2577,363,955,198,4093
"12272","Santa Clara County",2013-12-01,2525,335,933,194,3987
"12273","Santa Clara County",2014-01-01,2536,351,898,164,3949
"12274","Santa Clara County",2014-02-01,2556,357,965,189,4067
"12275","Santa Clara County",2014-03-01,2571,364,1041,207,4183
"12276","Santa Clara County",2014-04-01,2606,377,1027,210,4220
"12277","Santa Clara County",2014-05-01,2581,378,1051,204,4214
"12278","Santa Clara County",2014-06-01,2558,365,1052,210,4185
"12279","Santa Clara County",2014-07-01,2558,377,1025,206,4166
"12280","Santa Clara County",2014-08-01,2595,364,1033,201,4193
"12281","Santa Clara County",2014-09-01,2597,376,1011,193,4177
"12282","Santa Clara County",2014-10-01,2606,380,981,197,4164
"12283","Santa Clara County",2014-11-01,2468,357,957,182,3964
"12284","Santa Clara County",2014-12-01,2298,319,873,157,3647
"12285","Santa Clara County",2015-01-01,2324,315,791,162,3592
"12286","Santa Clara County",2015-02-01,2313,318,809,164,3604
"12287","Santa Clara County",2015-03-01,2380,308,794,164,3646
"12288","Santa Clara County",2015-04-01,2330,296,799,164,3589
"12289","Santa Clara County",2015-05-01,2348,307,816,159,3630
"12290","Santa Clara County",2015-06-01,2362,295,876,162,3695
"12291","Santa Clara County",2015-07-01,2333,288,889,158,3668
"12292","Santa Clara County",2015-08-01,2302,278,859,161,3600
"12293","Santa Clara County",2015-09-01,2355,292,822,150,3619
"12294","Santa Clara County",2015-10-01,2357,296,831,154,3638
"12295","Santa Clara County",2015-11-01,2305,296,810,146,3557
"12296","Santa Clara County",2015-12-01,2272,284,780,138,3474
"12297","Santa Clara County",2016-01-01,2332,289,754,136,3511
"12298","Santa Clara County",2016-02-01,2319,299,776,139,3533
"12299","Santa Clara County",2016-03-01,2316,283,752,158,3509
"12300","Santa Clara County",2016-04-01,2379,265,778,163,3585
"12301","Santa Clara County",2016-05-01,2375,265,794,144,3578
"12302","Santa Clara County",2016-06-01,2368,254,789,139,3550
"12303","Santa Clara County",2016-07-01,2375,260,796,137,3568
"12304","Santa Clara County",2016-08-01,2401,274,781,131,3587
"12305","Santa Clara County",2016-09-01,2401,284,783,135,3603
"12306","Santa Clara County",2016-10-01,2379,285,811,137,3612
"12307","Santa Clara County",2016-11-01,2367,284,836,153,3640
"12308","Santa Clara County",2016-12-01,2262,276,841,147,3526
"12309","Santa Clara County",2017-01-01,2246,276,829,148,3499
"12310","Santa Clara County",2017-02-01,2303,280,819,153,3555
"12311","Santa Clara County",2017-03-01,2312,297,816,158,3583
"12312","Santa Clara County",2017-04-01,2276,291,850,149,3566
"12313","Santa Clara County",2017-05-01,2148,279,852,158,3437
"12314","Santa Clara County",2017-06-01,2213,281,818,152,3464
"12315","Santa Clara County",2017-07-01,2212,286,857,152,3507
"12316","Santa Clara County",2017-08-01,2206,279,838,158,3481
"12317","Santa Clara County",2017-09-01,2198,282,863,159,3502
"12318","Santa Clara County",2017-10-01,2107,269,823,139,3338
"12319","Santa Clara County",2017-11-01,2059,261,781,138,3239
"12320","Santa Clara County",2017-12-01,2037,243,710,140,3130
"12321","Santa Clara County",2018-01-01,2138,222,708,138,3206
"12322","Santa Clara County",2018-02-01,2161,275,699,143,3278
"12323","Santa Clara County",2018-03-01,2089,278,715,133,3215
"12324","Santa Clara County",2018-04-01,2090,294,712,139,3234
"12325","Santa Clara County",2018-05-01,2138,283,739,137,3297
"12326","Santa Clara County",2018-06-01,2162,293,759,146,3360
"12327","Santa Clara County",2018-07-01,2223,313,765,146,3447
"12328","Santa Clara County",2018-08-01,2246,307,777,144,3474
"12329","Santa Clara County",2018-09-01,2268,330,776,147,3521
"12330","Santa Clara County",2018-10-01,0,0,0,0,0
"12331","Santa Clara County",2018-11-01,0,0,0,0,0
"12332","Santa Clara County",2018-12-01,2122,274,652,121,3169
"12333","Santa Clara County",2019-01-01,2129,290,650,116,3185
"12334","Santa Clara County",2019-02-01,2161,301,620,123,3205
"12335","Santa Clara County",2019-03-01,2144,314,658,124,3240
"12336","Santa Clara County",2019-04-01,2179,309,666,119,3273
"12337","Santa Clara County",2019-05-01,2170,258,697,113,3238
"12338","Santa Clara County",2019-06-01,2215,252,668,104,3239
"12339","Santa Clara County",2019-07-01,2265,290,611,88,3254
"12340","Santa Clara County",2019-08-01,2252,292,602,98,3244
"12341","Santa Clara County",2019-09-01,2340,307,594,109,3350
"12342","Santa Clara County",2019-10-01,2361,308,568,106,3343
"12343","Santa Clara County",2019-11-01,2345,288,583,95,3311
"12344","Santa Clara County",2019-12-01,2328,267,562,83,3240
"12345","Santa Clara County",2020-01-01,2379,232,622,75,3308
"12346","Santa Clara County",2020-02-01,2341,240,625,73,3279
"12347","Santa Clara County",2020-03-01,2195,229,525,69,3018
"12348","Santa Cruz County",1995-10-01,217,20,248,29,514
"12349","Santa Cruz County",1995-11-01,194,20,226,27,467
"12350","Santa Cruz County",1995-12-01,190,17,259,23,489
"12351","Santa Cruz County",1996-01-01,192,21,293,23,529
"12352","Santa Cruz County",1996-02-01,200,11,285,33,529
"12353","Santa Cruz County",1996-03-01,196,12,291,30,529
"12354","Santa Cruz County",1996-04-01,189,18,280,27,514
"12355","Santa Cruz County",1996-05-01,207,23,266,39,535
"12356","Santa Cruz County",1996-06-01,207,21,283,37,548
"12357","Santa Cruz County",1996-07-01,190,20,291,30,531
"12358","Santa Cruz County",1996-08-01,185,27,277,25,514
"12359","Santa Cruz County",1996-09-01,204,24,272,33,533
"12360","Santa Cruz County",1996-10-01,207,25,291,37,560
"12361","Santa Cruz County",1996-11-01,208,23,293,45,569
"12362","Santa Cruz County",1996-12-01,223,23,285,41,572
"12363","Santa Cruz County",1997-01-01,214,17,310,48,589
"12364","Santa Cruz County",1997-02-01,206,24,336,43,609
"12365","Santa Cruz County",1997-03-01,215,29,329,43,616
"12366","Santa Cruz County",1997-04-01,206,26,324,52,608
"12367","Santa Cruz County",1997-05-01,214,27,335,46,622
"12368","Santa Cruz County",1997-06-01,203,28,292,44,567
"12369","Santa Cruz County",1997-07-01,210,29,296,43,578
"12370","Santa Cruz County",1997-08-01,204,24,306,45,579
"12371","Santa Cruz County",1997-09-01,221,26,310,37,594
"12372","Santa Cruz County",1997-10-01,200,7,360,57,624
"12373","Santa Cruz County",1997-11-01,165,17,368,46,596
"12374","Santa Cruz County",1997-12-01,164,39,347,64,614
"12375","Santa Cruz County",1998-01-01,195,23,386,48,652
"12376","Santa Cruz County",1998-02-01,196,24,389,45,654
"12377","Santa Cruz County",1998-03-01,224,21,367,51,663
"12378","Santa Cruz County",1998-04-01,205,22,338,56,621
"12379","Santa Cruz County",1998-05-01,239,25,338,47,649
"12380","Santa Cruz County",1998-06-01,224,24,331,51,630
"12381","Santa Cruz County",1998-07-01,212,18,310,44,584
"12382","Santa Cruz County",1998-08-01,204,23,307,42,576
"12383","Santa Cruz County",1998-09-01,233,32,336,52,653
"12384","Santa Cruz County",1998-10-01,235,27,362,45,669
"12385","Santa Cruz County",1998-11-01,211,24,344,39,618
"12386","Santa Cruz County",1998-12-01,192,22,325,44,583
"12387","Santa Cruz County",1999-01-01,191,21,324,44,580
"12388","Santa Cruz County",1999-02-01,216,24,322,47,609
"12389","Santa Cruz County",1999-03-01,198,23,323,50,594
"12390","Santa Cruz County",1999-04-01,183,24,318,49,574
"12391","Santa Cruz County",1999-05-01,203,22,308,45,578
"12392","Santa Cruz County",1999-06-01,214,28,292,41,575
"12393","Santa Cruz County",1999-07-01,207,28,282,38,555
"12394","Santa Cruz County",1999-08-01,219,30,314,48,611
"12395","Santa Cruz County",1999-09-01,214,26,312,40,592
"12396","Santa Cruz County",1999-10-01,210,26,340,39,615
"12397","Santa Cruz County",1999-11-01,196,25,325,44,590
"12398","Santa Cruz County",1999-12-01,189,27,259,38,513
"12399","Santa Cruz County",2000-01-01,215,27,287,38,567
"12400","Santa Cruz County",2000-02-01,222,29,304,37,592
"12401","Santa Cruz County",2000-03-01,224,30,302,38,594
"12402","Santa Cruz County",2000-04-01,217,29,329,42,617
"12403","Santa Cruz County",2000-05-01,213,27,312,44,596
"12404","Santa Cruz County",2000-06-01,221,27,311,45,604
"12405","Santa Cruz County",2000-07-01,217,25,298,46,586
"12406","Santa Cruz County",2000-08-01,220,28,296,45,589
"12407","Santa Cruz County",2000-09-01,218,32,283,45,578
"12408","Santa Cruz County",2000-10-01,216,30,293,42,581
"12409","Santa Cruz County",2000-11-01,235,35,297,36,603
"12410","Santa Cruz County",2000-12-01,241,34,272,46,593
"12411","Santa Cruz County",2001-01-01,235,33,282,50,600
"12412","Santa Cruz County",2001-02-01,217,25,320,51,613
"12413","Santa Cruz County",2001-03-01,218,23,295,42,578
"12414","Santa Cruz County",2001-04-01,244,24,284,36,588
"12415","Santa Cruz County",2001-05-01,253,23,281,36,593
"12416","Santa Cruz County",2001-06-01,249,24,283,35,591
"12417","Santa Cruz County",2001-07-01,230,26,252,33,541
"12418","Santa Cruz County",2001-08-01,235,20,234,30,519
"12419","Santa Cruz County",2001-09-01,241,27,213,25,506
"12420","Santa Cruz County",2001-10-01,255,26,225,27,533
"12421","Santa Cruz County",2001-11-01,273,28,231,23,555
"12422","Santa Cruz County",2001-12-01,241,28,249,16,534
"12423","Santa Cruz County",2002-01-01,230,29,241,22,522
"12424","Santa Cruz County",2002-02-01,245,29,277,28,579
"12425","Santa Cruz County",2002-03-01,220,28,263,39,550
"12426","Santa Cruz County",2002-04-01,241,30,254,39,564
"12427","Santa Cruz County",2002-05-01,243,30,259,28,560
"12428","Santa Cruz County",2002-06-01,249,31,252,29,561
"12429","Santa Cruz County",2002-07-01,258,37,245,33,573
"12430","Santa Cruz County",2002-08-01,265,13,265,57,600
"12431","Santa Cruz County",2002-09-01,254,38,264,42,598
"12432","Santa Cruz County",2002-10-01,260,42,249,42,593
"12433","Santa Cruz County",2002-11-01,267,35,269,46,617
"12434","Santa Cruz County",2002-12-01,252,40,267,46,605
"12435","Santa Cruz County",2003-01-01,225,37,257,47,566
"12436","Santa Cruz County",2003-02-01,249,39,268,45,601
"12437","Santa Cruz County",2003-03-01,256,36,274,42,608
"12438","Santa Cruz County",2003-04-01,285,34,257,33,609
"12439","Santa Cruz County",2003-05-01,300,34,248,36,618
"12440","Santa Cruz County",2003-06-01,302,29,264,41,636
"12441","Santa Cruz County",2003-07-01,287,32,265,41,625
"12442","Santa Cruz County",2003-08-01,276,31,270,42,619
"12443","Santa Cruz County",2003-09-01,285,33,263,39,620
"12444","Santa Cruz County",2003-10-01,273,32,274,40,619
"12445","Santa Cruz County",2003-11-01,273,32,256,37,598
"12446","Santa Cruz County",2003-12-01,263,38,239,37,577
"12447","Santa Cruz County",2004-01-01,269,37,243,31,580
"12448","Santa Cruz County",2004-02-01,270,32,260,39,601
"12449","Santa Cruz County",2004-03-01,252,39,269,46,606
"12450","Santa Cruz County",2004-04-01,254,34,273,52,613
"12451","Santa Cruz County",2004-05-01,254,30,285,52,621
"12452","Santa Cruz County",2004-06-01,253,38,293,44,628
"12453","Santa Cruz County",2004-07-01,254,36,284,45,619
"12454","Santa Cruz County",2004-08-01,245,36,280,46,607
"12455","Santa Cruz County",2004-09-01,255,36,273,50,614
"12456","Santa Cruz County",2004-10-01,239,38,282,40,599
"12457","Santa Cruz County",2004-11-01,222,34,263,41,560
"12458","Santa Cruz County",2004-12-01,239,34,257,45,575
"12459","Santa Cruz County",2005-01-01,239,33,254,42,568
"12460","Santa Cruz County",2005-02-01,246,33,263,41,583
"12461","Santa Cruz County",2005-03-01,237,31,276,38,582
"12462","Santa Cruz County",2005-04-01,248,33,283,35,599
"12463","Santa Cruz County",2005-05-01,258,35,280,38,611
"12464","Santa Cruz County",2005-06-01,258,31,275,42,606
"12465","Santa Cruz County",2005-07-01,258,31,282,44,615
"12466","Santa Cruz County",2005-08-01,252,30,284,46,612
"12467","Santa Cruz County",2005-09-01,252,31,285,47,615
"12468","Santa Cruz County",2005-10-01,251,24,289,51,615
"12469","Santa Cruz County",2005-11-01,228,25,293,38,584
"12470","Santa Cruz County",2005-12-01,227,29,291,31,578
"12471","Santa Cruz County",2006-01-01,236,31,266,35,568
"12472","Santa Cruz County",2006-02-01,236,25,284,45,590
"12473","Santa Cruz County",2006-03-01,224,21,275,42,562
"12474","Santa Cruz County",2006-04-01,198,29,278,37,542
"12475","Santa Cruz County",2006-05-01,208,28,243,33,512
"12476","Santa Cruz County",2006-06-01,200,28,245,38,511
"12477","Santa Cruz County",2006-07-01,207,32,247,38,524
"12478","Santa Cruz County",2006-08-01,206,32,257,44,539
"12479","Santa Cruz County",2006-09-01,211,32,240,35,518
"12480","Santa Cruz County",2006-10-01,209,30,242,34,515
"12481","Santa Cruz County",2006-11-01,200,33,240,44,517
"12482","Santa Cruz County",2006-12-01,206,31,203,44,484
"12483","Santa Cruz County",2007-01-01,219,37,206,45,507
"12484","Santa Cruz County",2007-02-01,226,34,223,45,528
"12485","Santa Cruz County",2007-03-01,219,31,241,46,537
"12486","Santa Cruz County",2007-04-01,210,30,248,41,529
"12487","Santa Cruz County",2007-05-01,190,30,246,43,509
"12488","Santa Cruz County",2007-06-01,199,29,242,42,512
"12489","Santa Cruz County",2007-07-01,201,27,243,42,513
"12490","Santa Cruz County",2007-08-01,198,28,223,44,493
"12491","Santa Cruz County",2007-09-01,206,27,237,42,512
"12492","Santa Cruz County",2007-10-01,196,25,253,38,512
"12493","Santa Cruz County",2007-11-01,191,31,230,40,492
"12494","Santa Cruz County",2007-12-01,181,27,234,48,490
"12495","Santa Cruz County",2008-01-01,171,28,229,49,477
"12496","Santa Cruz County",2008-02-01,180,27,236,53,496
"12497","Santa Cruz County",2008-03-01,173,21,222,78,494
"12498","Santa Cruz County",2008-04-01,170,25,251,22,468
"12499","Santa Cruz County",2008-05-01,175,23,245,36,479
"12500","Santa Cruz County",2008-06-01,150,21,258,39,468
"12501","Santa Cruz County",2008-07-01,174,19,237,34,464
"12502","Santa Cruz County",2008-08-01,169,23,222,20,434
"12503","Santa Cruz County",2008-09-01,185,25,207,34,451
"12504","Santa Cruz County",2008-10-01,176,23,219,36,454
"12505","Santa Cruz County",2008-11-01,174,19,225,37,455
"12506","Santa Cruz County",2008-12-01,170,23,208,30,431
"12507","Santa Cruz County",2009-01-01,174,42,201,13,430
"12508","Santa Cruz County",2009-02-01,186,21,216,34,457
"12509","Santa Cruz County",2009-03-01,197,22,226,37,482
"12510","Santa Cruz County",2009-04-01,187,25,233,38,483
"12511","Santa Cruz County",2009-05-01,177,29,225,35,466
"12512","Santa Cruz County",2009-06-01,184,20,221,31,456
"12513","Santa Cruz County",2009-07-01,182,16,231,36,465
"12514","Santa Cruz County",2009-08-01,200,20,228,29,477
"12515","Santa Cruz County",2009-09-01,200,25,207,24,456
"12516","Santa Cruz County",2009-10-01,200,22,201,33,456
"12517","Santa Cruz County",2009-11-01,197,25,190,31,443
"12518","Santa Cruz County",2009-12-01,199,28,193,27,447
"12519","Santa Cruz County",2010-01-01,206,26,199,30,461
"12520","Santa Cruz County",2010-02-01,211,29,178,29,447
"12521","Santa Cruz County",2010-03-01,209,25,172,34,440
"12522","Santa Cruz County",2010-04-01,204,29,157,33,423
"12523","Santa Cruz County",2010-05-01,208,25,157,36,426
"12524","Santa Cruz County",2010-06-01,197,24,171,38,430
"12525","Santa Cruz County",2010-07-01,207,26,189,41,463
"12526","Santa Cruz County",2010-08-01,223,24,184,34,465
"12527","Santa Cruz County",2010-09-01,220,29,185,35,469
"12528","Santa Cruz County",2010-10-01,225,26,166,30,447
"12529","Santa Cruz County",2010-11-01,254,23,135,29,441
"12530","Santa Cruz County",2010-12-01,228,24,140,18,410
"12531","Santa Cruz County",2011-01-01,186,17,200,26,429
"12532","Santa Cruz County",2011-02-01,186,17,195,30,428
"12533","Santa Cruz County",2011-03-01,192,21,170,29,412
"12534","Santa Cruz County",2011-04-01,205,18,170,25,418
"12535","Santa Cruz County",2011-05-01,190,21,191,22,424
"12536","Santa Cruz County",2011-06-01,221,14,198,18,451
"12537","Santa Cruz County",2011-07-01,217,19,196,35,467
"12538","Santa Cruz County",2011-08-01,243,16,178,19,456
"12539","Santa Cruz County",2011-09-01,245,27,170,15,457
"12540","Santa Cruz County",2011-10-01,233,25,154,16,428
"12541","Santa Cruz County",2011-11-01,227,18,138,20,403
"12542","Santa Cruz County",2011-12-01,215,16,133,17,381
"12543","Santa Cruz County",2012-01-01,219,14,130,20,383
"12544","Santa Cruz County",2012-02-01,220,16,140,22,398
"12545","Santa Cruz County",2012-03-01,219,24,136,22,401
"12546","Santa Cruz County",2012-04-01,207,18,146,19,390
"12547","Santa Cruz County",2012-05-01,208,20,155,24,407
"12548","Santa Cruz County",2012-06-01,189,55,152,25,421
"12549","Santa Cruz County",2012-07-01,238,20,135,17,410
"12550","Santa Cruz County",2012-08-01,248,23,147,26,444
"12551","Santa Cruz County",2012-09-01,241,18,138,35,432
"12552","Santa Cruz County",2012-10-01,242,22,139,35,438
"12553","Santa Cruz County",2012-11-01,249,19,124,33,425
"12554","Santa Cruz County",2012-12-01,234,23,121,26,404
"12555","Santa Cruz County",2013-01-01,239,24,115,22,400
"12556","Santa Cruz County",2013-02-01,243,28,112,21,404
"12557","Santa Cruz County",2013-03-01,247,32,130,16,425
"12558","Santa Cruz County",2013-04-01,238,27,123,18,406
"12559","Santa Cruz County",2013-05-01,229,28,124,21,402
"12560","Santa Cruz County",2013-06-01,217,24,141,20,402
"12561","Santa Cruz County",2013-07-01,219,28,132,18,397
"12562","Santa Cruz County",2013-08-01,251,32,121,20,424
"12563","Santa Cruz County",2013-09-01,284,37,109,18,448
"12564","Santa Cruz County",2013-10-01,306,32,111,20,469
"12565","Santa Cruz County",2013-11-01,308,31,103,23,465
"12566","Santa Cruz County",2013-12-01,287,39,103,22,451
"12567","Santa Cruz County",2014-01-01,275,39,100,24,438
"12568","Santa Cruz County",2014-02-01,282,34,106,26,448
"12569","Santa Cruz County",2014-03-01,257,33,113,24,427
"12570","Santa Cruz County",2014-04-01,249,38,125,23,435
"12571","Santa Cruz County",2014-05-01,231,31,116,24,402
"12572","Santa Cruz County",2014-06-01,248,30,114,21,413
"12573","Santa Cruz County",2014-07-01,260,33,114,14,421
"12574","Santa Cruz County",2014-08-01,253,33,97,13,396
"12575","Santa Cruz County",2014-09-01,267,32,99,15,413
"12576","Santa Cruz County",2014-10-01,257,31,128,15,431
"12577","Santa Cruz County",2014-11-01,254,28,123,18,423
"12578","Santa Cruz County",2014-12-01,236,29,115,17,397
"12579","Santa Cruz County",2015-01-01,247,27,112,12,398
"12580","Santa Cruz County",2015-02-01,240,28,108,12,388
"12581","Santa Cruz County",2015-03-01,239,27,113,10,389
"12582","Santa Cruz County",2015-04-01,241,26,133,10,410
"12583","Santa Cruz County",2015-05-01,250,25,145,9,429
"12584","Santa Cruz County",2015-06-01,248,23,127,14,412
"12585","Santa Cruz County",2015-07-01,246,21,120,12,399
"12586","Santa Cruz County",2015-08-01,238,28,58,78,402
"12587","Santa Cruz County",2015-09-01,239,25,118,12,394
"12588","Santa Cruz County",2015-10-01,228,78,65,14,385
"12589","Santa Cruz County",2015-11-01,222,25,110,14,371
"12590","Santa Cruz County",2015-12-01,238,27,105,15,385
"12591","Santa Cruz County",2016-01-01,238,21,104,12,375
"12592","Santa Cruz County",2016-02-01,230,16,120,11,377
"12593","Santa Cruz County",2016-03-01,222,17,139,15,393
"12594","Santa Cruz County",2016-04-01,234,20,131,19,404
"12595","Santa Cruz County",2016-05-01,226,20,135,16,397
"12596","Santa Cruz County",2016-06-01,227,29,136,11,403
"12597","Santa Cruz County",2016-07-01,240,26,141,23,430
"12598","Santa Cruz County",2016-08-01,244,22,132,21,419
"12599","Santa Cruz County",2016-09-01,253,23,131,20,427
"12600","Santa Cruz County",2016-10-01,271,19,111,17,418
"12601","Santa Cruz County",2016-11-01,251,22,106,18,397
"12602","Santa Cruz County",2016-12-01,245,20,106,11,382
"12603","Santa Cruz County",2017-01-01,257,24,89,12,382
"12604","Santa Cruz County",2017-02-01,265,22,83,17,387
"12605","Santa Cruz County",2017-03-01,255,30,88,13,386
"12606","Santa Cruz County",2017-04-01,268,22,92,4,386
"12607","Santa Cruz County",2017-05-01,269,34,93,12,408
"12608","Santa Cruz County",2017-06-01,274,34,87,15,410
"12609","Santa Cruz County",2017-07-01,280,38,91,16,425
"12610","Santa Cruz County",2017-08-01,296,29,91,17,433
"12611","Santa Cruz County",2017-09-01,168,31,152,39,390
"12612","Santa Cruz County",2017-10-01,167,30,150,38,385
"12613","Santa Cruz County",2017-11-01,279,27,117,21,444
"12614","Santa Cruz County",2017-12-01,268,27,118,19,432
"12615","Santa Cruz County",2018-01-01,269,28,105,23,425
"12616","Santa Cruz County",2018-02-01,280,34,118,22,454
"12617","Santa Cruz County",2018-03-01,268,31,120,16,435
"12618","Santa Cruz County",2018-04-01,275,27,115,18,435
"12619","Santa Cruz County",2018-05-01,290,27,109,16,442
"12620","Santa Cruz County",2018-06-01,291,33,112,10,446
"12621","Santa Cruz County",2018-07-01,308,37,120,13,478
"12622","Santa Cruz County",2018-08-01,298,40,109,13,460
"12623","Santa Cruz County",2018-09-01,301,36,117,16,470
"12624","Santa Cruz County",2018-10-01,286,34,113,14,447
"12625","Santa Cruz County",2018-11-01,273,35,92,16,416
"12626","Santa Cruz County",2018-12-01,294,33,102,16,445
"12627","Santa Cruz County",2019-01-01,277,39,81,15,412
"12628","Santa Cruz County",2019-02-01,295,34,74,15,418
"12629","Santa Cruz County",2019-03-01,259,34,95,23,411
"12630","Santa Cruz County",2019-04-01,238,30,89,25,382
"12631","Santa Cruz County",2019-05-01,277,36,73,24,410
"12632","Santa Cruz County",2019-06-01,303,41,83,21,448
"12633","Santa Cruz County",2019-07-01,290,45,74,17,426
"12634","Santa Cruz County",2019-08-01,271,39,72,16,398
"12635","Santa Cruz County",2019-09-01,267,34,70,16,387
"12636","Santa Cruz County",2019-10-01,268,36,76,13,393
"12637","Santa Cruz County",2019-11-01,262,36,75,14,387
"12638","Santa Cruz County",2019-12-01,246,31,75,15,367
"12639","Santa Cruz County",2020-01-01,244,28,73,17,362
"12640","Santa Cruz County",2020-02-01,235,34,76,20,365
"12641","Santa Cruz County",2020-03-01,223,28,74,21,346
"12642","Shasta County",1995-10-01,199.25,25.06,140.47,25.41,390.19
"12643","Shasta County",1995-11-01,199.6,25.6,138.16,25.06,388.42
"12644","Shasta County",1995-12-01,185.77,27.51,132.41,14.57,360.26
"12645","Shasta County",1996-01-01,200.45,30.26,124.35,16.94,372
"12646","Shasta County",1996-02-01,207,32,123,20,382
"12647","Shasta County",1996-03-01,205,31,142,25,403
"12648","Shasta County",1996-04-01,194,34,148,27,403
"12649","Shasta County",1996-05-01,186,28,144,33,391
"12650","Shasta County",1996-06-01,194.8,29.8,129.5,24.6,378.7
"12651","Shasta County",1996-07-01,202.9,26.6,92.7,16.8,339
"12652","Shasta County",1996-08-01,203.1,28.5,91.7,17.1,340.4
"12653","Shasta County",1996-09-01,213.5,28.4,99.2,16.8,357.9
"12654","Shasta County",1996-10-01,227,34,88,16,365
"12655","Shasta County",1996-11-01,215,33,92,15,355
"12656","Shasta County",1996-12-01,222,31,89,14,356
"12657","Shasta County",1997-01-01,224,30,88.1,17,359.1
"12658","Shasta County",1997-02-01,210.4,25.9,100.9,17.7,354.9
"12659","Shasta County",1997-03-01,222.7,27,102.3,8.3,360.3
"12660","Shasta County",1997-04-01,218.6,28.5,101,5.9,354
"12661","Shasta County",1997-05-01,210.1,26.6,109.4,10.2,356.3
"12662","Shasta County",1997-06-01,195.2,25.8,103,19.8,343.8
"12663","Shasta County",1997-07-01,184,32,89.5,24.3,329.8
"12664","Shasta County",1997-08-01,186,34.4,94.9,21,336.3
"12665","Shasta County",1997-09-01,192,37.4,97.2,22.2,348.8
"12666","Shasta County",1997-10-01,198.1,38,98.9,19.3,354.3
"12667","Shasta County",1997-11-01,200.2,38.3,98.6,16.6,353.7
"12668","Shasta County",1997-12-01,192.7,34.8,101.1,19.4,348
"12669","Shasta County",1998-01-01,185.9,38,105.8,18.4,348.1
"12670","Shasta County",1998-02-01,195,35,101.8,21.7,353.5
"12671","Shasta County",1998-03-01,204.3,32.9,93.7,21.8,352.7
"12672","Shasta County",1998-04-01,195,34.8,97.2,21.7,348.7
"12673","Shasta County",1998-05-01,174.9,40.8,111.7,18.5,345.9
"12674","Shasta County",1998-06-01,178.3,30.3,111.7,29.2,349.5
"12675","Shasta County",1998-07-01,167.8,32.1,113.9,27.2,341
"12676","Shasta County",1998-08-01,176.3,26.7,110.9,27.6,341.5
"12677","Shasta County",1998-09-01,176.9,26.7,101.8,24,329.4
"12678","Shasta County",1998-10-01,177.2,21.8,96.9,26.5,322.4
"12679","Shasta County",1998-11-01,173.7,18.8,106.2,22.6,321.3
"12680","Shasta County",1998-12-01,180.5,23.1,111.7,17.2,332.5
"12681","Shasta County",1999-01-01,188.2,29.1,100.7,19.1,337.1
"12682","Shasta County",1999-02-01,171.4,29.9,116.7,17.8,335.8
"12683","Shasta County",1999-03-01,167.9,29.5,124.7,18.8,340.9
"12684","Shasta County",1999-04-01,157.6,28.5,120.2,21.3,327.6
"12685","Shasta County",1999-05-01,175.2,32.9,104.7,23.7,336.5
"12686","Shasta County",1999-06-01,185.2,33.4,95.9,24.3,338.8
"12687","Shasta County",1999-07-01,174.6,31,96.6,25.1,327.3
"12688","Shasta County",1999-08-01,182.4,30.9,99.9,24.8,338
"12689","Shasta County",1999-09-01,177,39.8,103,23.1,342.9
"12690","Shasta County",1999-10-01,183.8,38.3,100.1,29.5,351.7
"12691","Shasta County",1999-11-01,173.5,28.5,115.5,25.8,343.3
"12692","Shasta County",1999-12-01,178.7,28.4,111.1,25.6,343.8
"12693","Shasta County",2000-01-01,193.4,26.8,112.6,24,356.8
"12694","Shasta County",2000-02-01,191.7,37.8,122.7,17.4,369.6
"12695","Shasta County",2000-03-01,202.3,30.6,119,18.5,370.4
"12696","Shasta County",2000-04-01,202.4,33.8,116.8,17.3,370.3
"12697","Shasta County",2000-05-01,210.6,34.7,63.7,102.9,411.9
"12698","Shasta County",2000-06-01,221.3,33.3,128.7,26.9,410.2
"12699","Shasta County",2000-07-01,217,35,138,26,416
"12700","Shasta County",2000-08-01,208,35,141,27,411
"12701","Shasta County",2000-09-01,200,34,148,26,408
"12702","Shasta County",2000-10-01,187,31,137,28,383
"12703","Shasta County",2000-11-01,191,34,126,27,378
"12704","Shasta County",2000-12-01,187,28,128,27,370
"12705","Shasta County",2001-01-01,205,34,127,28,394
"12706","Shasta County",2001-02-01,204,38,132,26,400
"12707","Shasta County",2001-03-01,202,43,131,25,401
"12708","Shasta County",2001-04-01,192,36,125,23,376
"12709","Shasta County",2001-05-01,182,36,139,27,384
"12710","Shasta County",2001-06-01,197,34,129,24,384
"12711","Shasta County",2001-07-01,195,38,145,25,403
"12712","Shasta County",2001-08-01,196,31,132,22,381
"12713","Shasta County",2001-09-01,191,31,145,19,386
"12714","Shasta County",2001-10-01,192,30,74,89,385
"12715","Shasta County",2001-11-01,199,35,136,20,390
"12716","Shasta County",2001-12-01,207,31,121,23,382
"12717","Shasta County",2002-01-01,235,40,113,22,410
"12718","Shasta County",2002-02-01,235,41,121,22,419
"12719","Shasta County",2002-03-01,221,32,134,27,414
"12720","Shasta County",2002-04-01,220,33,124,27,404
"12721","Shasta County",2002-05-01,219,35,129,25,408
"12722","Shasta County",2002-06-01,208,37,124,19,388
"12723","Shasta County",2002-07-01,205,33,128,28,394
"12724","Shasta County",2002-08-01,217,40,116,23,396
"12725","Shasta County",2002-09-01,228,38,101,27,394
"12726","Shasta County",2002-10-01,231,40,105,26,402
"12727","Shasta County",2002-11-01,226,38,119,23,406
"12728","Shasta County",2002-12-01,202,39,111,20,372
"12729","Shasta County",2003-01-01,220,38,81,23,362
"12730","Shasta County",2003-02-01,221,28,85,25,359
"12731","Shasta County",2003-03-01,235,34,70,22,361
"12732","Shasta County",2003-04-01,218,30,81,20,349
"12733","Shasta County",2003-05-01,190,33,85,19,327
"12734","Shasta County",2003-06-01,211,39,85,23,358
"12735","Shasta County",2003-07-01,206,39,91,25,361
"12736","Shasta County",2003-08-01,197,39,90,24,350
"12737","Shasta County",2003-09-01,216,41,83,20,360
"12738","Shasta County",2003-10-01,217,36,90,22,365
"12739","Shasta County",2003-11-01,226,42,85,24,377
"12740","Shasta County",2003-12-01,223,39,85,25,372
"12741","Shasta County",2004-01-01,235,37,65,24,361
"12742","Shasta County",2004-02-01,232,41,71,24,368
"12743","Shasta County",2004-03-01,225,38,79,20,362
"12744","Shasta County",2004-04-01,233,34,71,23,361
"12745","Shasta County",2004-05-01,221,37,83,19,360
"12746","Shasta County",2004-06-01,202,40,92,19,353
"12747","Shasta County",2004-07-01,214,38,90,21,363
"12748","Shasta County",2004-08-01,213,40,86,20,359
"12749","Shasta County",2004-09-01,219,34,84,27,364
"12750","Shasta County",2004-10-01,219,49,80,19,367
"12751","Shasta County",2004-11-01,220,42,77,17,356
"12752","Shasta County",2004-12-01,202,46,104,18,370
"12753","Shasta County",2005-01-01,211,44,90,17,362
"12754","Shasta County",2005-02-01,216,38,84,24,362
"12755","Shasta County",2005-03-01,219,42,84,23,368
"12756","Shasta County",2005-04-01,217,44,90,20,371
"12757","Shasta County",2005-05-01,234,58,82,19,393
"12758","Shasta County",2005-06-01,250,41,66,18,375
"12759","Shasta County",2005-07-01,263,46,60,15,384
"12760","Shasta County",2005-08-01,261,47,63,13,384
"12761","Shasta County",2005-09-01,258,46,64,17,385
"12762","Shasta County",2005-10-01,254,47,66,15,382
"12763","Shasta County",2005-11-01,251,50,59,12,372
"12764","Shasta County",2005-12-01,250,52,59,10,371
"12765","Shasta County",2006-01-01,248,50,64,12,374
"12766","Shasta County",2006-02-01,237,44,74,16,371
"12767","Shasta County",2006-03-01,234,43,74,18,369
"12768","Shasta County",2006-04-01,231,40,80,20,371
"12769","Shasta County",2006-05-01,224,42,84,19,369
"12770","Shasta County",2006-06-01,236,40,74,21,371
"12771","Shasta County",2006-07-01,231,44,80,15,370
"12772","Shasta County",2006-08-01,230,35,82,25,372
"12773","Shasta County",2006-09-01,224,44,87,17,372
"12774","Shasta County",2006-10-01,227,44,83,17,371
"12775","Shasta County",2006-11-01,224,42,89,19,374
"12776","Shasta County",2006-12-01,228,42,82,18,370
"12777","Shasta County",2007-01-01,231,42,81,18,372
"12778","Shasta County",2007-02-01,225,41,79,17,362
"12779","Shasta County",2007-03-01,226,40,72,17,355
"12780","Shasta County",2007-04-01,233,42,66,13,354
"12781","Shasta County",2007-05-01,238,38,64,17,357
"12782","Shasta County",2007-06-01,229,38,73,17,357
"12783","Shasta County",2007-07-01,204,36,92,20,352
"12784","Shasta County",2007-08-01,202,44,95,14,355
"12785","Shasta County",2007-09-01,207,43,88,16,354
"12786","Shasta County",2007-10-01,201,41,92,18,352
"12787","Shasta County",2007-11-01,206,42,88,15,351
"12788","Shasta County",2007-12-01,213,38,86,15,352
"12789","Shasta County",2008-01-01,223,34,74,20,351
"12790","Shasta County",2008-02-01,216,37,75,20,348
"12791","Shasta County",2008-03-01,223,24,72,13,332
"12792","Shasta County",2008-04-01,214,34,77,7,332
"12793","Shasta County",2008-05-01,225,36,69,12,342
"12794","Shasta County",2008-06-01,214,37,73,11,335
"12795","Shasta County",2008-07-01,215,39,76,12,342
"12796","Shasta County",2008-08-01,204,36,74,14,328
"12797","Shasta County",2008-09-01,220,38,73,9,340
"12798","Shasta County",2008-10-01,212,39,75,10,336
"12799","Shasta County",2008-11-01,270,23,25,17,335
"12800","Shasta County",2008-12-01,201,35,76,11,323
"12801","Shasta County",2009-01-01,204,44,67,14,329
"12802","Shasta County",2009-02-01,247,37,64,10,358
"12803","Shasta County",2009-03-01,204,43,73,8,328
"12804","Shasta County",2009-04-01,198,42,78,13,331
"12805","Shasta County",2009-05-01,210,33,65,20,328
"12806","Shasta County",2009-06-01,236,36,62,8,342
"12807","Shasta County",2009-07-01,155,18,34,7,214
"12808","Shasta County",2009-08-01,153,21,38,6,218
"12809","Shasta County",2009-09-01,143,18,44,8,213
"12810","Shasta County",2009-10-01,145,19,44,9,217
"12811","Shasta County",2009-11-01,147,20,41,7,215
"12812","Shasta County",2009-12-01,151,5,35,23,214
"12813","Shasta County",2010-01-01,151,21,36,8,216
"12814","Shasta County",2010-02-01,145,20,42,8,215
"12815","Shasta County",2010-03-01,149,21,42,5,217
"12816","Shasta County",2010-04-01,147,19,42,7,215
"12817","Shasta County",2010-05-01,153,24,43,5,225
"12818","Shasta County",2010-06-01,167,27,35,2,231
"12819","Shasta County",2010-07-01,171,20,36,8,235
"12820","Shasta County",2010-08-01,170,25,35,5,235
"12821","Shasta County",2010-09-01,170,25,35,3,233
"12822","Shasta County",2010-10-01,161,23,37,5,226
"12823","Shasta County",2010-11-01,165,22,38,6,231
"12824","Shasta County",2010-12-01,165,24,37,4,230
"12825","Shasta County",2011-01-01,171,24,30,5,230
"12826","Shasta County",2011-02-01,173,23,31,5,232
"12827","Shasta County",2011-03-01,170,25,34,3,232
"12828","Shasta County",2011-04-01,166,25,34,4,229
"12829","Shasta County",2011-05-01,162,25,36,4,227
"12830","Shasta County",2011-06-01,156,26,44,2,228
"12831","Shasta County",2011-07-01,167,26,34,3,230
"12832","Shasta County",2011-08-01,151,25,38,5,219
"12833","Shasta County",2011-09-01,166,26,38,4,234
"12834","Shasta County",2011-10-01,166,25,38,5,234
"12835","Shasta County",2011-11-01,159,20,41,9,229
"12836","Shasta County",2011-12-01,150,19,54,11,234
"12837","Shasta County",2012-01-01,154,20,49,10,233
"12838","Shasta County",2012-02-01,156,20,46,11,233
"12839","Shasta County",2012-03-01,152,24,42,10,228
"12840","Shasta County",2012-04-01,154,15,45,11,225
"12841","Shasta County",2012-05-01,155,18,39,11,223
"12842","Shasta County",2012-06-01,147,21,42,13,223
"12843","Shasta County",2012-07-01,163,10,39,11,223
"12844","Shasta County",2012-08-01,187,27,55,13,282
"12845","Shasta County",2012-09-01,216,31,51,16,314
"12846","Shasta County",2012-10-01,226,40,44,15,325
"12847","Shasta County",2012-11-01,219,31,67,12,329
"12848","Shasta County",2012-12-01,207,29,75,17,328
"12849","Shasta County",2013-01-01,187,27,91,19,324
"12850","Shasta County",2013-02-01,181,32,94,16,323
"12851","Shasta County",2013-03-01,178,32,98,16,324
"12852","Shasta County",2013-04-01,189,30,91,17,327
"12853","Shasta County",2013-05-01,182,30,86,20,318
"12854","Shasta County",2013-06-01,193,28,90,14,325
"12855","Shasta County",2013-07-01,204,35,75,15,329
"12856","Shasta County",2013-08-01,214,31,70,13,328
"12857","Shasta County",2013-09-01,200,42,70,11,323
"12858","Shasta County",2013-10-01,205,38,76,10,329
"12859","Shasta County",2013-11-01,200,40,78,10,328
"12860","Shasta County",2013-12-01,200,40,78,10,328
"12861","Shasta County",2014-01-01,200,37,76,12,325
"12862","Shasta County",2014-02-01,207,40,72,10,329
"12863","Shasta County",2014-03-01,209,47,71,7,334
"12864","Shasta County",2014-04-01,207,43,71,8,329
"12865","Shasta County",2014-05-01,212,33,73,11,329
"12866","Shasta County",2014-06-01,206,37,76,11,330
"12867","Shasta County",2014-07-01,220,40,65,15,340
"12868","Shasta County",2014-08-01,217,42,65,13,337
"12869","Shasta County",2014-09-01,215,37,70,15,337
"12870","Shasta County",2014-10-01,210,39,72,13,334
"12871","Shasta County",2014-11-01,199,39,81,13,332
"12872","Shasta County",2014-12-01,210,35,73,12,330
"12873","Shasta County",2015-01-01,216,36,73,13,338
"12874","Shasta County",2015-02-01,212,41,74,13,340
"12875","Shasta County",2015-03-01,226,36,52,15,329
"12876","Shasta County",2015-04-01,216,40,60,12,328
"12877","Shasta County",2015-05-01,215,41,60,11,327
"12878","Shasta County",2015-06-01,220,40,59,11,330
"12879","Shasta County",2015-07-01,216,40,59,11,326
"12880","Shasta County",2015-08-01,220,40,59,11,330
"12881","Shasta County",2015-09-01,190,39,70,15,314
"12882","Shasta County",2015-10-01,209,37,67,14,327
"12883","Shasta County",2015-11-01,213,39,61,10,323
"12884","Shasta County",2015-12-01,216,40,56,11,323
"12885","Shasta County",2016-01-01,221,34,68,12,335
"12886","Shasta County",2016-02-01,235,34,56,16,341
"12887","Shasta County",2016-03-01,232,44,52,11,339
"12888","Shasta County",2016-04-01,231,42,58,10,341
"12889","Shasta County",2016-05-01,232,41,56,6,335
"12890","Shasta County",2016-06-01,229,43,58,7,337
"12891","Shasta County",2016-07-01,235,41,50,7,333
"12892","Shasta County",2016-08-01,237,44,51,10,342
"12893","Shasta County",2016-09-01,225,42,53,13,333
"12894","Shasta County",2016-10-01,221,45,59,11,336
"12895","Shasta County",2016-11-01,224,42,64,9,339
"12896","Shasta County",2016-12-01,218,40,74,11,343
"12897","Shasta County",2017-01-01,210,41,75,9,335
"12898","Shasta County",2017-02-01,216,40,71,11,338
"12899","Shasta County",2017-03-01,217,36,71,13,337
"12900","Shasta County",2017-04-01,229,38,64,9,340
"12901","Shasta County",2017-05-01,214,38,72,17,341
"12902","Shasta County",2017-06-01,213,41,77,15,346
"12903","Shasta County",2017-07-01,217,39,73,16,345
"12904","Shasta County",2017-08-01,223,36,71,16,346
"12905","Shasta County",2017-09-01,219,36,74,17,346
"12906","Shasta County",2017-10-01,217,39,72,16,344
"12907","Shasta County",2017-11-01,220,36,79,15,350
"12908","Shasta County",2017-12-01,226,39,74,8,347
"12909","Shasta County",2018-01-01,219,41,79,13,352
"12910","Shasta County",2018-02-01,206,39,82,19,346
"12911","Shasta County",2018-03-01,217,38,70,17,342
"12912","Shasta County",2018-04-01,222,41,73,17,353
"12913","Shasta County",2018-05-01,217,40,80,14,351
"12914","Shasta County",2018-06-01,216,41,79,12,348
"12915","Shasta County",2018-07-01,221,49,86,11,367
"12916","Shasta County",2018-08-01,227,45,74,12,358
"12917","Shasta County",2018-09-01,229,42,68,16,355
"12918","Shasta County",2018-10-01,226,44,71,16,357
"12919","Shasta County",2018-11-01,215,45,76,15,351
"12920","Shasta County",2018-12-01,205,44,90,15,354
"12921","Shasta County",2019-01-01,228,44,86,18,376
"12922","Shasta County",2019-02-01,254,54,91,18,417
"12923","Shasta County",2019-03-01,245,49,122,21,437
"12924","Shasta County",2019-04-01,240,46,130,28,444
"12925","Shasta County",2019-05-01,236,41,129,30,436
"12926","Shasta County",2019-06-01,232,42,125,28,427
"12927","Shasta County",2019-07-01,238,44,117,25,424
"12928","Shasta County",2019-08-01,255,45,107,27,434
"12929","Shasta County",2019-09-01,261,47,102,24,434
"12930","Shasta County",2019-10-01,266,49,98,21,434
"12931","Shasta County",2019-11-01,262,52,100,20,434
"12932","Shasta County",2019-12-01,254,47,106,24,431
"12933","Shasta County",2020-01-01,258,45,109,22,434
"12934","Shasta County",2020-02-01,264,47,104,19,434
"12935","Shasta County",2020-03-01,245,46,104,18,413
"12936","Sierra County",1998-01-01,9,0,9,0,18
"12937","Sierra County",1998-02-01,2.3,0,0,0,2.3
"12938","Sierra County",1998-03-01,3,0,3,0,6
"12939","Sierra County",1998-04-01,2.4,0,2.7,0,5.1
"12940","Sierra County",1998-05-01,1.4,0,1.3,0,2.7
"12941","Sierra County",1998-06-01,1.5,0.1,0.7,0.03,2.33
"12942","Sierra County",1998-07-01,2.4,0.1,1.8,0,4.3
"12943","Sierra County",1998-08-01,1.4,0,0,0,1.4
"12944","Sierra County",1998-09-01,1.2,0,0.9,0,2.1
"12945","Sierra County",1998-10-01,1.6,0.1,1.8,0,3.5
"12946","Sierra County",1998-11-01,0.5,0.5,1.6,0,2.6
"12947","Sierra County",1998-12-01,0.3,0.3,0.5,0,1.1
"12948","Sierra County",1999-01-01,1.66,0,0.74,0,2.4
"12949","Sierra County",1999-02-01,0.46,0.07,0.75,0,1.28
"12950","Sierra County",1999-03-01,1.35,0,1.58,0,2.93
"12951","Sierra County",1999-04-01,2.7,0,1,0,3.7
"12952","Sierra County",1999-05-01,2.48,0,1.12,0,3.6
"12953","Sierra County",1999-06-01,4.4,0,0.33,0,4.73
"12954","Sierra County",1999-07-01,2.4,0,0.01,0,2.41
"12955","Sierra County",1999-08-01,2.45,0.23,1,0,3.68
"12956","Sierra County",1999-09-01,2.4,0,1.2,0,3.6
"12957","Sierra County",1999-10-01,2.48,0.06,2.61,0,5.15
"12958","Sierra County",1999-11-01,1,1,3.26,0,5.26
"12959","Sierra County",1999-12-01,1.42,0,0.06,0,1.48
"12960","Sierra County",2000-01-01,1.16,0.1,1.38,0.03,2.67
"12961","Sierra County",2000-02-01,1.44,0.03,2.06,0.27,3.8
"12962","Sierra County",2000-03-01,1.96,0.03,1.61,0.06,3.66
"12963","Sierra County",2000-04-01,2.25,0.19,1.64,0,4.08
"12964","Sierra County",2000-05-01,4,0.03,0.8,0,4.83
"12965","Sierra County",2000-06-01,1.86,0.06,0.66,0.2,2.78
"12966","Sierra County",2000-07-01,2.77,0.16,0.32,0,3.25
"12967","Sierra County",2000-08-01,3.06,0.06,0.38,0.06,3.56
"12968","Sierra County",2000-09-01,2.9,0.1,1.3,0,4.3
"12969","Sierra County",2000-10-01,2.61,0.03,1.9,0,4.54
"12970","Sierra County",2000-11-01,2.2,0.03,2.86,0,5.09
"12971","Sierra County",2000-12-01,1.67,0,2.32,0,3.99
"12972","Sierra County",2001-01-01,3,0,1,0,4
"12973","Sierra County",2001-02-01,2,0,1,0,3
"12974","Sierra County",2001-03-01,2,0,1,0,3
"12975","Sierra County",2001-04-01,4,0,2,0,6
"12976","Sierra County",2001-05-01,5,0,2,0,7
"12977","Sierra County",2001-06-01,4,0,2,0,5
"12978","Sierra County",2001-07-01,5,0,2,0,7
"12979","Sierra County",2001-08-01,3,0,1,0,4
"12980","Sierra County",2001-09-01,3,0,1,0,4
"12981","Sierra County",2001-10-01,2,0,1,0,3
"12982","Sierra County",2001-11-01,3,0,1,0,4
"12983","Sierra County",2001-12-01,1,0,1,0,2
"12984","Sierra County",2002-01-01,1,0,1,0,2
"12985","Sierra County",2002-02-01,3,0,5,0,8
"12986","Sierra County",2002-03-01,1,0,3,0,4
"12987","Sierra County",2002-04-01,3,0,2,0,5
"12988","Sierra County",2002-05-01,3,0,2,0,5
"12989","Sierra County",2002-06-01,4,0,1,0,5
"12990","Sierra County",2002-07-01,2,0,2,0,4
"12991","Sierra County",2002-08-01,2,1,1,0,4
"12992","Sierra County",2002-09-01,2,1,1,0,4
"12993","Sierra County",2002-10-01,3,0,1,0,4
"12994","Sierra County",2002-11-01,2,0,1,0,3
"12995","Sierra County",2002-12-01,3,0,1,0,4
"12996","Sierra County",2003-01-01,3,1,1,1,6
"12997","Sierra County",2003-02-01,4,0,1,0,5
"12998","Sierra County",2003-03-01,5,0,2,0,7
"12999","Sierra County",2003-04-01,3,1,1,0,5
"13000","Sierra County",2003-05-01,4,1,1,0,6
"13001","Sierra County",2003-06-01,5,0,2,0,7
"13002","Sierra County",2003-07-01,4,0,3,0,7
"13003","Sierra County",2003-08-01,5,0,2,0,7
"13004","Sierra County",2003-09-01,6,0,3,0,9
"13005","Sierra County",2003-10-01,3,0,2,0,5
"13006","Sierra County",2003-11-01,5,1,1,0,7
"13007","Sierra County",2003-12-01,5,1,1,1,8
"13008","Sierra County",2004-01-01,5,1,4,0,10
"13009","Sierra County",2004-02-01,5,1,2,0,8
"13010","Sierra County",2004-03-01,3,1,4,0,8
"13011","Sierra County",2004-04-01,3,1,2,0,6
"13012","Sierra County",2004-05-01,4,1,4,0,9
"13013","Sierra County",2004-06-01,4,1,2,0,7
"13014","Sierra County",2004-07-01,3,1,2,0,6
"13015","Sierra County",2004-08-01,4,1,4,0,9
"13016","Sierra County",2004-09-01,4,1,2,0,7
"13017","Sierra County",2004-10-01,4,1,2,0,7
"13018","Sierra County",2004-11-01,4,1,2,0,7
"13019","Sierra County",2004-12-01,4,1,2,0,7
"13020","Sierra County",2005-01-01,4,1,2,0,7
"13021","Sierra County",2005-02-01,4,1,2,0,7
"13022","Sierra County",2005-03-01,4,1,2,0,7
"13023","Sierra County",2005-04-01,4,1,2,0,7
"13024","Sierra County",2005-05-01,4,1,2,0,7
"13025","Sierra County",2005-06-01,4,1,2,0,7
"13026","Sierra County",2005-07-01,4,1,2,0,7
"13027","Sierra County",2005-08-01,4,1,2,0,7
"13028","Sierra County",2005-09-01,4,1,2,0,7
"13029","Sierra County",2005-10-01,4,1,2,0,7
"13030","Sierra County",2005-11-01,4,1,2,0,7
"13031","Sierra County",2005-12-01,4,1,2,0,7
"13032","Sierra County",2006-01-01,8,0,1,0,9
"13033","Sierra County",2006-02-01,10,0,2,0,12
"13034","Sierra County",2006-03-01,9,0,2,0,11
"13035","Sierra County",2006-04-01,8,0,1,0,9
"13036","Sierra County",2006-05-01,7,1,2,0,10
"13037","Sierra County",2006-06-01,6,1,3,0,10
"13038","Sierra County",2006-07-01,7,1,0,0,8
"13039","Sierra County",2006-08-01,8,2,2,1,13
"13040","Sierra County",2006-09-01,6,1,2,0,9
"13041","Sierra County",2006-10-01,4,2,2,1,9
"13042","Sierra County",2006-11-01,3,1,1,1,6
"13043","Sierra County",2006-12-01,5,1,3,0,9
"13044","Sierra County",2007-01-01,3,4,1,0,8
"13045","Sierra County",2007-02-01,3,1,2,1,7
"13046","Sierra County",2007-03-01,3,1,2,1,7
"13047","Sierra County",2007-04-01,4,1,2,0,7
"13048","Sierra County",2007-05-01,7,2,0,0,9
"13049","Sierra County",2007-06-01,4,2,1,1,8
"13050","Sierra County",2007-07-01,6,3,0,0,9
"13051","Sierra County",2007-08-01,5,2,0,1,8
"13052","Sierra County",2007-09-01,4,1,2,0,7
"13053","Sierra County",2007-10-01,6,1,2,1,10
"13054","Sierra County",2007-11-01,4,1,1,0,6
"13055","Sierra County",2007-12-01,4,1,3,0,8
"13056","Sierra County",2008-01-01,5,1,2,0,8
"13057","Sierra County",2008-02-01,3,1,2,0,6
"13058","Sierra County",2008-03-01,4,1,2,1,8
"13059","Sierra County",2008-04-01,3,1,2,0,6
"13060","Sierra County",2008-05-01,2,1,2,0,5
"13061","Sierra County",2008-06-01,1,1,1,0,3
"13062","Sierra County",2008-07-01,2,1,1,0,4
"13063","Sierra County",2008-08-01,3,1,0,0,4
"13064","Sierra County",2008-09-01,3,1,1,0,5
"13065","Sierra County",2008-10-01,5,1,1,0,7
"13066","Sierra County",2008-11-01,4,1,2,0,7
"13067","Sierra County",2008-12-01,3,2,1,1,7
"13068","Sierra County",2009-01-01,4,1,1,1,7
"13069","Sierra County",2009-02-01,4,1,1,1,7
"13070","Sierra County",2009-03-01,4,1,2,0,7
"13071","Sierra County",2009-04-01,4,1,2,0,7
"13072","Sierra County",2009-05-01,5,1,1,0,7
"13073","Sierra County",2009-06-01,3,1,1,0,5
"13074","Sierra County",2009-07-01,4,1,1,1,7
"13075","Sierra County",2009-08-01,4,1,3,0,8
"13076","Sierra County",2009-09-01,6,3,0,0,9
"13077","Sierra County",2009-10-01,4,1,2,1,8
"13078","Sierra County",2009-11-01,5,1,2,0,8
"13079","Sierra County",2009-12-01,3,1,2,0,6
"13080","Sierra County",2010-01-01,4,1,1,1,7
"13081","Sierra County",2010-02-01,4,1,1,1,7
"13082","Sierra County",2010-03-01,4,1,2,0,7
"13083","Sierra County",2010-04-01,5,1,1,0,7
"13084","Sierra County",2010-05-01,4,2,2,1,9
"13085","Sierra County",2010-06-01,7,1,0,0,8
"13086","Sierra County",2010-07-01,4,1,3,0,8
"13087","Sierra County",2010-08-01,6,3,0,0,9
"13088","Sierra County",2010-09-01,5,2,0,1,8
"13089","Sierra County",2010-10-01,4,1,0,0,5
"13090","Sierra County",2010-11-01,2,1,1,0,4
"13091","Sierra County",2010-12-01,4,1,3,0,8
"13092","Sierra County",2011-01-01,8,0,1,0,9
"13093","Sierra County",2011-02-01,3,1,0,0,4
"13094","Sierra County",2011-03-01,4,1,2,0,7
"13095","Sierra County",2011-04-01,6,1,2,0,9
"13096","Sierra County",2011-05-01,6,1,3,0,10
"13097","Sierra County",2011-06-01,1,1,1,0,3
"13098","Sierra County",2011-07-01,2,0,0,0,2
"13099","Sierra County",2011-08-01,2,1,0,0,3
"13100","Sierra County",2011-09-01,3,1,1,0,5
"13101","Sierra County",2011-10-01,3,1,1,0,5
"13102","Sierra County",2011-11-01,4,1,1,0,6
"13103","Sierra County",2011-12-01,3,1,2,0,6
"13104","Sierra County",2012-01-01,1,0,2,1,4
"13105","Sierra County",2012-02-01,0,0,2,0,2
"13106","Sierra County",2012-03-01,0,0,2,0,2
"13107","Sierra County",2012-04-01,0,0,2,0,2
"13108","Sierra County",2012-05-01,2,0,0,1,3
"13109","Sierra County",2012-06-01,2,1,0,0,3
"13110","Sierra County",2012-07-01,3,1,0,1,5
"13111","Sierra County",2012-08-01,2,1,0,1,4
"13112","Sierra County",2012-09-01,2,1,0,1,4
"13113","Sierra County",2012-10-01,3,0,1,1,5
"13114","Sierra County",2012-11-01,1,1,1,1,4
"13115","Sierra County",2012-12-01,0,0,1,1,2
"13116","Sierra County",2013-01-01,1,0,1,1,3
"13117","Sierra County",2013-02-01,1,1,1,0,3
"13118","Sierra County",2013-03-01,1,0,1,1,3
"13119","Sierra County",2013-04-01,2,0,1,0,3
"13120","Sierra County",2013-05-01,3,0,1,0,4
"13121","Sierra County",2013-06-01,4,0,1,0,5
"13122","Sierra County",2013-07-01,1,0,3,1,5
"13123","Sierra County",2013-08-01,2,1,1,1,5
"13124","Sierra County",2013-09-01,3,1,1,1,6
"13125","Sierra County",2013-10-01,3,0,0,1,4
"13126","Sierra County",2013-11-01,3,1,0,1,5
"13127","Sierra County",2013-12-01,3,2,1,1,7
"13128","Sierra County",2014-01-01,5,1,1,3,10
"13129","Sierra County",2014-02-01,6,0,2,1,9
"13130","Sierra County",2014-03-01,5,0,2,1,8
"13131","Sierra County",2014-04-01,3,0,2,1,6
"13132","Sierra County",2014-05-01,3,1,1,0,5
"13133","Sierra County",2014-06-01,3,0,1,0,4
"13134","Sierra County",2014-07-01,2,0,1,1,4
"13135","Sierra County",2014-08-01,3,1,1,0,5
"13136","Sierra County",2014-09-01,3,2,1,0,6
"13137","Sierra County",2014-10-01,3,1,1,0,5
"13138","Sierra County",2014-11-01,2,1,1,0,4
"13139","Sierra County",2014-12-01,1,0,1,0,2
"13140","Sierra County",2015-01-01,0,0,1,0,1
"13141","Sierra County",2015-02-01,1,0,1,0,2
"13142","Sierra County",2015-03-01,0,0,1,0,1
"13143","Siskiyou County",1995-10-01,45,2,36,11,94
"13144","Siskiyou County",1995-11-01,34,8,43,3,88
"13145","Siskiyou County",1995-12-01,38,1,34,7,80
"13146","Siskiyou County",1996-01-01,34,2,44,8,88
"13147","Siskiyou County",1996-02-01,30,4,40,8,82
"13148","Siskiyou County",1996-03-01,38,5,40,9,92
"13149","Siskiyou County",1996-04-01,40,5,38,8,91
"13150","Siskiyou County",1996-05-01,36,9,35,5,85
"13151","Siskiyou County",1996-06-01,41,9,31,4,85
"13152","Siskiyou County",1996-07-01,43,8,30,8,89
"13153","Siskiyou County",1996-08-01,41,3,34,8,86
"13154","Siskiyou County",1996-09-01,45,4,28,6,83
"13155","Siskiyou County",1996-10-01,44,5,29,7,85
"13156","Siskiyou County",1996-11-01,41,6,33,4,84
"13157","Siskiyou County",1996-12-01,44,4,28,6,82
"13158","Siskiyou County",1997-01-01,29,7,43,5,84
"13159","Siskiyou County",1997-02-01,44,8,32,7,91
"13160","Siskiyou County",1997-03-01,35,12,31,9,87
"13161","Siskiyou County",1997-04-01,36,11,37,5,89
"13162","Siskiyou County",1997-05-01,41,7,36,7,91
"13163","Siskiyou County",1997-06-01,38,8,37,7,90
"13164","Siskiyou County",1997-07-01,36,5,40,6,87
"13165","Siskiyou County",1997-08-01,44,6,27,7,84
"13166","Siskiyou County",1997-09-01,43,7,25,9,84
"13167","Siskiyou County",1997-10-01,45,7,27,9,88
"13168","Siskiyou County",1997-11-01,44,7,27,9,87
"13169","Siskiyou County",1997-12-01,43,6,26,9,84
"13170","Siskiyou County",1998-01-01,41,8,25,10,84
"13171","Siskiyou County",1998-02-01,45,10,28,5,88
"13172","Siskiyou County",1998-03-01,44,8,30,5,87
"13173","Siskiyou County",1998-04-01,45,8,31,5,89
"13174","Siskiyou County",1998-05-01,44,9,30,6,89
"13175","Siskiyou County",1998-06-01,44,7,29,5,85
"13176","Siskiyou County",1998-07-01,41,7,30,3,81
"13177","Siskiyou County",1998-08-01,44,9,27,3,83
"13178","Siskiyou County",1998-09-01,41,9,20,10,80
"13179","Siskiyou County",1998-10-01,40,9,22,4,75
"13180","Siskiyou County",1998-11-01,36,7,28,3,74
"13181","Siskiyou County",1998-12-01,39,9,31,3,82
"13182","Siskiyou County",1999-01-01,40,10,33,4,87
"13183","Siskiyou County",1999-02-01,39,10,32,3,84
"13184","Siskiyou County",1999-03-01,40,11,36,3,90
"13185","Siskiyou County",1999-04-01,42,4,36,6,88
"13186","Siskiyou County",1999-05-01,44,9,30,4,87
"13187","Siskiyou County",1999-06-01,60,8,20,2,90
"13188","Siskiyou County",1999-07-01,49,8,26,3,86
"13189","Siskiyou County",1999-08-01,51,9,27,3,90
"13190","Siskiyou County",1999-09-01,49,10,28,4,91
"13191","Siskiyou County",1999-10-01,56,9,21,4,90
"13192","Siskiyou County",1999-11-01,53,8,22,3,86
"13193","Siskiyou County",1999-12-01,54,11,26,5,96
"13194","Siskiyou County",2000-01-01,50,15,22,4,91
"13195","Siskiyou County",2000-02-01,51,10,27,2,90
"13196","Siskiyou County",2000-03-01,49,10,24,3,86
"13197","Siskiyou County",2000-04-01,50,10,27,2,89
"13198","Siskiyou County",2000-05-01,49,11,26,3,89
"13199","Siskiyou County",2000-06-01,46,8,26,2,82
"13200","Siskiyou County",2000-07-01,46,6,23,1,76
"13201","Siskiyou County",2000-08-01,50,5,28,3,86
"13202","Siskiyou County",2000-09-01,51,5,32,4,92
"13203","Siskiyou County",2000-10-01,53,6,31,4,94
"13204","Siskiyou County",2000-11-01,49,7,33,2,91
"13205","Siskiyou County",2000-12-01,51,4,34,2,91
"13206","Siskiyou County",2001-01-01,50,5,29,3,87
"13207","Siskiyou County",2001-02-01,52,6,31,4,93
"13208","Siskiyou County",2001-03-01,50,6,33,5,94
"13209","Siskiyou County",2001-04-01,51,4,32,7,94
"13210","Siskiyou County",2001-05-01,49,3,29,8,89
"13211","Siskiyou County",2001-06-01,44,4,27,8,83
"13212","Siskiyou County",2001-07-01,47,7,27,9,90
"13213","Siskiyou County",2001-08-01,57,9,29,2,97
"13214","Siskiyou County",2001-09-01,54,6,29,4,93
"13215","Siskiyou County",2001-10-01,51,3,28,6,88
"13216","Siskiyou County",2001-11-01,71,2,17,5,95
"13217","Siskiyou County",2001-12-01,81,4,24,3,112
"13218","Siskiyou County",2002-01-01,61,14,20,3,98
"13219","Siskiyou County",2002-02-01,58,10,31,5,104
"13220","Siskiyou County",2002-03-01,66,9,19,3,97
"13221","Siskiyou County",2002-04-01,58,13,15,7,93
"13222","Siskiyou County",2002-05-01,40,3,18,1,62
"13223","Siskiyou County",2002-06-01,56,3,19,6,84
"13224","Siskiyou County",2002-07-01,44,4,15,2,65
"13225","Siskiyou County",2002-08-01,61,6,25,4,96
"13226","Siskiyou County",2002-09-01,76,6,14,4,100
"13227","Siskiyou County",2002-10-01,62,2,28,11,103
"13228","Siskiyou County",2002-11-01,67,2,21,4,94
"13229","Siskiyou County",2002-12-01,67,2,21,4,94
"13230","Siskiyou County",2003-01-01,65,7,18,3,93
"13231","Siskiyou County",2003-02-01,61,9,26,2,98
"13232","Siskiyou County",2003-03-01,60,8,28,4,100
"13233","Siskiyou County",2003-04-01,62,7,26,3,98
"13234","Siskiyou County",2003-05-01,65,6,28,3,102
"13235","Siskiyou County",2003-06-01,78,7,18,0,103
"13236","Siskiyou County",2003-07-01,68,8,28,1,105
"13237","Siskiyou County",2003-08-01,65,7,27,2,101
"13238","Siskiyou County",2003-09-01,57,3,28,9,97
"13239","Siskiyou County",2003-10-01,64,5,27,3,99
"13240","Siskiyou County",2003-11-01,66,4,25,2,97
"13241","Siskiyou County",2003-12-01,71,6,19,5,101
"13242","Siskiyou County",2004-01-01,75,1,21,6,103
"13243","Siskiyou County",2004-02-01,77,8,19,4,108
"13244","Siskiyou County",2004-03-01,88,9,21,4,122
"13245","Siskiyou County",2004-04-01,85,5,21,4,115
"13246","Siskiyou County",2004-05-01,81,6,19,2,108
"13247","Siskiyou County",2004-06-01,77,11,10,2,100
"13248","Siskiyou County",2004-07-01,79,8,11,3,101
"13249","Siskiyou County",2004-08-01,77,16,7,2,102
"13250","Siskiyou County",2004-09-01,85,11,12,2,110
"13251","Siskiyou County",2004-10-01,74,12,7,1,94
"13252","Siskiyou County",2004-11-01,75,11,10,3,99
"13253","Siskiyou County",2004-12-01,76,11,7,1,95
"13254","Siskiyou County",2005-01-01,58,5,17,3,83
"13255","Siskiyou County",2005-02-01,64,5,23,3,95
"13256","Siskiyou County",2005-03-01,70,3,15,5,93
"13257","Siskiyou County",2005-04-01,69,5,17,4,95
"13258","Siskiyou County",2005-05-01,71,2,15,9,97
"13259","Siskiyou County",2005-06-01,68,7,14,5,94
"13260","Siskiyou County",2005-07-01,63,8,11,9,91
"13261","Siskiyou County",2005-08-01,69,6,15,3,93
"13262","Siskiyou County",2005-09-01,69,6,15,3,93
"13263","Siskiyou County",2005-10-01,70,6,13,3,92
"13264","Siskiyou County",2005-11-01,74,6,11,2,93
"13265","Siskiyou County",2005-12-01,73,4,13,1,91
"13266","Siskiyou County",2006-01-01,77,7,17,2,103
"13267","Siskiyou County",2006-02-01,77,7,17,2,103
"13268","Siskiyou County",2006-03-01,76,5,14,1,96
"13269","Siskiyou County",2006-04-01,78,7,15,2,102
"13270","Siskiyou County",2006-05-01,74,2,16,1,93
"13271","Siskiyou County",2006-06-01,77,6,15,0,98
"13272","Siskiyou County",2006-07-01,83,8,15,3,109
"13273","Siskiyou County",2006-08-01,87,7,6,2,102
"13274","Siskiyou County",2006-09-01,85,6,8,3,102
"13275","Siskiyou County",2006-10-01,83,7,10,1,101
"13276","Siskiyou County",2006-11-01,80,2,11,0,93
"13277","Siskiyou County",2006-12-01,77,8,9,3,97
"13278","Siskiyou County",2007-01-01,71,5,6,2,84
"13279","Siskiyou County",2007-02-01,69,6,11,2,88
"13280","Siskiyou County",2007-03-01,59,2,13,2,76
"13281","Siskiyou County",2007-04-01,63,8,12,2,85
"13282","Siskiyou County",2007-05-01,66,4,17,5,92
"13283","Siskiyou County",2007-06-01,69,3,19,2,93
"13284","Siskiyou County",2007-07-01,71,4,20,0,95
"13285","Siskiyou County",2007-08-01,68,4,18,1,91
"13286","Siskiyou County",2007-09-01,61,7,17,4,89
"13287","Siskiyou County",2007-10-01,63,9,19,1,92
"13288","Siskiyou County",2007-11-01,76,3,11,1,91
"13289","Siskiyou County",2007-12-01,55,4,11,6,76
"13290","Siskiyou County",2008-01-01,56,3,9,7,75
"13291","Siskiyou County",2008-02-01,68,8,6,2,84
"13292","Siskiyou County",2008-03-01,72,7,10,4,93
"13293","Siskiyou County",2008-04-01,68,4,11,4,87
"13294","Siskiyou County",2008-05-01,62,3,15,5,85
"13295","Siskiyou County",2008-06-01,62,8,12,2,84
"13296","Siskiyou County",2008-07-01,69,4,9,3,85
"13297","Siskiyou County",2008-08-01,68,5,12,4,89
"13298","Siskiyou County",2008-09-01,73,5,10,6,94
"13299","Siskiyou County",2008-10-01,69,4,11,7,91
"13300","Siskiyou County",2008-11-01,61,4,9,8,82
"13301","Siskiyou County",2008-12-01,59,7,11,9,86
"13302","Siskiyou County",2009-01-01,61,8,15,7,91
"13303","Siskiyou County",2009-02-01,62,7,17,7,93
"13304","Siskiyou County",2009-03-01,63,6,19,5,93
"13305","Siskiyou County",2009-04-01,61,4,21,3,89
"13306","Siskiyou County",2009-05-01,58,5,19,5,87
"13307","Siskiyou County",2009-06-01,55,5,21,4,85
"13308","Siskiyou County",2009-07-01,54,6,22,5,87
"13309","Siskiyou County",2009-08-01,57,13,20,3,93
"13310","Siskiyou County",2009-09-01,60,11,22,3,96
"13311","Siskiyou County",2009-10-01,62,14,19,2,97
"13312","Siskiyou County",2009-11-01,62,14,19,2,97
"13313","Siskiyou County",2009-12-01,47,6,30,2,85
"13314","Siskiyou County",2010-01-01,63,7,17,3,90
"13315","Siskiyou County",2010-02-01,67,8,15,2,92
"13316","Siskiyou County",2010-03-01,64,9,17,3,93
"13317","Siskiyou County",2010-04-01,61,6,17,3,87
"13318","Siskiyou County",2010-05-01,66,2,14,2,84
"13319","Siskiyou County",2010-06-01,59,7,16,2,84
"13320","Siskiyou County",2010-07-01,55,7,17,2,81
"13321","Siskiyou County",2010-08-01,48,3,25,3,79
"13322","Siskiyou County",2010-09-01,47,5,23,5,80
"13323","Siskiyou County",2010-10-01,55,8,17,7,87
"13324","Siskiyou County",2010-11-01,48,9,25,5,87
"13325","Siskiyou County",2010-12-01,49,5,24,1,79
"13326","Siskiyou County",2011-01-01,69,9,6,1,85
"13327","Siskiyou County",2011-02-01,73,6,15,5,99
"13328","Siskiyou County",2011-03-01,75,5,16,3,99
"13329","Siskiyou County",2011-04-01,74,7,18,3,102
"13330","Siskiyou County",2011-05-01,69,9,21,0,99
"13331","Siskiyou County",2011-06-01,71,6,22,1,100
"13332","Siskiyou County",2011-07-01,80,4,14,0,98
"13333","Siskiyou County",2011-08-01,73,5,13,0,91
"13334","Siskiyou County",2011-09-01,71,6,12,1,90
"13335","Siskiyou County",2011-10-01,59,6,21,0,86
"13336","Siskiyou County",2011-11-01,76,4,10,1,91
"13337","Siskiyou County",2011-12-01,77,3,11,5,96
"13338","Siskiyou County",2012-01-01,61,6,19,2,88
"13339","Siskiyou County",2012-02-01,64,5,20,2,91
"13340","Siskiyou County",2012-03-01,64,8,13,4,89
"13341","Siskiyou County",2012-04-01,66,9,15,3,93
"13342","Siskiyou County",2012-05-01,64,10,21,3,98
"13343","Siskiyou County",2012-06-01,63,11,19,2,95
"13344","Siskiyou County",2012-07-01,59,10,21,4,94
"13345","Siskiyou County",2012-08-01,56,9,20,6,91
"13346","Siskiyou County",2012-09-01,63,8,19,4,94
"13347","Siskiyou County",2012-10-01,64,10,21,1,96
"13348","Siskiyou County",2012-11-01,56,8,19,2,85
"13349","Siskiyou County",2012-12-01,49,9,19,2,79
"13350","Siskiyou County",2013-01-01,62,12,18,1,93
"13351","Siskiyou County",2013-02-01,65,11,21,1,98
"13352","Siskiyou County",2013-03-01,68,10,21,3,102
"13353","Siskiyou County",2013-04-01,64,5,25,5,99
"13354","Siskiyou County",2013-05-01,66,9,22,2,99
"13355","Siskiyou County",2013-06-01,65,8,21,2,96
"13356","Siskiyou County",2013-07-01,67,9,22,2,100
"13357","Siskiyou County",2013-08-01,70,10,19,2,101
"13358","Siskiyou County",2013-09-01,66,9,21,2,98
"13359","Siskiyou County",2013-10-01,69,7,22,2,100
"13360","Siskiyou County",2013-11-01,71,5,23,1,100
"13361","Siskiyou County",2013-12-01,62,8,19,2,91
"13362","Siskiyou County",2014-01-01,65,9,20,0,94
"13363","Siskiyou County",2014-02-01,63,7,21,3,94
"13364","Siskiyou County",2014-03-01,64,9,22,2,97
"13365","Siskiyou County",2014-04-01,70,8,20,2,100
"13366","Siskiyou County",2014-05-01,68,8,18,1,95
"13367","Siskiyou County",2014-06-01,64,10,19,0,93
"13368","Siskiyou County",2014-07-01,72,8,17,0,97
"13369","Siskiyou County",2014-08-01,69,10,19,0,98
"13370","Siskiyou County",2014-09-01,68,4,17,3,92
"13371","Siskiyou County",2014-10-01,73,11,11,2,97
"13372","Siskiyou County",2014-11-01,71,10,16,2,99
"13373","Siskiyou County",2014-12-01,81,11,10,0,102
"13374","Siskiyou County",2015-01-01,88,9,2,0,99
"13375","Siskiyou County",2015-02-01,89,6,4,0,99
"13376","Siskiyou County",2015-03-01,85,6,2,0,93
"13377","Siskiyou County",2015-04-01,84,8,3,0,95
"13378","Siskiyou County",2015-05-01,87,7,8,0,102
"13379","Siskiyou County",2015-06-01,90,8,8,0,106
"13380","Siskiyou County",2015-07-01,85,8,8,0,101
"13381","Siskiyou County",2015-08-01,88,8,5,0,101
"13382","Siskiyou County",2015-09-01,86,10,3,0,99
"13383","Siskiyou County",2015-10-01,85,10,8,0,103
"13384","Siskiyou County",2015-11-01,71,8,19,0,98
"13385","Siskiyou County",2015-12-01,90,10,4,0,104
"13386","Siskiyou County",2016-01-01,88,9,5,0,102
"13387","Siskiyou County",2016-02-01,88,10,5,0,103
"13388","Siskiyou County",2016-03-01,77,7,11,0,95
"13389","Siskiyou County",2016-04-01,78,8,11,0,97
"13390","Siskiyou County",2016-05-01,77,10,9,0,96
"13391","Siskiyou County",2016-06-01,80,8,10,0,98
"13392","Siskiyou County",2016-07-01,82,8,9,0,99
"13393","Siskiyou County",2016-08-01,77,10,11,0,98
"13394","Siskiyou County",2016-09-01,81,9,8,1,99
"13395","Siskiyou County",2016-10-01,73,12,8,1,94
"13396","Siskiyou County",2016-11-01,65,13,12,2,92
"13397","Siskiyou County",2016-12-01,65,12,11,0,88
"13398","Siskiyou County",2017-01-01,70,10,8,1,89
"13399","Siskiyou County",2017-02-01,69,13,11,0,93
"13400","Siskiyou County",2017-03-01,72,13,14,0,99
"13401","Siskiyou County",2017-04-01,71,13,15,1,100
"13402","Siskiyou County",2017-05-01,74,13,13,0,100
"13403","Siskiyou County",2017-06-01,80,13,7,0,100
"13404","Siskiyou County",2017-07-01,79,12,10,0,101
"13405","Siskiyou County",2017-08-01,76,13,10,0,99
"13406","Siskiyou County",2017-09-01,70,14,11,0,95
"13407","Siskiyou County",2017-10-01,77,13,8,1,99
"13408","Siskiyou County",2017-11-01,78,12,8,1,99
"13409","Siskiyou County",2017-12-01,73,12,10,1,96
"13410","Siskiyou County",2018-01-01,74,11,11,3,99
"13411","Siskiyou County",2018-02-01,75,14,11,0,100
"13412","Siskiyou County",2018-03-01,68,11,8,3,90
"13413","Siskiyou County",2018-04-01,73,8,10,6,97
"13414","Siskiyou County",2018-05-01,77,9,8,5,99
"13415","Siskiyou County",2018-06-01,77,9,10,5,101
"13416","Siskiyou County",2018-07-01,69,10,15,5,99
"13417","Siskiyou County",2018-08-01,77,10,13,4,104
"13418","Siskiyou County",2018-09-01,NA,NA,NA,NA,NA
"13419","Siskiyou County",2018-10-01,76,9,8,5,98
"13420","Siskiyou County",2018-11-01,75,9,8,5,97
"13421","Siskiyou County",2018-12-01,73,8,11,6,98
"13422","Siskiyou County",2019-01-01,71,8,11,6,96
"13423","Siskiyou County",2019-02-01,75,11,8,3,97
"13424","Siskiyou County",2019-03-01,70,11,10,3,94
"13425","Siskiyou County",2019-04-01,69,11,11,3,94
"13426","Siskiyou County",2019-05-01,74,11,7,3,95
"13427","Siskiyou County",2019-06-01,70,5,10,4,89
"13428","Siskiyou County",2019-07-01,63,9,12,3,87
"13429","Siskiyou County",2019-08-01,72,9,9,5,95
"13430","Siskiyou County",2019-09-01,NA,NA,NA,NA,NA
"13431","Siskiyou County",2019-10-01,68,10,13,3,94
"13432","Siskiyou County",2019-11-01,67,9,9,4,89
"13433","Siskiyou County",2019-12-01,63,6,13,4,86
"13434","Siskiyou County",2020-01-01,62,8,15,3,88
"13435","Siskiyou County",2020-02-01,68,11,11,3,93
"13436","Siskiyou County",2020-03-01,70,6,3,2,81
"13437","Solano County",1995-10-01,394,53,265,63,775
"13438","Solano County",1995-11-01,438,54,272,55,819
"13439","Solano County",1995-12-01,421,45,264,47,777
"13440","Solano County",1996-01-01,442,51,251,40,784
"13441","Solano County",1996-02-01,440,48,252,40,780
"13442","Solano County",1996-03-01,432,59,241,40,772
"13443","Solano County",1996-04-01,425,58,241,46,770
"13444","Solano County",1996-05-01,410,56,240,46,752
"13445","Solano County",1996-06-01,399,56,241,51,747
"13446","Solano County",1996-07-01,408,57,248,49,762
"13447","Solano County",1996-08-01,405,54,233,43,735
"13448","Solano County",1996-09-01,466,65,235,47,813
"13449","Solano County",1996-10-01,461,70,244,43,818
"13450","Solano County",1996-11-01,458,71,243,46,818
"13451","Solano County",1996-12-01,437,59,244,42,782
"13452","Solano County",1997-01-01,418,65,240,39,762
"13453","Solano County",1997-02-01,454,63,224,34,775
"13454","Solano County",1997-03-01,451,67,238,43,799
"13455","Solano County",1997-04-01,507,59,240,47,853
"13456","Solano County",1997-05-01,496,58,228,49,831
"13457","Solano County",1997-06-01,502,62,230,46,840
"13458","Solano County",1997-07-01,455,74,266,47,842
"13459","Solano County",1997-08-01,463,72,274,51,860
"13460","Solano County",1997-09-01,489,79,271,48,887
"13461","Solano County",1997-10-01,493,70,293,43,899
"13462","Solano County",1997-11-01,483,75,284,46,888
"13463","Solano County",1997-12-01,455,65,297,54,871
"13464","Solano County",1998-01-01,442,57,325,62,886
"13465","Solano County",1998-02-01,466,59,310,60,895
"13466","Solano County",1998-03-01,443,54,282,52,831
"13467","Solano County",1998-04-01,409,64,293,48,814
"13468","Solano County",1998-05-01,431,65,285,49,830
"13469","Solano County",1998-06-01,423,74,296,53,846
"13470","Solano County",1998-07-01,450,69,278,60,857
"13471","Solano County",1998-08-01,427,73,268,54,822
"13472","Solano County",1998-09-01,433,83,285,53,854
"13473","Solano County",1998-10-01,431,61,295,43,830
"13474","Solano County",1998-11-01,395,58,284,28,765
"13475","Solano County",1998-12-01,395,58,284,28,765
"13476","Solano County",1999-01-01,416,59,260,32,767
"13477","Solano County",1999-02-01,433,77,257,27,794
"13478","Solano County",1999-03-01,410,80,258,32,780
"13479","Solano County",1999-04-01,431,77,256,39,803
"13480","Solano County",1999-05-01,461,68,237,45,811
"13481","Solano County",1999-06-01,463,66,226,34,789
"13482","Solano County",1999-07-01,433,66,229,29,757
"13483","Solano County",1999-08-01,456,77,245,35,813
"13484","Solano County",1999-09-01,504,82,258,37,881
"13485","Solano County",1999-10-01,523,79,272,32,906
"13486","Solano County",1999-11-01,517,84,275,29,905
"13487","Solano County",1999-12-01,477,85,227,37,826
"13488","Solano County",2000-01-01,491,80,206,30,807
"13489","Solano County",2000-02-01,478,97,225,35,835
"13490","Solano County",2000-03-01,499,92,225,32,848
"13491","Solano County",2000-04-01,474,74,224,29,801
"13492","Solano County",2000-05-01,487,74,236,30,827
"13493","Solano County",2000-06-01,494,81,231,31,837
"13494","Solano County",2000-07-01,527,91,217,37,872
"13495","Solano County",2000-08-01,535,87,229,29,880
"13496","Solano County",2000-09-01,527,91,217,37,872
"13497","Solano County",2000-10-01,525,92,219,32,868
"13498","Solano County",2000-11-01,546,88,208,33,875
"13499","Solano County",2000-12-01,509,90,227,36,862
"13500","Solano County",2001-01-01,513,101,237,33,884
"13501","Solano County",2001-02-01,535,95,219,35,884
"13502","Solano County",2001-03-01,547,100,227,36,910
"13503","Solano County",2001-04-01,549,104,235,34,922
"13504","Solano County",2001-05-01,548,103,263,36,950
"13505","Solano County",2001-06-01,546,104,269,44,963
"13506","Solano County",2001-07-01,561,110,279,46,996
"13507","Solano County",2001-08-01,615,107,254,34,1010
"13508","Solano County",2001-09-01,608,101,245,35,989
"13509","Solano County",2001-10-01,603,111,230,42,986
"13510","Solano County",2001-11-01,630,107,239,39,1015
"13511","Solano County",2001-12-01,598,115,258,32,1003
"13512","Solano County",2002-01-01,629,116,254,31,1030
"13513","Solano County",2002-02-01,635,124,253,37,1049
"13514","Solano County",2002-03-01,643,110,266,43,1062
"13515","Solano County",2002-04-01,637,117,278,44,1076
"13516","Solano County",2002-05-01,625,118,262,46,1051
"13517","Solano County",2002-06-01,631,107,260,55,1053
"13518","Solano County",2002-07-01,638,104,258,48,1048
"13519","Solano County",2002-08-01,664,100,246,48,1058
"13520","Solano County",2002-09-01,690,103,228,47,1068
"13521","Solano County",2002-10-01,673,122,262,51,1108
"13522","Solano County",2002-11-01,664,117,272,48,1101
"13523","Solano County",2002-12-01,669,109,249,41,1068
"13524","Solano County",2003-01-01,700,116,257,43,1116
"13525","Solano County",2003-02-01,698,120,256,41,1115
"13526","Solano County",2003-03-01,642,107,276,55,1080
"13527","Solano County",2003-04-01,618,108,290,57,1073
"13528","Solano County",2003-05-01,635,118,297,51,1101
"13529","Solano County",2003-06-01,634,120,289,34,1077
"13530","Solano County",2003-07-01,649,110,288,43,1090
"13531","Solano County",2003-08-01,656,113,281,41,1091
"13532","Solano County",2003-09-01,669,120,264,40,1093
"13533","Solano County",2003-10-01,641,115,256,42,1054
"13534","Solano County",2003-11-01,630,108,251,51,1040
"13535","Solano County",2003-12-01,618,113,245,44,1020
"13536","Solano County",2004-01-01,627,123,249,40,1039
"13537","Solano County",2004-02-01,652,117,251,43,1063
"13538","Solano County",2004-03-01,671,126,249,41,1087
"13539","Solano County",2004-04-01,675,118,235,46,1074
"13540","Solano County",2004-05-01,641,114,266,43,1064
"13541","Solano County",2004-06-01,631,105,262,52,1050
"13542","Solano County",2004-07-01,676,107,226,60,1069
"13543","Solano County",2004-08-01,672,118,210,53,1053
"13544","Solano County",2004-09-01,669,124,225,43,1061
"13545","Solano County",2004-10-01,717,122,217,42,1098
"13546","Solano County",2004-11-01,718,112,219,39,1088
"13547","Solano County",2004-12-01,668,96,241,37,1042
"13548","Solano County",2005-01-01,707,92,222,42,1063
"13549","Solano County",2005-02-01,700,101,214,59,1074
"13550","Solano County",2005-03-01,677,105,227,54,1063
"13551","Solano County",2005-04-01,673,98,243,58,1072
"13552","Solano County",2005-05-01,663,101,247,47,1058
"13553","Solano County",2005-06-01,647,97,242,46,1032
"13554","Solano County",2005-07-01,658,94,239,39,1030
"13555","Solano County",2005-08-01,693,108,237,37,1075
"13556","Solano County",2005-09-01,740,120,181,41,1082
"13557","Solano County",2005-10-01,740,112,187,42,1081
"13558","Solano County",2005-11-01,723,103,206,44,1076
"13559","Solano County",2005-12-01,680,102,221,41,1044
"13560","Solano County",2006-01-01,683,109,204,41,1037
"13561","Solano County",2006-02-01,674,117,218,39,1048
"13562","Solano County",2006-03-01,689,123,221,29,1062
"13563","Solano County",2006-04-01,699,132,217,29,1077
"13564","Solano County",2006-05-01,683,134,221,40,1078
"13565","Solano County",2006-06-01,736,130,199,49,1114
"13566","Solano County",2006-07-01,692,114,235,52,1093
"13567","Solano County",2006-08-01,689,97,235,56,1077
"13568","Solano County",2006-09-01,714,115,231,44,1104
"13569","Solano County",2006-10-01,687,120,222,45,1074
"13570","Solano County",2006-11-01,705,129,207,51,1092
"13571","Solano County",2006-12-01,695,113,197,41,1046
"13572","Solano County",2007-01-01,714,118,192,41,1065
"13573","Solano County",2007-02-01,718,125,205,46,1094
"13574","Solano County",2007-03-01,729,142,179,47,1097
"13575","Solano County",2007-04-01,771,122,193,45,1131
"13576","Solano County",2007-05-01,762,127,170,57,1116
"13577","Solano County",2007-06-01,730,121,191,44,1086
"13578","Solano County",2007-07-01,718,112,211,48,1089
"13579","Solano County",2007-08-01,694,106,218,57,1075
"13580","Solano County",2007-09-01,737,117,197,49,1100
"13581","Solano County",2007-10-01,711,115,207,45,1078
"13582","Solano County",2007-11-01,669,120,209,36,1034
"13583","Solano County",2007-12-01,644,108,210,43,1005
"13584","Solano County",2008-01-01,671,113,204,42,1030
"13585","Solano County",2008-02-01,703,116,198,44,1061
"13586","Solano County",2008-03-01,692,110,202,41,1045
"13587","Solano County",2008-04-01,670,110,225,44,1049
"13588","Solano County",2008-05-01,652,102,226,53,1033
"13589","Solano County",2008-06-01,644,106,209,40,999
"13590","Solano County",2008-07-01,656,88,191,61,996
"13591","Solano County",2008-08-01,648,113,187,42,990
"13592","Solano County",2008-09-01,660,115,177,42,994
"13593","Solano County",2008-10-01,674,108,190,45,1017
"13594","Solano County",2008-11-01,642,114,192,48,996
"13595","Solano County",2008-12-01,652,99,186,41,978
"13596","Solano County",2009-01-01,663,95,184,41,983
"13597","Solano County",2009-02-01,671,88,191,47,997
"13598","Solano County",2009-03-01,654,96,184,46,980
"13599","Solano County",2009-04-01,619,95,187,49,950
"13600","Solano County",2009-05-01,619,103,181,45,948
"13601","Solano County",2009-06-01,609,94,179,46,928
"13602","Solano County",2009-07-01,639,94,175,46,954
"13603","Solano County",2009-08-01,637,90,167,42,936
"13604","Solano County",2009-09-01,653,80,182,45,960
"13605","Solano County",2009-10-01,641,89,191,42,963
"13606","Solano County",2009-11-01,606,82,192,36,916
"13607","Solano County",2009-12-01,569,71,177,36,853
"13608","Solano County",2010-01-01,591,63,166,33,853
"13609","Solano County",2010-02-01,580,69,141,27,817
"13610","Solano County",2010-03-01,603,76,137,24,840
"13611","Solano County",2010-04-01,615,85,138,24,862
"13612","Solano County",2010-05-01,608,87,124,25,844
"13613","Solano County",2010-06-01,620,86,116,29,851
"13614","Solano County",2010-07-01,633,78,118,30,859
"13615","Solano County",2010-08-01,639,76,131,29,875
"13616","Solano County",2010-09-01,629,83,134,29,875
"13617","Solano County",2010-10-01,626,90,141,26,883
"13618","Solano County",2010-11-01,589,82,138,24,833
"13619","Solano County",2010-12-01,542,76,131,21,770
"13620","Solano County",2011-01-01,544,87,128,23,782
"13621","Solano County",2011-02-01,548,79,126,25,778
"13622","Solano County",2011-03-01,533,77,144,22,776
"13623","Solano County",2011-04-01,529,67,137,21,754
"13624","Solano County",2011-05-01,517,115,108,24,764
"13625","Solano County",2011-06-01,510,80,146,26,762
"13626","Solano County",2011-07-01,512,68,135,32,747
"13627","Solano County",2011-08-01,530,86,131,24,771
"13628","Solano County",2011-09-01,546,82,111,22,761
"13629","Solano County",2011-10-01,555,78,109,23,765
"13630","Solano County",2011-11-01,525,78,165,26,794
"13631","Solano County",2011-12-01,497,65,182,30,774
"13632","Solano County",2012-01-01,513,69,208,29,819
"13633","Solano County",2012-02-01,527,80,194,30,831
"13634","Solano County",2012-03-01,534,69,209,32,844
"13635","Solano County",2012-04-01,554,73,208,25,860
"13636","Solano County",2012-05-01,582,87,207,31,907
"13637","Solano County",2012-06-01,579,84,203,33,899
"13638","Solano County",2012-07-01,574,86,204,37,901
"13639","Solano County",2012-08-01,591,89,215,43,938
"13640","Solano County",2012-09-01,614,91,206,42,953
"13641","Solano County",2012-10-01,586,76,208,43,913
"13642","Solano County",2012-11-01,550,64,225,52,891
"13643","Solano County",2012-12-01,559,71,224,48,902
"13644","Solano County",2013-01-01,506,94,220,61,881
"13645","Solano County",2013-02-01,517,72,251,44,884
"13646","Solano County",2013-03-01,551,73,250,42,916
"13647","Solano County",2013-04-01,570,75,250,37,932
"13648","Solano County",2013-05-01,604,83,250,38,975
"13649","Solano County",2013-06-01,583,77,247,41,948
"13650","Solano County",2013-07-01,559,69,249,42,919
"13651","Solano County",2013-08-01,546,73,251,42,912
"13652","Solano County",2013-09-01,545,79,246,39,909
"13653","Solano County",2013-10-01,558,83,265,36,942
"13654","Solano County",2013-11-01,552,79,256,36,923
"13655","Solano County",2013-12-01,525,84,263,30,902
"13656","Solano County",2014-01-01,521,81,257,25,884
"13657","Solano County",2014-02-01,550,79,257,27,913
"13658","Solano County",2014-03-01,573,84,268,34,959
"13659","Solano County",2014-04-01,550,83,270,30,933
"13660","Solano County",2014-05-01,583,81,260,28,952
"13661","Solano County",2014-06-01,587,92,247,35,961
"13662","Solano County",2014-07-01,581,87,252,43,963
"13663","Solano County",2014-08-01,578,92,245,37,952
"13664","Solano County",2014-09-01,597,96,235,40,968
"13665","Solano County",2014-10-01,609,99,218,37,963
"13666","Solano County",2014-11-01,564,85,220,36,905
"13667","Solano County",2014-12-01,536,73,196,29,834
"13668","Solano County",2015-01-01,559,79,176,28,842
"13669","Solano County",2015-02-01,573,78,201,29,881
"13670","Solano County",2015-03-01,560,83,214,31,888
"13671","Solano County",2015-04-01,550,92,193,29,864
"13672","Solano County",2015-05-01,560,82,198,32,872
"13673","Solano County",2015-06-01,580,87,158,30,855
"13674","Solano County",2015-07-01,560,82,172,31,845
"13675","Solano County",2015-08-01,578,80,172,30,860
"13676","Solano County",2015-09-01,593,89,163,24,869
"13677","Solano County",2015-10-01,617,89,155,25,886
"13678","Solano County",2015-11-01,668,95,176,26,965
"13679","Solano County",2015-12-01,652,92,165,27,936
"13680","Solano County",2016-01-01,656,94,165,26,941
"13681","Solano County",2016-02-01,676,82,178,30,966
"13682","Solano County",2016-03-01,669,84,198,27,978
"13683","Solano County",2016-04-01,592,81,200,31,904
"13684","Solano County",2016-05-01,599,94,211,29,933
"13685","Solano County",2016-06-01,646,91,211,41,989
"13686","Solano County",2016-07-01,656,86,211,39,992
"13687","Solano County",2016-08-01,581,93,207,30,911
"13688","Solano County",2016-09-01,693,101,203,28,1025
"13689","Solano County",2016-10-01,668,102,220,27,1017
"13690","Solano County",2016-11-01,704,104,213,30,1051
"13691","Solano County",2016-12-01,679,99,210,24,1012
"13692","Solano County",2017-01-01,685,99,210,24,1018
"13693","Solano County",2017-02-01,730,94,215,29,1068
"13694","Solano County",2017-03-01,710,86,207,31,1034
"13695","Solano County",2017-04-01,671,96,209,35,1011
"13696","Solano County",2017-05-01,665,93,209,40,1007
"13697","Solano County",2017-06-01,645,89,197,44,975
"13698","Solano County",2017-07-01,631,80,178,39,928
"13699","Solano County",2017-08-01,625,89,178,39,931
"13700","Solano County",2017-09-01,644,88,190,46,968
"13701","Solano County",2017-10-01,627,95,204,47,973
"13702","Solano County",2017-11-01,574,88,214,41,917
"13703","Solano County",2017-12-01,563,83,205,36,887
"13704","Solano County",2018-01-01,546,74,201,39,860
"13705","Solano County",2018-02-01,528,72,193,40,833
"13706","Solano County",2018-03-01,476,62,184,28,750
"13707","Solano County",2018-04-01,475,60,173,24,732
"13708","Solano County",2018-05-01,480,63,170,22,735
"13709","Solano County",2018-06-01,505,65,165,20,755
"13710","Solano County",2018-07-01,526,70,157,21,774
"13711","Solano County",2018-08-01,522,74,156,24,776
"13712","Solano County",2018-09-01,531,75,137,23,766
"13713","Solano County",2018-10-01,523,68,141,27,759
"13714","Solano County",2018-11-01,499,75,151,31,756
"13715","Solano County",2018-12-01,507,69,139,23,738
"13716","Solano County",2019-01-01,499,61,143,20,723
"13717","Solano County",2019-02-01,524,65,125,20,734
"13718","Solano County",2019-03-01,523,71,131,26,751
"13719","Solano County",2019-04-01,522,70,134,23,749
"13720","Solano County",2019-05-01,524,55,140,22,741
"13721","Solano County",2019-06-01,525,62,145,20,752
"13722","Solano County",2019-07-01,525,59,134,18,736
"13723","Solano County",2019-08-01,529,62,127,17,735
"13724","Solano County",2019-09-01,523,60,128,15,726
"13725","Solano County",2019-10-01,516,58,127,18,719
"13726","Solano County",2019-11-01,511,59,133,19,722
"13727","Solano County",2019-12-01,502,63,127,16,708
"13728","Solano County",2020-01-01,485,60,111,20,676
"13729","Solano County",2020-02-01,495,67,121,14,697
"13730","Solano County",2020-03-01,478,48,115,17,658
"13731","Sonoma County",1995-10-01,414,57,382,41,894
"13732","Sonoma County",1995-11-01,398,61,385,33,877
"13733","Sonoma County",1995-12-01,398,68,380,24,870
"13734","Sonoma County",1996-01-01,414.6,67,371.3,29.7,882.6
"13735","Sonoma County",1996-02-01,426.1,59.6,368,32.4,886.1
"13736","Sonoma County",1996-03-01,425.8,53.4,363,39.6,881.8
"13737","Sonoma County",1996-04-01,431.5,53.7,384.7,35.9,905.8
"13738","Sonoma County",1996-05-01,426.3,52.7,376.1,38.8,893.9
"13739","Sonoma County",1996-06-01,421.6,47.9,376.6,39.8,885.9
"13740","Sonoma County",1996-07-01,420.8,44.4,376.9,42.6,884.7
"13741","Sonoma County",1996-08-01,435.2,51.5,368.3,39.1,894.1
"13742","Sonoma County",1996-09-01,450,58.7,352.7,30.1,891.5
"13743","Sonoma County",1996-10-01,456.2,68.8,348.4,23.7,897.1
"13744","Sonoma County",1996-11-01,454,76.4,351,23.2,904.6
"13745","Sonoma County",1996-12-01,447.3,65.6,360.2,24.7,897.8
"13746","Sonoma County",1997-01-01,458.7,58.6,367.6,29,913.9
"13747","Sonoma County",1997-02-01,464,65.9,359.9,24.2,914
"13748","Sonoma County",1997-03-01,449,78,370,19,916
"13749","Sonoma County",1997-04-01,443.3,78,377.1,36.3,934.7
"13750","Sonoma County",1997-05-01,460.3,69.6,387.4,57,974.3
"13751","Sonoma County",1997-06-01,463,67.7,408,48.2,986.9
"13752","Sonoma County",1997-07-01,458.4,69.8,416.6,38.8,983.6
"13753","Sonoma County",1997-08-01,459,67,430,47,1003
"13754","Sonoma County",1997-09-01,441,84,428,43,996
"13755","Sonoma County",1997-10-01,441,91,413,48,993
"13756","Sonoma County",1997-11-01,423,82,405,55,965
"13757","Sonoma County",1997-12-01,441,79,384,53,957
"13758","Sonoma County",1998-01-01,447,78,388,62,975
"13759","Sonoma County",1998-02-01,461,79,386,76,1002
"13760","Sonoma County",1998-03-01,449,88,398,69,1004
"13761","Sonoma County",1998-04-01,470,81,407,74,1032
"13762","Sonoma County",1998-05-01,481,76,405,77,1039
"13763","Sonoma County",1998-06-01,495,76,403,80,1054
"13764","Sonoma County",1998-07-01,492,74,425,75,1066
"13765","Sonoma County",1998-08-01,479,82,425,68,1054
"13766","Sonoma County",1998-09-01,446,81,449,76,1052
"13767","Sonoma County",1998-10-01,478,75,437,76,1066
"13768","Sonoma County",1998-11-01,492,65,451,77,1085
"13769","Sonoma County",1998-12-01,477,68,453,68,1066
"13770","Sonoma County",1999-01-01,481,64,459,62,1066
"13771","Sonoma County",1999-02-01,506,73,468,69,1116
"13772","Sonoma County",1999-03-01,504,71,497,69,1141
"13773","Sonoma County",1999-04-01,492,71,509,67,1139
"13774","Sonoma County",1999-05-01,470,60,505,75,1110
"13775","Sonoma County",1999-06-01,437,53,489,68,1047
"13776","Sonoma County",1999-07-01,412,58,495,72,1037
"13777","Sonoma County",1999-08-01,420,65,469,75,1029
"13778","Sonoma County",1999-09-01,432,66,468,72,1038
"13779","Sonoma County",1999-10-01,470,67,465,65,1067
"13780","Sonoma County",1999-11-01,469,68,470,66,1073
"13781","Sonoma County",1999-12-01,463,65,481,69,1078
"13782","Sonoma County",2000-01-01,485,65,488,69,1107
"13783","Sonoma County",2000-02-01,496,70,466,65,1097
"13784","Sonoma County",2000-03-01,494,65,444,62,1065
"13785","Sonoma County",2000-04-01,488,64,425,66,1043
"13786","Sonoma County",2000-05-01,489,64,438,66,1057
"13787","Sonoma County",2000-06-01,499,79,420,64,1062
"13788","Sonoma County",2000-07-01,479,78,422,62,1041
"13789","Sonoma County",2000-08-01,468,76,444,71,1059
"13790","Sonoma County",2000-09-01,498,69,468,86,1121
"13791","Sonoma County",2000-10-01,485,72,491,84,1132
"13792","Sonoma County",2000-11-01,467,72,517,77,1133
"13793","Sonoma County",2000-12-01,446,63,498,73,1080
"13794","Sonoma County",2001-01-01,450,54,490,79,1073
"13795","Sonoma County",2001-02-01,463,54,493,82,1092
"13796","Sonoma County",2001-03-01,454,67,505,76,1102
"13797","Sonoma County",2001-04-01,465,73,478,71,1087
"13798","Sonoma County",2001-05-01,462,68,484,68,1082
"13799","Sonoma County",2001-06-01,458,64,481,72,1075
"13800","Sonoma County",2001-07-01,473,61,427,64,1025
"13801","Sonoma County",2001-08-01,461,66,429,62,1018
"13802","Sonoma County",2001-09-01,470,69,433,67,1039
"13803","Sonoma County",2001-10-01,526,73,436,68,1103
"13804","Sonoma County",2001-11-01,523,64,453,61,1101
"13805","Sonoma County",2001-12-01,506,68,423,64,1061
"13806","Sonoma County",2002-01-01,516,83,404,66,1069
"13807","Sonoma County",2002-02-01,491,75,396,71,1033
"13808","Sonoma County",2002-03-01,502,75,377,69,1023
"13809","Sonoma County",2002-04-01,501,69,379,67,1016
"13810","Sonoma County",2002-05-01,484,71,376,62,993
"13811","Sonoma County",2002-06-01,497,71,375,61,1004
"13812","Sonoma County",2002-07-01,483,69,374,58,984
"13813","Sonoma County",2002-08-01,481,74,375,61,991
"13814","Sonoma County",2002-09-01,502,73,365,60,1000
"13815","Sonoma County",2002-10-01,522,72,392,63,1049
"13816","Sonoma County",2002-11-01,518,79,400,52,1049
"13817","Sonoma County",2002-12-01,475,68,399,56,998
"13818","Sonoma County",2003-01-01,486,70,413,61,1030
"13819","Sonoma County",2003-02-01,501,65,423,56,1045
"13820","Sonoma County",2003-03-01,482,53,423,53,1011
"13821","Sonoma County",2003-04-01,481,69,418,64,1032
"13822","Sonoma County",2003-05-01,527,75,385,64,1051
"13823","Sonoma County",2003-06-01,561,78,380,65,1084
"13824","Sonoma County",2003-07-01,531,76,384,55,1046
"13825","Sonoma County",2003-08-01,516,65,376,59,1016
"13826","Sonoma County",2003-09-01,514,73,385,58,1030
"13827","Sonoma County",2003-10-01,505,68,417,73,1063
"13828","Sonoma County",2003-11-01,524,75,404,71,1074
"13829","Sonoma County",2003-12-01,513,67,409,74,1063
"13830","Sonoma County",2004-01-01,567,84,415,68,1134
"13831","Sonoma County",2004-02-01,570,95,421,62,1148
"13832","Sonoma County",2004-03-01,551,86,407,69,1113
"13833","Sonoma County",2004-04-01,544,87,413,68,1112
"13834","Sonoma County",2004-05-01,557,86,435,70,1148
"13835","Sonoma County",2004-06-01,550,90,449,64,1153
"13836","Sonoma County",2004-07-01,527,85,436,62,1110
"13837","Sonoma County",2004-08-01,519,87,451,70,1127
"13838","Sonoma County",2004-09-01,530,79,451,79,1139
"13839","Sonoma County",2004-10-01,528,74,464,86,1152
"13840","Sonoma County",2004-11-01,514,76,455,88,1133
"13841","Sonoma County",2004-12-01,508,77,435,78,1098
"13842","Sonoma County",2005-01-01,533,66,410,73,1082
"13843","Sonoma County",2005-02-01,553,78,408,62,1101
"13844","Sonoma County",2005-03-01,550,79,426,70,1125
"13845","Sonoma County",2005-04-01,545,87,426,67,1125
"13846","Sonoma County",2005-05-01,568,88,418,70,1144
"13847","Sonoma County",2005-06-01,574,92,423,74,1163
"13848","Sonoma County",2005-07-01,592,84,398,73,1147
"13849","Sonoma County",2005-08-01,599,81,402,67,1149
"13850","Sonoma County",2005-09-01,601,85,396,69,1151
"13851","Sonoma County",2005-10-01,597,83,399,77,1156
"13852","Sonoma County",2005-11-01,621,82,391,75,1169
"13853","Sonoma County",2005-12-01,593,79,392,72,1136
"13854","Sonoma County",2006-01-01,599,75,397,70,1141
"13855","Sonoma County",2006-02-01,606,75,392,70,1143
"13856","Sonoma County",2006-03-01,598,80,386,72,1136
"13857","Sonoma County",2006-04-01,600,72,407,72,1151
"13858","Sonoma County",2006-05-01,587,69,412,75,1143
"13859","Sonoma County",2006-06-01,572,80,388,69,1109
"13860","Sonoma County",2006-07-01,557,87,381,67,1092
"13861","Sonoma County",2006-08-01,538,92,411,66,1107
"13862","Sonoma County",2006-09-01,534,88,381,67,1070
"13863","Sonoma County",2006-10-01,554,97,361,57,1069
"13864","Sonoma County",2006-11-01,559,94,373,64,1090
"13865","Sonoma County",2006-12-01,545,80,345,67,1037
"13866","Sonoma County",2007-01-01,569,83,349,65,1066
"13867","Sonoma County",2007-02-01,572,79,368,64,1083
"13868","Sonoma County",2007-03-01,550,78,383,67,1078
"13869","Sonoma County",2007-04-01,544,89,383,77,1093
"13870","Sonoma County",2007-05-01,522,74,430,80,1106
"13871","Sonoma County",2007-06-01,471,76,433,79,1059
"13872","Sonoma County",2007-07-01,460,70,402,74,1006
"13873","Sonoma County",2007-08-01,472,64,403,66,1005
"13874","Sonoma County",2007-09-01,488,70,395,75,1028
"13875","Sonoma County",2007-10-01,507,72,398,73,1050
"13876","Sonoma County",2007-11-01,513,74,408,76,1071
"13877","Sonoma County",2007-12-01,493,74,385,73,1025
"13878","Sonoma County",2008-01-01,491,70,388,64,1013
"13879","Sonoma County",2008-02-01,497,69,399,60,1025
"13880","Sonoma County",2008-03-01,504,73,405,69,1051
"13881","Sonoma County",2008-04-01,505,75,413,78,1071
"13882","Sonoma County",2008-05-01,495,75,397,75,1042
"13883","Sonoma County",2008-06-01,486,69,377,83,1015
"13884","Sonoma County",2008-07-01,481,54,377,91,1003
"13885","Sonoma County",2008-08-01,487,64,368,89,1008
"13886","Sonoma County",2008-09-01,525,67,369,83,1044
"13887","Sonoma County",2008-10-01,527,58,357,83,1025
"13888","Sonoma County",2008-11-01,536,61,353,69,1019
"13889","Sonoma County",2008-12-01,506,61,370,64,1001
"13890","Sonoma County",2009-01-01,497,58,378,66,999
"13891","Sonoma County",2009-02-01,492,74,393,61,1020
"13892","Sonoma County",2009-03-01,510,71,426,79,1086
"13893","Sonoma County",2009-04-01,483,67,416,78,1044
"13894","Sonoma County",2009-05-01,479,71,409,76,1035
"13895","Sonoma County",2009-06-01,481,70,392,70,1013
"13896","Sonoma County",2009-07-01,485,73,385,68,1011
"13897","Sonoma County",2009-08-01,505,76,391,66,1038
"13898","Sonoma County",2009-09-01,505,74,384,72,1035
"13899","Sonoma County",2009-10-01,503,74,389,73,1039
"13900","Sonoma County",2009-11-01,478,68,370,75,991
"13901","Sonoma County",2009-12-01,464,65,358,68,955
"13902","Sonoma County",2010-01-01,467,63,363,74,967
"13903","Sonoma County",2010-02-01,485,61,355,74,975
"13904","Sonoma County",2010-03-01,485,68,366,68,987
"13905","Sonoma County",2010-04-01,467,66,338,70,941
"13906","Sonoma County",2010-05-01,480,63,352,63,958
"13907","Sonoma County",2010-06-01,451,64,325,62,902
"13908","Sonoma County",2010-07-01,438,61,322,53,874
"13909","Sonoma County",2010-08-01,444,54,340,59,897
"13910","Sonoma County",2010-09-01,446,61,353,51,911
"13911","Sonoma County",2010-10-01,450,54,354,51,909
"13912","Sonoma County",2010-11-01,453,49,350,43,895
"13913","Sonoma County",2010-12-01,450,53,351,55,909
"13914","Sonoma County",2011-01-01,479,55,352,57,943
"13915","Sonoma County",2011-02-01,506,68,352,55,981
"13916","Sonoma County",2011-03-01,477,64,354,65,960
"13917","Sonoma County",2011-04-01,462,60,369,72,963
"13918","Sonoma County",2011-05-01,450,49,363,75,937
"13919","Sonoma County",2011-06-01,442,59,375,68,944
"13920","Sonoma County",2011-07-01,414,60,389,70,933
"13921","Sonoma County",2011-08-01,447,55,373,73,948
"13922","Sonoma County",2011-09-01,465,58,386,65,974
"13923","Sonoma County",2011-10-01,435,59,424,60,978
"13924","Sonoma County",2011-11-01,420,49,444,58,971
"13925","Sonoma County",2011-12-01,412,47,445,56,960
"13926","Sonoma County",2012-01-01,437,59,440,55,991
"13927","Sonoma County",2012-02-01,442,61,484,65,1052
"13928","Sonoma County",2012-03-01,439,57,485,72,1053
"13929","Sonoma County",2012-04-01,438,60,484,71,1053
"13930","Sonoma County",2012-05-01,421,65,480,79,1045
"13931","Sonoma County",2012-06-01,398,61,504,86,1049
"13932","Sonoma County",2012-07-01,403,58,504,86,1051
"13933","Sonoma County",2012-08-01,410,62,505,78,1055
"13934","Sonoma County",2012-09-01,404,52,505,86,1047
"13935","Sonoma County",2012-10-01,400,59,507,76,1042
"13936","Sonoma County",2012-11-01,416,60,501,80,1057
"13937","Sonoma County",2012-12-01,395,58,480,75,1008
"13938","Sonoma County",2013-01-01,395,62,467,85,1009
"13939","Sonoma County",2013-02-01,406,64,502,92,1064
"13940","Sonoma County",2013-03-01,418,79,516,88,1101
"13941","Sonoma County",2013-04-01,407,84,529,92,1112
"13942","Sonoma County",2013-05-01,405,87,509,98,1099
"13943","Sonoma County",2013-06-01,410,73,503,103,1089
"13944","Sonoma County",2013-07-01,411,70,463,103,1047
"13945","Sonoma County",2013-08-01,439,72,457,97,1065
"13946","Sonoma County",2013-09-01,469,84,453,92,1098
"13947","Sonoma County",2013-10-01,497,68,472,99,1136
"13948","Sonoma County",2013-11-01,469,67,481,101,1118
"13949","Sonoma County",2013-12-01,461,72,459,96,1088
"13950","Sonoma County",2014-01-01,433,68,462,93,1056
"13951","Sonoma County",2014-02-01,435,69,470,93,1067
"13952","Sonoma County",2014-03-01,435,76,492,91,1094
"13953","Sonoma County",2014-04-01,442,76,401,96,1015
"13954","Sonoma County",2014-05-01,416,78,391,89,974
"13955","Sonoma County",2014-06-01,394,85,420,93,992
"13956","Sonoma County",2014-07-01,406,79,417,87,989
"13957","Sonoma County",2014-08-01,416,77,420,97,1010
"13958","Sonoma County",2014-09-01,447,86,398,107,1038
"13959","Sonoma County",2014-10-01,465,89,424,98,1076
"13960","Sonoma County",2014-11-01,452,91,454,102,1099
"13961","Sonoma County",2014-12-01,403,88,444,80,1015
"13962","Sonoma County",2015-01-01,399,79,419,75,972
"13963","Sonoma County",2015-02-01,406,77,403,79,965
"13964","Sonoma County",2015-03-01,433,88,407,86,1014
"13965","Sonoma County",2015-04-01,438,81,398,83,1000
"13966","Sonoma County",2015-05-01,442,72,426,75,1015
"13967","Sonoma County",2015-06-01,458,77,406,82,1023
"13968","Sonoma County",2015-07-01,467,79,432,90,1068
"13969","Sonoma County",2015-08-01,546,87,380,94,1107
"13970","Sonoma County",2015-09-01,499,88,446,83,1116
"13971","Sonoma County",2015-10-01,469,81,399,87,1036
"13972","Sonoma County",2015-11-01,528,81,369,82,1060
"13973","Sonoma County",2015-12-01,442,69,389,68,968
"13974","Sonoma County",2016-01-01,483,71,453,80,1087
"13975","Sonoma County",2016-02-01,538,80,459,77,1154
"13976","Sonoma County",2016-03-01,453,88,443,74,1058
"13977","Sonoma County",2016-04-01,462,91,470,91,1114
"13978","Sonoma County",2016-05-01,480,89,415,89,1073
"13979","Sonoma County",2016-06-01,457,87,417,88,1049
"13980","Sonoma County",2016-07-01,485,116,402,63,1066
"13981","Sonoma County",2016-08-01,500,102,421,68,1091
"13982","Sonoma County",2016-09-01,509,104,435,92,1140
"13983","Sonoma County",2016-10-01,475,95,425,85,1080
"13984","Sonoma County",2016-11-01,472,82,416,75,1045
"13985","Sonoma County",2016-12-01,448,74,405,65,992
"13986","Sonoma County",2017-01-01,520,112,383,69,1084
"13987","Sonoma County",2017-02-01,462,103,366,68,999
"13988","Sonoma County",2017-03-01,458,98,418,71,1045
"13989","Sonoma County",2017-04-01,450,103,392,64,1009
"13990","Sonoma County",2017-05-01,418,79,374,57,928
"13991","Sonoma County",2017-06-01,393,75,281,44,793
"13992","Sonoma County",2017-07-01,504,113,423,73,1113
"13993","Sonoma County",2017-08-01,512,105,413,70,1100
"13994","Sonoma County",2017-09-01,519,96,433,67,1115
"13995","Sonoma County",2017-10-01,566,95,415,63,1139
"13996","Sonoma County",2017-11-01,522,94,407,62,1085
"13997","Sonoma County",2017-12-01,502,98,451,63,1114
"13998","Sonoma County",2018-01-01,519,98,378,65,1060
"13999","Sonoma County",2018-02-01,541,98,398,65,1102
"14000","Sonoma County",2018-03-01,533,88,418,64,1103
"14001","Sonoma County",2018-04-01,535,96,388,67,1086
"14002","Sonoma County",2018-05-01,516,96,391,76,1079
"14003","Sonoma County",2018-06-01,518,98,411,79,1106
"14004","Sonoma County",2018-07-01,506,102,419,70,1097
"14005","Sonoma County",2018-08-01,478,104,382,68,1032
"14006","Sonoma County",2018-09-01,478,100,371,70,1019
"14007","Sonoma County",2018-10-01,464,80,373,71,988
"14008","Sonoma County",2018-11-01,494,78,342,67,981
"14009","Sonoma County",2018-12-01,504,92,347,62,1005
"14010","Sonoma County",2019-01-01,518,109,355,64,1046
"14011","Sonoma County",2019-02-01,511,109,380,63,1063
"14012","Sonoma County",2019-03-01,518,96,359,68,1041
"14013","Sonoma County",2019-04-01,522,90,363,73,1048
"14014","Sonoma County",2019-05-01,506,79,355,79,1019
"14015","Sonoma County",2019-06-01,515,87,338,74,1014
"14016","Sonoma County",2019-07-01,529,89,332,68,1018
"14017","Sonoma County",2019-08-01,548,93,344,64,1049
"14018","Sonoma County",2019-09-01,557,99,353,69,1078
"14019","Sonoma County",2019-10-01,523,86,327,70,1006
"14020","Sonoma County",2019-11-01,554,87,308,61,1010
"14021","Sonoma County",2019-12-01,540,84,303,58,985
"14022","Sonoma County",2020-01-01,514,83,293,54,944
"14023","Sonoma County",2020-02-01,512,82,306,54,954
"14024","Sonoma County",2020-03-01,477,78,297,59,911
"14025","Stanislaus County",1995-10-01,454,75,356,95,980
"14026","Stanislaus County",1995-11-01,443,45,410,60,958
"14027","Stanislaus County",1995-12-01,446,47,375,54,922
"14028","Stanislaus County",1996-01-01,460,63,335,62,920
"14029","Stanislaus County",1996-02-01,387,58,413,69,927
"14030","Stanislaus County",1996-03-01,429,38,383,76,926
"14031","Stanislaus County",1996-04-01,389,40,414,55,898
"14032","Stanislaus County",1996-05-01,659,47,162,77,945
"14033","Stanislaus County",1996-06-01,465,49,380,72,966
"14034","Stanislaus County",1996-07-01,483,53,319,78,933
"14035","Stanislaus County",1996-08-01,659,47,162,77,945
"14036","Stanislaus County",1996-09-01,438,51,398,78,965
"14037","Stanislaus County",1996-10-01,423,51,436,75,985
"14038","Stanislaus County",1996-11-01,421,46,426,72,965
"14039","Stanislaus County",1996-12-01,410,51,408,73,942
"14040","Stanislaus County",1997-01-01,437,57,415,81,990
"14041","Stanislaus County",1997-02-01,424,60,451,81,1016
"14042","Stanislaus County",1997-03-01,427,64,465,86,1042
"14043","Stanislaus County",1997-04-01,440,58,446,82,1026
"14044","Stanislaus County",1997-05-01,454,63,437,84,1038
"14045","Stanislaus County",1997-06-01,494,58,422,79,1053
"14046","Stanislaus County",1997-07-01,530,58,417,69,1074
"14047","Stanislaus County",1997-08-01,524,64,402,76,1066
"14048","Stanislaus County",1997-09-01,502,61,384,86,1033
"14049","Stanislaus County",1997-10-01,513,55,404,90,1062
"14050","Stanislaus County",1997-11-01,522,58,410,94,1084
"14051","Stanislaus County",1997-12-01,501,52,411,90,1054
"14052","Stanislaus County",1998-01-01,491,60,435,93,1079
"14053","Stanislaus County",1998-02-01,499,59,437,98,1093
"14054","Stanislaus County",1998-03-01,501,65,467,91,1124
"14055","Stanislaus County",1998-04-01,480,54,490,94,1118
"14056","Stanislaus County",1998-05-01,473,48,489,104,1114
"14057","Stanislaus County",1998-06-01,483,52,505,98,1138
"14058","Stanislaus County",1998-07-01,477,54,487,87,1105
"14059","Stanislaus County",1998-08-01,474,50,432,86,1042
"14060","Stanislaus County",1998-09-01,468,59,447,82,1056
"14061","Stanislaus County",1998-10-01,447,60,471,88,1066
"14062","Stanislaus County",1998-11-01,471,58,462,81,1072
"14063","Stanislaus County",1998-12-01,449,62,423,85,1019
"14064","Stanislaus County",1999-01-01,453,56,417,87,1013
"14065","Stanislaus County",1999-02-01,432,57,453,87,1029
"14066","Stanislaus County",1999-03-01,409,56,465,91,1021
"14067","Stanislaus County",1999-04-01,422,57,458,78,1015
"14068","Stanislaus County",1999-05-01,428,56,442,83,1009
"14069","Stanislaus County",1999-06-01,451,56,422,89,1018
"14070","Stanislaus County",1999-07-01,455,51,420,81,1007
"14071","Stanislaus County",1999-08-01,456,62,415,77,1010
"14072","Stanislaus County",1999-09-01,461,66,419,77,1023
"14073","Stanislaus County",1999-10-01,453,61,415,80,1009
"14074","Stanislaus County",1999-11-01,472,58,403,75,1008
"14075","Stanislaus County",1999-12-01,456,50,386,72,964
"14076","Stanislaus County",2000-01-01,500,51,378,82,1011
"14077","Stanislaus County",2000-02-01,514,68,456,88,1126
"14078","Stanislaus County",2000-03-01,487,69,445,85,1086
"14079","Stanislaus County",2000-04-01,582,79,361,78,1100
"14080","Stanislaus County",2000-05-01,569,79,365,70,1083
"14081","Stanislaus County",2000-06-01,525,75,347,76,1023
"14082","Stanislaus County",2000-07-01,546,72,359,82,1059
"14083","Stanislaus County",2000-08-01,540,67,356,82,1045
"14084","Stanislaus County",2000-09-01,555,66,342,90,1053
"14085","Stanislaus County",2000-10-01,526,68,357,94,1045
"14086","Stanislaus County",2000-11-01,517,62,362,89,1030
"14087","Stanislaus County",2000-12-01,487,57,321,72,937
"14088","Stanislaus County",2001-01-01,521,67,332,79,999
"14089","Stanislaus County",2001-02-01,499,71,338,85,993
"14090","Stanislaus County",2001-03-01,539,72,329,90,1030
"14091","Stanislaus County",2001-04-01,524,78,329,89,1020
"14092","Stanislaus County",2001-05-01,554,75,340,74,1043
"14093","Stanislaus County",2001-06-01,559,74,360,75,1068
"14094","Stanislaus County",2001-07-01,525,68,372,88,1053
"14095","Stanislaus County",2001-08-01,521,71,380,92,1064
"14096","Stanislaus County",2001-09-01,533,84,376,79,1072
"14097","Stanislaus County",2001-10-01,570,93,353,70,1086
"14098","Stanislaus County",2001-11-01,573,92,344,66,1075
"14099","Stanislaus County",2001-12-01,542,85,317,60,1004
"14100","Stanislaus County",2002-01-01,598,98,311,58,1065
"14101","Stanislaus County",2002-02-01,636,90,315,67,1108
"14102","Stanislaus County",2002-03-01,619,91,347,63,1120
"14103","Stanislaus County",2002-04-01,627,93,356,65,1141
"14104","Stanislaus County",2002-05-01,623,82,362,73,1140
"14105","Stanislaus County",2002-06-01,625,86,355,66,1132
"14106","Stanislaus County",2002-07-01,635,104,346,59,1144
"14107","Stanislaus County",2002-08-01,625,99,341,69,1134
"14108","Stanislaus County",2002-09-01,618,111,341,71,1141
"14109","Stanislaus County",2002-10-01,626,105,328,67,1126
"14110","Stanislaus County",2002-11-01,624,105,346,70,1145
"14111","Stanislaus County",2002-12-01,597,87,358,63,1105
"14112","Stanislaus County",2003-01-01,616,87,333,59,1095
"14113","Stanislaus County",2003-02-01,636,91,346,57,1130
"14114","Stanislaus County",2003-03-01,618,100,379,56,1153
"14115","Stanislaus County",2003-04-01,617,88,340,66,1111
"14116","Stanislaus County",2003-05-01,633,88,354,64,1139
"14117","Stanislaus County",2003-06-01,650,100,330,61,1141
"14118","Stanislaus County",2003-07-01,668,101,330,65,1164
"14119","Stanislaus County",2003-08-01,634,86,371,75,1166
"14120","Stanislaus County",2003-09-01,667,105,366,92,1230
"14121","Stanislaus County",2003-10-01,669,94,367,92,1222
"14122","Stanislaus County",2003-11-01,692,93,354,79,1218
"14123","Stanislaus County",2003-12-01,662,77,353,72,1164
"14124","Stanislaus County",2004-01-01,684,89,343,56,1172
"14125","Stanislaus County",2004-02-01,705,108,324,59,1196
"14126","Stanislaus County",2004-03-01,721,124,288,54,1187
"14127","Stanislaus County",2004-04-01,703,145,316,41,1205
"14128","Stanislaus County",2004-05-01,669,113,342,65,1189
"14129","Stanislaus County",2004-06-01,666,100,358,73,1197
"14130","Stanislaus County",2004-07-01,664,105,343,71,1183
"14131","Stanislaus County",2004-08-01,656,107,334,60,1157
"14132","Stanislaus County",2004-09-01,659,97,327,69,1152
"14133","Stanislaus County",2004-10-01,669,94,362,65,1190
"14134","Stanislaus County",2004-11-01,665,92,373,71,1201
"14135","Stanislaus County",2004-12-01,689,112,354,47,1202
"14136","Stanislaus County",2005-01-01,672,122,363,58,1215
"14137","Stanislaus County",2005-02-01,655,99,388,80,1222
"14138","Stanislaus County",2005-03-01,634,112,400,88,1234
"14139","Stanislaus County",2005-04-01,671,103,396,98,1268
"14140","Stanislaus County",2005-05-01,688,112,387,95,1282
"14141","Stanislaus County",2005-06-01,723,120,389,88,1320
"14142","Stanislaus County",2005-07-01,682,93,421,99,1295
"14143","Stanislaus County",2005-08-01,666,99,456,100,1321
"14144","Stanislaus County",2005-09-01,661,107,478,103,1349
"14145","Stanislaus County",2005-10-01,667,101,453,104,1325
"14146","Stanislaus County",2005-11-01,669,101,445,104,1319
"14147","Stanislaus County",2005-12-01,648,97,415,94,1254
"14148","Stanislaus County",2006-01-01,688,105,432,93,1318
"14149","Stanislaus County",2006-02-01,682,107,461,87,1337
"14150","Stanislaus County",2006-03-01,686,101,464,111,1362
"14151","Stanislaus County",2006-04-01,709,106,444,106,1365
"14152","Stanislaus County",2006-05-01,692,102,438,110,1342
"14153","Stanislaus County",2006-06-01,692,95,431,110,1328
"14154","Stanislaus County",2006-07-01,703,96,415,115,1329
"14155","Stanislaus County",2006-08-01,712,95,400,109,1316
"14156","Stanislaus County",2006-09-01,728,111,409,98,1346
"14157","Stanislaus County",2006-10-01,713,108,422,101,1344
"14158","Stanislaus County",2006-11-01,704,100,437,101,1342
"14159","Stanislaus County",2006-12-01,698,94,447,91,1330
"14160","Stanislaus County",2007-01-01,727,104,433,95,1359
"14161","Stanislaus County",2007-02-01,743,110,414,100,1367
"14162","Stanislaus County",2007-03-01,755,118,391,105,1369
"14163","Stanislaus County",2007-04-01,774,112,415,104,1405
"14164","Stanislaus County",2007-05-01,747,116,406,99,1368
"14165","Stanislaus County",2007-06-01,752,110,420,105,1387
"14166","Stanislaus County",2007-07-01,767,109,416,108,1400
"14167","Stanislaus County",2007-08-01,749,109,457,104,1419
"14168","Stanislaus County",2007-09-01,732,107,482,108,1429
"14169","Stanislaus County",2007-10-01,721,110,484,111,1426
"14170","Stanislaus County",2007-11-01,710,109,455,101,1375
"14171","Stanislaus County",2007-12-01,694,100,414,90,1298
"14172","Stanislaus County",2008-01-01,714,99,412,95,1320
"14173","Stanislaus County",2008-02-01,726,104,426,101,1357
"14174","Stanislaus County",2008-03-01,725,95,438,103,1361
"14175","Stanislaus County",2008-04-01,731,97,430,110,1368
"14176","Stanislaus County",2008-05-01,725,95,438,103,1361
"14177","Stanislaus County",2008-06-01,740,98,433,97,1368
"14178","Stanislaus County",2008-07-01,756,97,423,104,1380
"14179","Stanislaus County",2008-08-01,741,107,411,109,1368
"14180","Stanislaus County",2008-09-01,712,99,413,105,1329
"14181","Stanislaus County",2008-10-01,699,95,387,104,1285
"14182","Stanislaus County",2008-11-01,720,93,381,107,1301
"14183","Stanislaus County",2008-12-01,711,94,372,98,1275
"14184","Stanislaus County",2009-01-01,735,92,367,105,1299
"14185","Stanislaus County",2009-02-01,762,96,359,101,1318
"14186","Stanislaus County",2009-03-01,775,114,347,93,1329
"14187","Stanislaus County",2009-04-01,759,109,365,100,1333
"14188","Stanislaus County",2009-05-01,752,102,365,97,1316
"14189","Stanislaus County",2009-06-01,774,108,344,91,1317
"14190","Stanislaus County",2009-07-01,759,101,352,97,1309
"14191","Stanislaus County",2009-08-01,785,107,358,106,1356
"14192","Stanislaus County",2009-09-01,802,102,344,109,1357
"14193","Stanislaus County",2009-10-01,791,100,333,112,1336
"14194","Stanislaus County",2009-11-01,783,92,333,107,1315
"14195","Stanislaus County",2009-12-01,751,100,337,90,1278
"14196","Stanislaus County",2010-01-01,749,106,314,88,1257
"14197","Stanislaus County",2010-02-01,756,95,269,70,1190
"14198","Stanislaus County",2010-03-01,754,99,222,60,1135
"14199","Stanislaus County",2010-04-01,775,91,237,57,1160
"14200","Stanislaus County",2010-05-01,789,92,244,56,1181
"14201","Stanislaus County",2010-06-01,713,86,228,63,1090
"14202","Stanislaus County",2010-07-01,726,90,219,59,1094
"14203","Stanislaus County",2010-08-01,750,99,191,62,1102
"14204","Stanislaus County",2010-09-01,750,93,195,61,1099
"14205","Stanislaus County",2010-10-01,715,98,233,62,1108
"14206","Stanislaus County",2010-11-01,680,100,242,58,1080
"14207","Stanislaus County",2010-12-01,692,85,235,53,1065
"14208","Stanislaus County",2011-01-01,716,86,188,60,1050
"14209","Stanislaus County",2011-02-01,720,72,124,48,964
"14210","Stanislaus County",2011-03-01,682,82,156,48,968
"14211","Stanislaus County",2011-04-01,708,89,159,47,1003
"14212","Stanislaus County",2011-05-01,708,84,156,56,1004
"14213","Stanislaus County",2011-06-01,719,80,150,54,1003
"14214","Stanislaus County",2011-07-01,715,84,159,52,1010
"14215","Stanislaus County",2011-08-01,750,84,131,54,1019
"14216","Stanislaus County",2011-09-01,776,85,99,55,1015
"14217","Stanislaus County",2011-10-01,812,78,98,50,1038
"14218","Stanislaus County",2011-11-01,767,80,164,42,1053
"14219","Stanislaus County",2011-12-01,774,73,215,48,1110
"14220","Stanislaus County",2012-01-01,793,83,218,49,1143
"14221","Stanislaus County",2012-02-01,822,85,198,56,1161
"14222","Stanislaus County",2012-03-01,805,82,208,54,1149
"14223","Stanislaus County",2012-04-01,786,82,225,42,1135
"14224","Stanislaus County",2012-05-01,768,82,238,47,1135
"14225","Stanislaus County",2012-06-01,795,81,214,59,1149
"14226","Stanislaus County",2012-07-01,837,93,174,53,1157
"14227","Stanislaus County",2012-08-01,867,79,146,59,1151
"14228","Stanislaus County",2012-09-01,872,84,136,60,1152
"14229","Stanislaus County",2012-10-01,868,91,139,56,1154
"14230","Stanislaus County",2012-11-01,824,93,176,47,1140
"14231","Stanislaus County",2012-12-01,797,91,205,48,1141
"14232","Stanislaus County",2013-01-01,818,84,189,30,1121
"14233","Stanislaus County",2013-02-01,803,88,224,24,1139
"14234","Stanislaus County",2013-03-01,780,103,260,17,1160
"14235","Stanislaus County",2013-04-01,784,110,191,17,1102
"14236","Stanislaus County",2013-05-01,789,113,182,23,1107
"14237","Stanislaus County",2013-06-01,812,113,153,21,1099
"14238","Stanislaus County",2013-07-01,776,100,164,23,1063
"14239","Stanislaus County",2013-08-01,797,99,103,17,1016
"14240","Stanislaus County",2013-09-01,815,110,84,12,1021
"14241","Stanislaus County",2013-10-01,811,116,184,35,1146
"14242","Stanislaus County",2013-11-01,822,111,254,42,1229
"14243","Stanislaus County",2013-12-01,809,111,270,41,1231
"14244","Stanislaus County",2014-01-01,822,109,253,36,1220
"14245","Stanislaus County",2014-02-01,834,113,139,17,1103
"14246","Stanislaus County",2014-03-01,808,108,156,29,1101
"14247","Stanislaus County",2014-04-01,839,116,177,35,1167
"14248","Stanislaus County",2014-05-01,824,112,192,29,1157
"14249","Stanislaus County",2014-06-01,813,105,204,36,1158
"14250","Stanislaus County",2014-07-01,809,110,205,36,1160
"14251","Stanislaus County",2014-08-01,829,106,219,33,1187
"14252","Stanislaus County",2014-09-01,839,109,238,32,1218
"14253","Stanislaus County",2014-10-01,833,108,250,39,1230
"14254","Stanislaus County",2014-11-01,776,88,259,45,1168
"14255","Stanislaus County",2014-12-01,710,79,250,48,1087
"14256","Stanislaus County",2015-01-01,699,76,228,39,1042
"14257","Stanislaus County",2015-02-01,710,76,216,35,1037
"14258","Stanislaus County",2015-03-01,718,80,236,34,1068
"14259","Stanislaus County",2015-04-01,727,83,262,39,1111
"14260","Stanislaus County",2015-05-01,721,80,248,48,1097
"14261","Stanislaus County",2015-06-01,713,79,254,41,1087
"14262","Stanislaus County",2015-07-01,695,87,256,47,1085
"14263","Stanislaus County",2015-08-01,717,74,263,50,1104
"14264","Stanislaus County",2015-09-01,740,76,268,53,1137
"14265","Stanislaus County",2015-10-01,762,73,263,50,1148
"14266","Stanislaus County",2015-11-01,715,70,297,54,1136
"14267","Stanislaus County",2015-12-01,722,74,285,44,1125
"14268","Stanislaus County",2016-01-01,752,83,272,50,1157
"14269","Stanislaus County",2016-02-01,765,88,294,52,1199
"14270","Stanislaus County",2016-03-01,819,92,267,53,1231
"14271","Stanislaus County",2016-04-01,832,96,251,41,1220
"14272","Stanislaus County",2016-05-01,804,90,288,50,1232
"14273","Stanislaus County",2016-06-01,790,90,301,62,1243
"14274","Stanislaus County",2016-07-01,777,87,309,57,1230
"14275","Stanislaus County",2016-08-01,800,92,286,49,1227
"14276","Stanislaus County",2016-09-01,820,102,261,49,1232
"14277","Stanislaus County",2016-10-01,789,97,293,54,1233
"14278","Stanislaus County",2016-11-01,783,97,306,51,1237
"14279","Stanislaus County",2016-12-01,759,84,317,52,1212
"14280","Stanislaus County",2017-01-01,771,82,312,52,1217
"14281","Stanislaus County",2017-02-01,806,85,290,47,1228
"14282","Stanislaus County",2017-03-01,784,91,308,51,1234
"14283","Stanislaus County",2017-04-01,761,93,322,51,1227
"14284","Stanislaus County",2017-05-01,763,89,363,68,1283
"14285","Stanislaus County",2017-06-01,744,88,381,65,1278
"14286","Stanislaus County",2017-07-01,725,83,361,68,1237
"14287","Stanislaus County",2017-08-01,713,87,334,66,1200
"14288","Stanislaus County",2017-09-01,698,91,314,61,1164
"14289","Stanislaus County",2017-10-01,681,88,310,59,1138
"14290","Stanislaus County",2017-11-01,676,82,309,54,1121
"14291","Stanislaus County",2017-12-01,695,93,311,49,1148
"14292","Stanislaus County",2018-01-01,738,93,284,40,1155
"14293","Stanislaus County",2018-02-01,713,90,258,39,1100
"14294","Stanislaus County",2018-03-01,741,100,291,42,1174
"14295","Stanislaus County",2018-04-01,740,98,282,51,1171
"14296","Stanislaus County",2018-05-01,739,104,294,50,1187
"14297","Stanislaus County",2018-06-01,734,98,296,54,1182
"14298","Stanislaus County",2018-07-01,753,99,280,56,1188
"14299","Stanislaus County",2018-08-01,747,100,295,50,1192
"14300","Stanislaus County",2018-09-01,779,106,296,49,1230
"14301","Stanislaus County",2018-10-01,770,111,275,43,1199
"14302","Stanislaus County",2018-11-01,776,103,253,42,1174
"14303","Stanislaus County",2018-12-01,782,116,241,34,1173
"14304","Stanislaus County",2019-01-01,796,123,246,42,1207
"14305","Stanislaus County",2019-02-01,766,111,287,42,1206
"14306","Stanislaus County",2019-03-01,724,104,304,43,1175
"14307","Stanislaus County",2019-04-01,714,100,287,47,1148
"14308","Stanislaus County",2019-05-01,719,114,284,43,1160
"14309","Stanislaus County",2019-06-01,651,92,370,61,1174
"14310","Stanislaus County",2019-07-01,753,107,286,44,1190
"14311","Stanislaus County",2019-08-01,769,108,301,36,1214
"14312","Stanislaus County",2019-09-01,811,112,272,39,1234
"14313","Stanislaus County",2019-10-01,797,108,270,44,1219
"14314","Stanislaus County",2019-11-01,820,115,256,41,1232
"14315","Stanislaus County",2019-12-01,824,122,246,35,1227
"14316","Stanislaus County",2020-01-01,845,125,253,33,1256
"14317","Stanislaus County",2020-02-01,862,123,303,34,1322
"14318","Stanislaus County",2020-03-01,850,121,288,36,1295
"14319","Sutter County",1995-10-01,74,20,116,31,241
"14320","Sutter County",1995-11-01,49,10,139,29,227
"14321","Sutter County",1995-12-01,41.3,6.3,126.7,30.8,205.1
"14322","Sutter County",1996-01-01,51,10,118,24,203
"14323","Sutter County",1996-02-01,31,18,144,23,216
"14324","Sutter County",1996-03-01,39,17,128,19,203
"14325","Sutter County",1996-04-01,108,20,84,21,233
"14326","Sutter County",1996-05-01,94,16,113,22,245
"14327","Sutter County",1996-06-01,111,19,86,29,245
"14328","Sutter County",1996-07-01,81,18,107,30,236
"14329","Sutter County",1996-08-01,71,15,92,25,203
"14330","Sutter County",1996-09-01,73,14,91,24,202
"14331","Sutter County",1996-10-01,71,17,95,27,210
"14332","Sutter County",1996-11-01,75,18,100,29,222
"14333","Sutter County",1996-12-01,102,12,84,16,214
"14334","Sutter County",1997-01-01,93,13,40,10,156
"14335","Sutter County",1997-02-01,109,20,65,16,210
"14336","Sutter County",1997-03-01,117,17,70,21,225
"14337","Sutter County",1997-04-01,168,20,87,19,294
"14338","Sutter County",1997-05-01,131,21,88,27,267
"14339","Sutter County",1997-06-01,125,22,103,22,272
"14340","Sutter County",1997-07-01,130,18,75,31,254
"14341","Sutter County",1997-08-01,116,36,62,23,237
"14342","Sutter County",1997-09-01,100,14,73,25,212
"14343","Sutter County",1997-10-01,102,21,73,34,230
"14344","Sutter County",1997-11-01,124,20,61,24,229
"14345","Sutter County",1997-12-01,127,22,48,21,218
"14346","Sutter County",1998-01-01,117,17,76,29,239
"14347","Sutter County",1998-02-01,120,17,71,29,237
"14348","Sutter County",1998-03-01,118,22,89,23,252
"14349","Sutter County",1998-04-01,117,19,84,23,243
"14350","Sutter County",1998-05-01,57,18,149,25,249
"14351","Sutter County",1998-06-01,129,12,96,24,261
"14352","Sutter County",1998-07-01,76,17,147,23,263
"14353","Sutter County",1998-08-01,112,22,85,22,241
"14354","Sutter County",1998-09-01,118,16,77,22,233
"14355","Sutter County",1998-10-01,112,19,70,36,237
"14356","Sutter County",1998-11-01,103,19,87,20,229
"14357","Sutter County",1998-12-01,120,22,67,17,226
"14358","Sutter County",1999-01-01,94,15,85,17,211
"14359","Sutter County",1999-02-01,98,20,77,10,205
"14360","Sutter County",1999-03-01,94,20,90,20,224
"14361","Sutter County",1999-04-01,97,21,82,36,236
"14362","Sutter County",1999-05-01,106,19,85,19,229
"14363","Sutter County",1999-06-01,109,26,60,21,216
"14364","Sutter County",1999-07-01,91,17,92,18,218
"14365","Sutter County",1999-08-01,94,17,78,21,210
"14366","Sutter County",1999-09-01,107,16,73,12,208
"14367","Sutter County",1999-10-01,86,19,90,19,214
"14368","Sutter County",1999-11-01,109,20,61,17,207
"14369","Sutter County",1999-12-01,109,20,61,17,207
"14370","Sutter County",2000-01-01,144,21,55,19,239
"14371","Sutter County",2000-02-01,102,19,54,20,195
"14372","Sutter County",2000-03-01,99,18,68,18,203
"14373","Sutter County",2000-04-01,110,20,71,18,219
"14374","Sutter County",2000-05-01,119,22,52,6,199
"14375","Sutter County",2000-06-01,112,29,57,17,215
"14376","Sutter County",2000-07-01,112,21,51,17,201
"14377","Sutter County",2000-08-01,114,24,61,19,218
"14378","Sutter County",2000-09-01,122,21,61,19,223
"14379","Sutter County",2000-10-01,128,20,43,13,204
"14380","Sutter County",2000-11-01,108,12,58,9,187
"14381","Sutter County",2000-12-01,91,6,66,9,172
"14382","Sutter County",2001-01-01,110,11,52,14,187
"14383","Sutter County",2001-02-01,132,13,43,10,198
"14384","Sutter County",2001-03-01,117,13,76,5,211
"14385","Sutter County",2001-04-01,103,20,76,4,203
"14386","Sutter County",2001-05-01,122,16,64,18,220
"14387","Sutter County",2001-06-01,120,14,69,14,217
"14388","Sutter County",2001-07-01,116,14,72,17,219
"14389","Sutter County",2001-08-01,125,26,69,16,236
"14390","Sutter County",2001-09-01,135,22,68,16,241
"14391","Sutter County",2001-10-01,131,15,69,19,234
"14392","Sutter County",2001-11-01,127,13,76,19,235
"14393","Sutter County",2001-12-01,123,22,74,18,237
"14394","Sutter County",2002-01-01,142,31,58,15,246
"14395","Sutter County",2002-02-01,146,27,74,21,268
"14396","Sutter County",2002-03-01,127,21,67,16,231
"14397","Sutter County",2002-04-01,135,22,74,19,250
"14398","Sutter County",2002-05-01,125,27,72,10,234
"14399","Sutter County",2002-06-01,137,20,81,15,253
"14400","Sutter County",2002-07-01,136,23,74,18,251
"14401","Sutter County",2002-08-01,163,21,73,13,270
"14402","Sutter County",2002-09-01,143,16,82,21,262
"14403","Sutter County",2002-10-01,137,20,58,18,233
"14404","Sutter County",2002-11-01,152,18,58,15,243
"14405","Sutter County",2002-12-01,138,20,67,17,242
"14406","Sutter County",2003-01-01,147,22,53,26,248
"14407","Sutter County",2003-02-01,146,22,56,24,248
"14408","Sutter County",2003-03-01,131,23,61,24,239
"14409","Sutter County",2003-04-01,126,26,66,17,235
"14410","Sutter County",2003-05-01,151,23,61,19,254
"14411","Sutter County",2003-06-01,149,23,48,15,235
"14412","Sutter County",2003-07-01,144,20,65,13,242
"14413","Sutter County",2003-08-01,152,23,77,14,266
"14414","Sutter County",2003-09-01,137,16,74,16,243
"14415","Sutter County",2003-10-01,167,13,50,21,251
"14416","Sutter County",2003-11-01,157,27,50,19,253
"14417","Sutter County",2003-12-01,163,27,50,17,257
"14418","Sutter County",2004-01-01,150,30,76,22,278
"14419","Sutter County",2004-02-01,158,28,81,28,295
"14420","Sutter County",2004-03-01,150,22,74,29,275
"14421","Sutter County",2004-04-01,129,23,70,22,244
"14422","Sutter County",2004-05-01,146,15,75,19,255
"14423","Sutter County",2004-06-01,166,17,69,19,271
"14424","Sutter County",2004-07-01,160,21,61,20,262
"14425","Sutter County",2004-08-01,154,24,71,21,270
"14426","Sutter County",2004-09-01,161,21,69,16,267
"14427","Sutter County",2004-10-01,143,18,63,11,235
"14428","Sutter County",2004-11-01,137,19,76,16,248
"14429","Sutter County",2004-12-01,162,15,67,14,258
"14430","Sutter County",2005-01-01,152,22,75,22,271
"14431","Sutter County",2005-02-01,170,19,63,25,277
"14432","Sutter County",2005-03-01,154,15,68,23,260
"14433","Sutter County",2005-04-01,152,28,79,15,274
"14434","Sutter County",2005-05-01,132,23,78,21,254
"14435","Sutter County",2005-06-01,199,26,66,16,307
"14436","Sutter County",2005-07-01,199,26,66,16,307
"14437","Sutter County",2005-08-01,211,22,71,11,315
"14438","Sutter County",2005-09-01,225,28,79,23,355
"14439","Sutter County",2005-10-01,193,27,72,24,316
"14440","Sutter County",2005-11-01,149,24,61,22,256
"14441","Sutter County",2005-12-01,128,22,44,19,213
"14442","Sutter County",2006-01-01,148,25,52,16,241
"14443","Sutter County",2006-02-01,153,27,75,18,273
"14444","Sutter County",2006-03-01,147,25,77,24,273
"14445","Sutter County",2006-04-01,152,24,75,28,279
"14446","Sutter County",2006-05-01,155,26,68,23,272
"14447","Sutter County",2006-06-01,150,20,59,27,256
"14448","Sutter County",2006-07-01,148,19,80,24,271
"14449","Sutter County",2006-08-01,156,24,61,24,265
"14450","Sutter County",2006-09-01,144,31,66,18,259
"14451","Sutter County",2006-10-01,144,28,72,18,262
"14452","Sutter County",2006-11-01,99,28,61,21,209
"14453","Sutter County",2006-12-01,130,27,67,20,244
"14454","Sutter County",2007-01-01,130,19,58,17,224
"14455","Sutter County",2007-02-01,157,29,58,26,270
"14456","Sutter County",2007-03-01,149,26,70,29,274
"14457","Sutter County",2007-04-01,167,23,77,31,298
"14458","Sutter County",2007-05-01,164,25,71,30,290
"14459","Sutter County",2007-06-01,163,24,66,19,272
"14460","Sutter County",2007-07-01,143,26,90,28,287
"14461","Sutter County",2007-08-01,137,21,75,32,265
"14462","Sutter County",2007-09-01,145,26,62,33,266
"14463","Sutter County",2007-10-01,133,29,57,21,240
"14464","Sutter County",2007-11-01,138,27,56,21,242
"14465","Sutter County",2007-12-01,142,26,55,21,244
"14466","Sutter County",2008-01-01,150,21,64,17,252
"14467","Sutter County",2008-02-01,159,25,72,17,273
"14468","Sutter County",2008-03-01,159,23,75,31,288
"14469","Sutter County",2008-04-01,159,24,73,24,280
"14470","Sutter County",2008-05-01,155,15,64,23,257
"14471","Sutter County",2008-06-01,156,22,47,28,253
"14472","Sutter County",2008-07-01,158,19,54,21,252
"14473","Sutter County",2008-08-01,173,23,45,21,262
"14474","Sutter County",2008-09-01,173,25,45,17,260
"14475","Sutter County",2008-10-01,173,23,59,19,274
"14476","Sutter County",2008-11-01,158,26,60,22,266
"14477","Sutter County",2008-12-01,142,26,55,21,244
"14478","Sutter County",2009-01-01,169,18,58,34,279
"14479","Sutter County",2009-02-01,166,27,52,21,266
"14480","Sutter County",2009-03-01,171,24,57,14,266
"14481","Sutter County",2009-04-01,156,27,45,19,247
"14482","Sutter County",2009-05-01,177,29,41,17,264
"14483","Sutter County",2009-06-01,167,26,43,20,256
"14484","Sutter County",2009-07-01,161,23,42,14,240
"14485","Sutter County",2009-08-01,151,23,43,16,233
"14486","Sutter County",2009-09-01,151,24,35,20,230
"14487","Sutter County",2009-10-01,145,29,42,22,238
"14488","Sutter County",2009-11-01,146,25,40,21,232
"14489","Sutter County",2009-12-01,148,26,37,22,233
"14490","Sutter County",2010-01-01,138,24,30,17,209
"14491","Sutter County",2010-02-01,143,24,19,10,196
"14492","Sutter County",2010-03-01,138,28,32,13,211
"14493","Sutter County",2010-04-01,137,26,36,13,212
"14494","Sutter County",2010-05-01,133,23,27,16,199
"14495","Sutter County",2010-06-01,150,31,36,19,236
"14496","Sutter County",2010-07-01,156,23,30,16,225
"14497","Sutter County",2010-08-01,147,35,29,0,211
"14498","Sutter County",2010-09-01,148,29,29,0,206
"14499","Sutter County",2010-10-01,140,37,35,0,212
"14500","Sutter County",2010-11-01,120,32,27,0,179
"14501","Sutter County",2010-12-01,133,18,21,14,186
"14502","Sutter County",2011-01-01,150,20,16,15,201
"14503","Sutter County",2011-02-01,115,18,16,9,158
"14504","Sutter County",2011-03-01,139,22,31,10,202
"14505","Sutter County",2011-04-01,157,16,28,12,213
"14506","Sutter County",2011-05-01,154,22,31,12,219
"14507","Sutter County",2011-06-01,153,26,43,15,237
"14508","Sutter County",2011-07-01,138,13,30,11,192
"14509","Sutter County",2011-08-01,135,8,28,10,181
"14510","Sutter County",2011-09-01,134,21,28,7,190
"14511","Sutter County",2011-10-01,143,18,26,10,197
"14512","Sutter County",2011-11-01,127,17,24,9,177
"14513","Sutter County",2011-12-01,122,15,19,6,162
"14514","Sutter County",2012-01-01,128,17,26,7,178
"14515","Sutter County",2012-02-01,139,17,32,10,198
"14516","Sutter County",2012-03-01,139,20,27,11,197
"14517","Sutter County",2012-04-01,132,22,28,8,190
"14518","Sutter County",2012-05-01,147,22,34,12,215
"14519","Sutter County",2012-06-01,158,15,46,22,241
"14520","Sutter County",2012-07-01,176,22,43,23,264
"14521","Sutter County",2012-08-01,180,16,49,22,267
"14522","Sutter County",2012-09-01,181,20,62,25,288
"14523","Sutter County",2012-10-01,170,23,35,24,252
"14524","Sutter County",2012-11-01,168,19,36,15,238
"14525","Sutter County",2012-12-01,167,22,26,12,227
"14526","Sutter County",2013-01-01,169,22,26,17,234
"14527","Sutter County",2013-02-01,177,22,46,23,268
"14528","Sutter County",2013-03-01,169,24,50,22,265
"14529","Sutter County",2013-04-01,190,21,42,18,271
"14530","Sutter County",2013-05-01,183,27,43,20,273
"14531","Sutter County",2013-06-01,174,28,36,17,255
"14532","Sutter County",2013-07-01,179,24,36,21,260
"14533","Sutter County",2013-08-01,179,27,44,15,265
"14534","Sutter County",2013-09-01,180,31,38,20,269
"14535","Sutter County",2013-10-01,162,27,26,10,225
"14536","Sutter County",2013-11-01,163,22,28,22,235
"14537","Sutter County",2013-12-01,153,22,24,19,218
"14538","Sutter County",2014-01-01,173,28,24,25,250
"14539","Sutter County",2014-02-01,171,25,29,25,250
"14540","Sutter County",2014-03-01,172,27,28,29,256
"14541","Sutter County",2014-04-01,171,24,28,29,252
"14542","Sutter County",2014-05-01,169,22,30,28,249
"14543","Sutter County",2014-06-01,175,27,44,28,274
"14544","Sutter County",2014-07-01,143,23,57,19,242
"14545","Sutter County",2014-08-01,144,24,51,25,244
"14546","Sutter County",2014-09-01,169,27,33,23,252
"14547","Sutter County",2014-10-01,155,26,44,21,246
"14548","Sutter County",2014-11-01,129,26,49,10,214
"14549","Sutter County",2014-12-01,147,26,26,13,212
"14550","Sutter County",2015-01-01,143,24,44,12,223
"14551","Sutter County",2015-02-01,144,26,40,12,222
"14552","Sutter County",2015-03-01,132,21,38,23,214
"14553","Sutter County",2015-04-01,130,21,48,17,216
"14554","Sutter County",2015-05-01,146,21,40,16,223
"14555","Sutter County",2015-06-01,128,21,36,16,201
"14556","Sutter County",2015-07-01,149,22,37,17,225
"14557","Sutter County",2015-08-01,144,25,52,17,238
"14558","Sutter County",2015-09-01,147,31,61,21,260
"14559","Sutter County",2015-10-01,144,30,65,21,260
"14560","Sutter County",2015-11-01,138,31,46,14,229
"14561","Sutter County",2015-12-01,121,32,53,14,220
"14562","Sutter County",2016-01-01,136,29,55,18,238
"14563","Sutter County",2016-02-01,157,26,40,14,237
"14564","Sutter County",2016-03-01,137,31,42,22,232
"14565","Sutter County",2016-04-01,132,24,49,23,228
"14566","Sutter County",2016-05-01,118,27,45,15,205
"14567","Sutter County",2016-06-01,116,25,42,12,195
"14568","Sutter County",2016-07-01,123,20,42,15,200
"14569","Sutter County",2016-08-01,139,19,40,16,214
"14570","Sutter County",2016-09-01,136,22,45,12,215
"14571","Sutter County",2016-10-01,126,23,39,19,207
"14572","Sutter County",2016-11-01,127,25,37,14,203
"14573","Sutter County",2016-12-01,121,25,49,14,209
"14574","Sutter County",2017-01-01,131,23,52,10,216
"14575","Sutter County",2017-02-01,128,24,41,13,206
"14576","Sutter County",2017-03-01,148,17,45,11,221
"14577","Sutter County",2017-04-01,179,19,48,15,261
"14578","Sutter County",2017-05-01,176,22,44,23,265
"14579","Sutter County",2017-06-01,144,12,61,18,235
"14580","Sutter County",2017-07-01,152,5,64,27,248
"14581","Sutter County",2017-08-01,156,5,54,36,251
"14582","Sutter County",2017-09-01,143,9,50,25,227
"14583","Sutter County",2017-10-01,129,6,52,24,211
"14584","Sutter County",2017-11-01,138,5,63,22,228
"14585","Sutter County",2017-12-01,135,7,46,22,210
"14586","Sutter County",2018-01-01,132,14,54,25,225
"14587","Sutter County",2018-02-01,134,14,49,26,223
"14588","Sutter County",2018-03-01,131,17,45,25,218
"14589","Sutter County",2018-04-01,131,18,50,24,223
"14590","Sutter County",2018-05-01,138,12,52,22,224
"14591","Sutter County",2018-06-01,123,19,60,31,233
"14592","Sutter County",2018-07-01,128,15,69,23,235
"14593","Sutter County",2018-08-01,116,12,52,19,199
"14594","Sutter County",2018-09-01,0,0,0,0,0
"14595","Sutter County",2018-10-01,118,16,51,12,197
"14596","Sutter County",2018-11-01,133,13,54,10,210
"14597","Sutter County",2018-12-01,118,11,51,11,191
"14598","Sutter County",2019-01-01,112,12,41,9,174
"14599","Sutter County",2019-02-01,126,21,45,9,201
"14600","Sutter County",2019-03-01,137,12,39,16,204
"14601","Sutter County",2019-04-01,139,20,41,14,214
"14602","Sutter County",2019-05-01,139,17,43,25,224
"14603","Sutter County",2019-06-01,126,23,50,17,216
"14604","Sutter County",2019-07-01,151,33,47,14,245
"14605","Sutter County",2019-08-01,145,30,53,14,242
"14606","Sutter County",2019-09-01,129,33,44,10,216
"14607","Sutter County",2019-10-01,119,28,56,11,214
"14608","Sutter County",2019-11-01,141,25,58,14,238
"14609","Sutter County",2019-12-01,138,25,75,12,250
"14610","Sutter County",2020-01-01,120,23,56,9,208
"14611","Sutter County",2020-02-01,120,21,55,10,206
"14612","Sutter County",2020-03-01,130,10,29,3,172
"14613","Tehama County",1995-10-01,32,4,82,15,133
"14614","Tehama County",1995-11-01,38,5,92,15,150
"14615","Tehama County",1995-12-01,36,3,87,15,141
"14616","Tehama County",1996-01-01,35,7,90,14,146
"14617","Tehama County",1996-02-01,40,8,97,15,160
"14618","Tehama County",1996-03-01,42,8,101,15,166
"14619","Tehama County",1996-04-01,42,8,100,15,165
"14620","Tehama County",1996-05-01,44,7,103,11,165
"14621","Tehama County",1996-06-01,46,6,98,14,164
"14622","Tehama County",1996-07-01,44,4,86,13,147
"14623","Tehama County",1996-08-01,37,8,81,11,137
"14624","Tehama County",1996-09-01,42,6,63,14,125
"14625","Tehama County",1996-10-01,37,5,74,13,129
"14626","Tehama County",1996-11-01,40,6,78,12,136
"14627","Tehama County",1996-12-01,34,6,84,9,133
"14628","Tehama County",1997-01-01,40,7,91,10,148
"14629","Tehama County",1997-02-01,60,5,88,9,162
"14630","Tehama County",1997-03-01,73,10,74,10,167
"14631","Tehama County",1997-04-01,165,17,0,0,182
"14632","Tehama County",1997-05-01,0,0,19,172,191
"14633","Tehama County",1997-06-01,0,0,168,23,191
"14634","Tehama County",1997-07-01,0,0,158,23,181
"14635","Tehama County",1997-08-01,0,0,165,19,184
"14636","Tehama County",1997-09-01,0,0,193,24,217
"14637","Tehama County",1997-10-01,0,0,198,18,216
"14638","Tehama County",1997-11-01,0,0,190,19,209
"14639","Tehama County",1997-12-01,0,0,176,19,195
"14640","Tehama County",1998-01-01,0,0,155,38,193
"14641","Tehama County",1998-02-01,0,0,162,46,208
"14642","Tehama County",1998-03-01,0,0,182,23,205
"14643","Tehama County",1998-04-01,0,0,188,24,212
"14644","Tehama County",1998-05-01,0,0,25,196,221
"14645","Tehama County",1998-06-01,0,0,48,178,226
"14646","Tehama County",1998-07-01,0,0,207,19,226
"14647","Tehama County",1998-08-01,0,0,191,23,214
"14648","Tehama County",1998-09-01,0,0,183,22,205
"14649","Tehama County",1998-10-01,0,0,177,22,199
"14650","Tehama County",1998-11-01,0,0,172,21,193
"14651","Tehama County",1998-12-01,0,0,162,23,185
"14652","Tehama County",1999-01-01,0,0,176,21,197
"14653","Tehama County",1999-02-01,0,0,180,20,200
"14654","Tehama County",1999-03-01,0,0,193,21,214
"14655","Tehama County",1999-04-01,0,0,192,17,209
"14656","Tehama County",1999-05-01,0,0,193,20,213
"14657","Tehama County",1999-06-01,0,0,203,18,221
"14658","Tehama County",1999-07-01,138,11,66,9,224
"14659","Tehama County",1999-08-01,134,12,58,11,215
"14660","Tehama County",1999-09-01,127,12,59,11,209
"14661","Tehama County",1999-10-01,127,8,69,9,213
"14662","Tehama County",1999-11-01,108,8,74,8,198
"14663","Tehama County",1999-12-01,94,11,69,6,180
"14664","Tehama County",2000-01-01,109,13,62,7,191
"14665","Tehama County",2000-02-01,120,9,76,9,214
"14666","Tehama County",2000-03-01,115,11,80,10,216
"14667","Tehama County",2000-04-01,100,11,88,7,206
"14668","Tehama County",2000-05-01,96,11,88,8,203
"14669","Tehama County",2000-06-01,95,12,77,8,192
"14670","Tehama County",2000-07-01,86,15,73,7,181
"14671","Tehama County",2000-08-01,82,15,70,9,176
"14672","Tehama County",2000-09-01,81,12,78,12,183
"14673","Tehama County",2000-10-01,85,13,88,12,198
"14674","Tehama County",2000-11-01,74,10,89,13,186
"14675","Tehama County",2000-12-01,80,8,84,17,189
"14676","Tehama County",2001-01-01,72,11,84,13,180
"14677","Tehama County",2001-02-01,70,11,88,12,181
"14678","Tehama County",2001-03-01,71,9,83,14,177
"14679","Tehama County",2001-04-01,88,9,75,12,184
"14680","Tehama County",2001-05-01,96,15,65,11,187
"14681","Tehama County",2001-06-01,93,15,69,11,188
"14682","Tehama County",2001-07-01,95,19,76,8,198
"14683","Tehama County",2001-08-01,86,11,75,13,185
"14684","Tehama County",2001-09-01,107,14,61,13,195
"14685","Tehama County",2001-10-01,99,17,57,10,183
"14686","Tehama County",2001-11-01,83,14,60,12,169
"14687","Tehama County",2001-12-01,86,50,12,10,158
"14688","Tehama County",2002-01-01,84,17,52,7,160
"14689","Tehama County",2002-02-01,92,16,63,10,181
"14690","Tehama County",2002-03-01,88,11,70,11,180
"14691","Tehama County",2002-04-01,85,13,72,11,181
"14692","Tehama County",2002-05-01,19,2,29,2,52
"14693","Tehama County",2002-06-01,13,3,28,3,47
"14694","Tehama County",2002-07-01,85,12,72,13,182
"14695","Tehama County",2002-08-01,15,4,27,3,49
"14696","Tehama County",2002-09-01,13,2,26,3,44
"14697","Tehama County",2002-10-01,79,14,74,11,178
"14698","Tehama County",2002-11-01,18,4,26,1,49
"14699","Tehama County",2002-12-01,18,3,24,1,46
"14700","Tehama County",2003-01-01,19,5,23,3,50
"14701","Tehama County",2003-02-01,15,4,20,2,41
"14702","Tehama County",2003-03-01,72,11,73,12,168
"14703","Tehama County",2003-04-01,70,9,77,13,169
"14704","Tehama County",2003-05-01,66,8,75,11,160
"14705","Tehama County",2003-06-01,81,14,80,10,185
"14706","Tehama County",2003-07-01,21,4,20,1,46
"14707","Tehama County",2003-08-01,72,11,74,14,171
"14708","Tehama County",2003-09-01,19,4,22,5,50
"14709","Tehama County",2003-10-01,26,3,24,3,56
"14710","Tehama County",2003-11-01,105,13,67,13,198
"14711","Tehama County",2003-12-01,28,1,23,4,56
"14712","Tehama County",2004-01-01,29,3,21,4,57
"14713","Tehama County",2004-02-01,31,3,21,4,59
"14714","Tehama County",2004-03-01,31,5,24,5,65
"14715","Tehama County",2004-04-01,89,10,76,15,190
"14716","Tehama County",2004-05-01,31,5,31,5,72
"14717","Tehama County",2004-06-01,28,5,25,5,63
"14718","Tehama County",2004-07-01,84,18,82,15,199
"14719","Tehama County",2004-08-01,89,21,76,14,200
"14720","Tehama County",2004-09-01,88,17,64,19,188
"14721","Tehama County",2004-10-01,85,13,53,23,174
"14722","Tehama County",2004-11-01,91,16,50,23,180
"14723","Tehama County",2004-12-01,78,16,50,20,164
"14724","Tehama County",2005-01-01,74,19,56,19,168
"14725","Tehama County",2005-02-01,92,17,55,21,185
"14726","Tehama County",2005-03-01,96,19,53,17,185
"14727","Tehama County",2005-04-01,94,12,57,17,180
"14728","Tehama County",2005-05-01,89,16,52,14,171
"14729","Tehama County",2005-06-01,91,16,47,15,169
"14730","Tehama County",2005-07-01,84,20,49,17,170
"14731","Tehama County",2005-08-01,97,23,53,20,193
"14732","Tehama County",2005-09-01,98,24,50,20,192
"14733","Tehama County",2005-10-01,88,21,54,19,182
"14734","Tehama County",2005-11-01,91,18,59,18,186
"14735","Tehama County",2005-12-01,78,14,58,18,168
"14736","Tehama County",2006-01-01,82,16,59,20,177
"14737","Tehama County",2006-02-01,84,23,53,14,174
"14738","Tehama County",2006-03-01,82,20,59,16,177
"14739","Tehama County",2006-04-01,71,17,65,16,169
"14740","Tehama County",2006-05-01,77,16,71,16,180
"14741","Tehama County",2006-06-01,91,13,59,12,175
"14742","Tehama County",2006-07-01,102,16,56,12,186
"14743","Tehama County",2006-08-01,95,9,61,17,182
"14744","Tehama County",2006-09-01,87,20,56,17,180
"14745","Tehama County",2006-10-01,101,16,55,14,186
"14746","Tehama County",2006-11-01,105,20,63,16,204
"14747","Tehama County",2006-12-01,99,18,63,17,197
"14748","Tehama County",2007-01-01,104,13,65,19,201
"14749","Tehama County",2007-02-01,104,14,69,16,203
"14750","Tehama County",2007-03-01,105,19,64,14,202
"14751","Tehama County",2007-04-01,95,16,70,15,196
"14752","Tehama County",2007-05-01,88,19,60,16,183
"14753","Tehama County",2007-06-01,85,20,59,14,178
"14754","Tehama County",2007-07-01,97,19,55,14,185
"14755","Tehama County",2007-08-01,92,13,63,20,188
"14756","Tehama County",2007-09-01,92,17,57,22,188
"14757","Tehama County",2007-10-01,86,13,54,18,171
"14758","Tehama County",2007-11-01,79,11,60,18,168
"14759","Tehama County",2007-12-01,77,9,57,17,160
"14760","Tehama County",2008-01-01,80,12,64,15,171
"14761","Tehama County",2008-02-01,91,15,73,15,194
"14762","Tehama County",2008-03-01,80,16,69,19,184
"14763","Tehama County",2008-04-01,72,11,66,27,176
"14764","Tehama County",2008-05-01,75,12,68,23,178
"14765","Tehama County",2008-06-01,73,13,63,23,172
"14766","Tehama County",2008-07-01,78,12,70,21,181
"14767","Tehama County",2008-08-01,72,10,71,15,168
"14768","Tehama County",2008-09-01,71,13,65,17,166
"14769","Tehama County",2008-10-01,86,14,56,18,174
"14770","Tehama County",2008-11-01,92,12,57,23,184
"14771","Tehama County",2008-12-01,83,13,63,17,176
"14772","Tehama County",2009-01-01,73,14,69,12,168
"14773","Tehama County",2009-02-01,69,19,68,9,165
"14774","Tehama County",2009-03-01,72,18,66,13,169
"14775","Tehama County",2009-04-01,89,20,64,15,188
"14776","Tehama County",2009-05-01,96,24,68,15,203
"14777","Tehama County",2009-06-01,100,21,64,17,202
"14778","Tehama County",2009-07-01,106,18,65,19,208
"14779","Tehama County",2009-08-01,100,19,70,14,203
"14780","Tehama County",2009-09-01,86,17,66,14,183
"14781","Tehama County",2009-10-01,94,14,61,21,190
"14782","Tehama County",2009-11-01,104,14,60,24,202
"14783","Tehama County",2009-12-01,88,19,55,18,180
"14784","Tehama County",2010-01-01,87,17,61,16,181
"14785","Tehama County",2010-02-01,84,14,56,8,162
"14786","Tehama County",2010-03-01,86,13,60,15,174
"14787","Tehama County",2010-04-01,92,14,59,14,179
"14788","Tehama County",2010-05-01,101,15,53,10,179
"14789","Tehama County",2010-06-01,101,19,46,12,178
"14790","Tehama County",2010-07-01,100,15,41,16,172
"14791","Tehama County",2010-08-01,105,16,43,16,180
"14792","Tehama County",2010-09-01,118,16,42,15,191
"14793","Tehama County",2010-10-01,124,14,39,12,189
"14794","Tehama County",2010-11-01,121,14,43,10,188
"14795","Tehama County",2010-12-01,114,14,32,12,172
"14796","Tehama County",2011-01-01,105,13,40,11,169
"14797","Tehama County",2011-02-01,99,15,50,14,178
"14798","Tehama County",2011-03-01,90,13,50,11,164
"14799","Tehama County",2011-04-01,93,17,46,9,165
"14800","Tehama County",2011-05-01,95,15,50,9,169
"14801","Tehama County",2011-06-01,105,11,59,15,190
"14802","Tehama County",2011-07-01,112,15,52,10,189
"14803","Tehama County",2011-08-01,110,16,47,11,184
"14804","Tehama County",2011-09-01,114,16,46,18,194
"14805","Tehama County",2011-10-01,115,13,52,12,192
"14806","Tehama County",2011-11-01,107,12,55,13,187
"14807","Tehama County",2011-12-01,100,14,56,12,182
"14808","Tehama County",2012-01-01,108,18,53,6,185
"14809","Tehama County",2012-02-01,92,16,64,5,177
"14810","Tehama County",2012-03-01,96,18,70,13,197
"14811","Tehama County",2012-04-01,98,18,70,14,200
"14812","Tehama County",2012-05-01,110,16,68,16,210
"14813","Tehama County",2012-06-01,97,19,74,14,204
"14814","Tehama County",2012-07-01,101,16,71,9,197
"14815","Tehama County",2012-08-01,88,16,73,16,193
"14816","Tehama County",2012-09-01,88,16,73,16,193
"14817","Tehama County",2012-10-01,97,16,65,15,193
"14818","Tehama County",2012-11-01,108,17,73,11,209
"14819","Tehama County",2012-12-01,91,20,73,8,192
"14820","Tehama County",2013-01-01,88,15,68,12,183
"14821","Tehama County",2013-02-01,91,14,64,13,182
"14822","Tehama County",2013-03-01,90,13,64,12,179
"14823","Tehama County",2013-04-01,92,11,79,15,197
"14824","Tehama County",2013-05-01,85,9,80,15,189
"14825","Tehama County",2013-06-01,88,7,71,4,170
"14826","Tehama County",2013-07-01,94,10,54,13,171
"14827","Tehama County",2013-08-01,108,11,61,4,184
"14828","Tehama County",2013-09-01,93,12,68,8,181
"14829","Tehama County",2013-10-01,83,14,61,12,170
"14830","Tehama County",2013-11-01,88,11,65,9,173
"14831","Tehama County",2013-12-01,84,12,75,7,178
"14832","Tehama County",2014-01-01,92,15,68,6,181
"14833","Tehama County",2014-02-01,100,13,62,8,183
"14834","Tehama County",2014-03-01,98,10,68,13,189
"14835","Tehama County",2014-04-01,94,12,72,12,190
"14836","Tehama County",2014-05-01,92,13,61,10,176
"14837","Tehama County",2014-06-01,96,9,68,16,189
"14838","Tehama County",2014-07-01,86,7,74,18,185
"14839","Tehama County",2014-08-01,81,6,83,14,184
"14840","Tehama County",2014-09-01,83,9,87,13,192
"14841","Tehama County",2014-10-01,77,14,82,12,185
"14842","Tehama County",2014-11-01,86,16,73,15,190
"14843","Tehama County",2014-12-01,81,14,71,18,184
"14844","Tehama County",2015-01-01,82,17,69,17,185
"14845","Tehama County",2015-02-01,75,14,72,17,178
"14846","Tehama County",2015-03-01,76,12,80,13,181
"14847","Tehama County",2015-04-01,82,11,77,14,184
"14848","Tehama County",2015-05-01,89,14,76,14,193
"14849","Tehama County",2015-06-01,100,13,72,14,199
"14850","Tehama County",2015-07-01,98,12,69,6,185
"14851","Tehama County",2015-08-01,98,17,54,8,177
"14852","Tehama County",2015-09-01,101,17,57,11,186
"14853","Tehama County",2015-10-01,91,19,70,15,195
"14854","Tehama County",2015-11-01,89,14,73,19,195
"14855","Tehama County",2015-12-01,84,15,76,18,193
"14856","Tehama County",2016-01-01,90,18,68,21,197
"14857","Tehama County",2016-02-01,90,17,72,22,201
"14858","Tehama County",2016-03-01,95,15,70,22,202
"14859","Tehama County",2016-04-01,95,11,73,24,203
"14860","Tehama County",2016-05-01,98,13,68,22,201
"14861","Tehama County",2016-06-01,103,11,66,20,200
"14862","Tehama County",2016-07-01,102,16,70,17,205
"14863","Tehama County",2016-08-01,109,16,71,15,211
"14864","Tehama County",2016-09-01,94,12,71,17,194
"14865","Tehama County",2016-10-01,89,13,74,14,190
"14866","Tehama County",2016-11-01,104,12,63,13,192
"14867","Tehama County",2016-12-01,99,10,62,14,185
"14868","Tehama County",2017-01-01,104,11,69,12,196
"14869","Tehama County",2017-02-01,98,15,71,15,199
"14870","Tehama County",2017-03-01,100,12,66,13,191
"14871","Tehama County",2017-04-01,100,14,64,11,189
"14872","Tehama County",2017-05-01,102,15,61,10,188
"14873","Tehama County",2017-06-01,94,15,58,11,178
"14874","Tehama County",2017-07-01,108,16,53,15,192
"14875","Tehama County",2017-08-01,104,12,58,14,188
"14876","Tehama County",2017-09-01,100,14,60,16,190
"14877","Tehama County",2017-10-01,105,12,53,19,189
"14878","Tehama County",2017-11-01,101,11,63,17,192
"14879","Tehama County",2017-12-01,97,13,63,16,189
"14880","Tehama County",2018-01-01,98,17,64,12,191
"14881","Tehama County",2018-02-01,100,17,66,8,191
"14882","Tehama County",2018-03-01,102,19,62,11,194
"14883","Tehama County",2018-04-01,104,23,56,13,196
"14884","Tehama County",2018-05-01,102,24,57,13,196
"14885","Tehama County",2018-06-01,91,11,66,14,182
"14886","Tehama County",2018-07-01,NA,NA,NA,NA,NA
"14887","Tehama County",2018-08-01,101,17,58,16,192
"14888","Tehama County",2018-09-01,108,16,54,16,194
"14889","Tehama County",2018-10-01,115,10,56,17,198
"14890","Tehama County",2018-11-01,53,12,59,9,133
"14891","Tehama County",2018-12-01,102,13,64,14,193
"14892","Tehama County",2019-01-01,101,18,55,16,190
"14893","Tehama County",2019-02-01,105,14,52,20,191
"14894","Tehama County",2019-03-01,98,15,58,19,190
"14895","Tehama County",2019-04-01,96,18,60,18,192
"14896","Tehama County",2019-05-01,97,22,57,11,187
"14897","Tehama County",2019-06-01,89,24,62,8,183
"14898","Tehama County",2019-07-01,47,10,35,6,98
"14899","Tehama County",2019-08-01,87,15,64,15,181
"14900","Tehama County",2019-09-01,88,17,54,15,174
"14901","Tehama County",2019-10-01,88,14,65,18,185
"14902","Tehama County",2019-11-01,73,17,65,19,174
"14903","Tehama County",2019-12-01,73,16,63,17,169
"14904","Tehama County",2020-01-01,75,19,70,16,180
"14905","Tehama County",2020-02-01,76,17,66,13,172
"14906","Tehama County",2020-03-01,81,12,62,11,166
"14907","Trinity County",1995-10-01,12,3,14,1,30
"14908","Trinity County",1995-11-01,14,2,12,0,28
"14909","Trinity County",1995-12-01,12,1,12,1,26
"14910","Trinity County",1996-01-01,16,1,12,2,31
"14911","Trinity County",1996-02-01,10,1,12,0,23
"14912","Trinity County",1996-03-01,13,1,18,2,34
"14913","Trinity County",1996-04-01,16,0,15,4,35
"14914","Trinity County",1996-05-01,13,1,14,2,30
"14915","Trinity County",1996-06-01,10,0,16,3,29
"14916","Trinity County",1996-07-01,13,0,15,2,30
"14917","Trinity County",1996-08-01,11,1,11,1,24
"14918","Trinity County",1996-09-01,11,0,11,2,24
"14919","Trinity County",1996-10-01,18,1,17,1,37
"14920","Trinity County",1996-11-01,16,1,13,0,30
"14921","Trinity County",1996-12-01,17,0,15,2,34
"14922","Trinity County",1997-01-01,16,1,15,2,34
"14923","Trinity County",1997-02-01,18,1,16,2,37
"14924","Trinity County",1997-03-01,17,1,21,2,41
"14925","Trinity County",1997-04-01,19,1,21,3,44
"14926","Trinity County",1997-05-01,25,2,14,3,44
"14927","Trinity County",1997-06-01,20,3,22,3,48
"14928","Trinity County",1997-07-01,24,1,17,4,46
"14929","Trinity County",1997-08-01,29,2,17,3,51
"14930","Trinity County",1997-09-01,28,2,20,2,52
"14931","Trinity County",1997-10-01,21,1,28,2,52
"14932","Trinity County",1997-11-01,21,2,20,3,46
"14933","Trinity County",1997-12-01,19,3,22,1,45
"14934","Trinity County",1998-01-01,25,3,16,2,46
"14935","Trinity County",1998-02-01,24,4,16,4,48
"14936","Trinity County",1998-03-01,31,4,20,5,60
"14937","Trinity County",1998-04-01,28,7,22,3,60
"14938","Trinity County",1998-05-01,24,5,23,5,57
"14939","Trinity County",1998-06-01,23,3,21,6,53
"14940","Trinity County",1998-07-01,29,3,17,6,55
"14941","Trinity County",1998-08-01,27,4,17,3,51
"14942","Trinity County",1998-09-01,28,4,16,3,51
"14943","Trinity County",1998-10-01,28,4,22,3,57
"14944","Trinity County",1998-11-01,19,5,23,2,49
"14945","Trinity County",1998-12-01,17,2,22,1,42
"14946","Trinity County",1999-01-01,15,3,27,4,49
"14947","Trinity County",1999-02-01,14,4,21,5,44
"14948","Trinity County",1999-03-01,15,5,20,4,44
"14949","Trinity County",1999-04-01,11,5,15,5,36
"14950","Trinity County",1999-05-01,12,5,14,3,34
"14951","Trinity County",1999-06-01,9,4,16,5,34
"14952","Trinity County",1999-07-01,14,4,14,3,35
"14953","Trinity County",1999-08-01,12,3,12,3,30
"14954","Trinity County",1999-09-01,13,3,18,5,39
"14955","Trinity County",1999-10-01,14,4,14,3,35
"14956","Trinity County",1999-11-01,12,3,12,3,30
"14957","Trinity County",1999-12-01,13,3,18,5,39
"14958","Trinity County",2000-01-01,14,4,18,1,37
"14959","Trinity County",2000-02-01,15,3,20,2,40
"14960","Trinity County",2000-03-01,18,6,19,3,46
"14961","Trinity County",2000-04-01,13,5,23,4,45
"14962","Trinity County",2000-05-01,16,3,24,6,49
"14963","Trinity County",2000-06-01,16,3,15,4,38
"14964","Trinity County",2000-07-01,13,5,17,2,37
"14965","Trinity County",2000-08-01,17,2,17,4,40
"14966","Trinity County",2000-09-01,17,3,19,5,44
"14967","Trinity County",2000-10-01,15,2,21,8,46
"14968","Trinity County",2000-11-01,14,4,20,3,41
"14969","Trinity County",2000-12-01,11,3,22,6,42
"14970","Trinity County",2001-01-01,11,1,15,6,33
"14971","Trinity County",2001-02-01,17,3,17,5,42
"14972","Trinity County",2001-03-01,14,4,10,4,32
"14973","Trinity County",2001-04-01,20,4,7,2,33
"14974","Trinity County",2001-05-01,20,5,6,2,33
"14975","Trinity County",2001-06-01,20,2,9,2,33
"14976","Trinity County",2001-07-01,18,3,7,2,30
"14977","Trinity County",2001-08-01,17,3,7,2,29
"14978","Trinity County",2001-09-01,18,5,6,2,31
"14979","Trinity County",2001-10-01,20,8,12,7,47
"14980","Trinity County",2001-11-01,20,8,12,7,47
"14981","Trinity County",2001-12-01,20,8,12,7,47
"14982","Trinity County",2002-01-01,24,4,18,8,54
"14983","Trinity County",2002-02-01,25,3,19,7,54
"14984","Trinity County",2002-03-01,31,3,13,7,54
"14985","Trinity County",2002-04-01,27,3,19,3,52
"14986","Trinity County",2002-05-01,24,2,16,3,45
"14987","Trinity County",2002-06-01,18,2,21,5,46
"14988","Trinity County",2002-07-01,21,4,21,4,50
"14989","Trinity County",2002-08-01,24,3,17,3,47
"14990","Trinity County",2002-09-01,26,5,9,1,41
"14991","Trinity County",2002-10-01,33,5,7,0,45
"14992","Trinity County",2002-11-01,28,6,11,2,47
"14993","Trinity County",2002-12-01,28,5,15,2,50
"14994","Trinity County",2003-01-01,17,3,16,2,38
"14995","Trinity County",2003-02-01,26,1,15,3,45
"14996","Trinity County",2003-03-01,23,2,14,4,43
"14997","Trinity County",2003-04-01,23,5,11,3,42
"14998","Trinity County",2003-05-01,24,5,12,3,44
"14999","Trinity County",2003-06-01,17,3,14,2,36
"15000","Trinity County",2003-07-01,12,5,11,6,34
"15001","Trinity County",2003-08-01,11,6,9,2,28
"15002","Trinity County",2003-09-01,16,6,16,1,39
"15003","Trinity County",2003-10-01,16,3,16,3,38
"15004","Trinity County",2003-11-01,21,3,15,3,42
"15005","Trinity County",2003-12-01,16,4,11,2,33
"15006","Trinity County",2004-01-01,13,4,12,2,31
"15007","Trinity County",2004-02-01,17,6,15,0,38
"15008","Trinity County",2004-03-01,12,7,23,2,44
"15009","Trinity County",2004-04-01,11,8,18,2,39
"15010","Trinity County",2004-05-01,12,8,16,1,37
"15011","Trinity County",2004-06-01,16,8,14,3,41
"15012","Trinity County",2004-07-01,23,8,11,6,48
"15013","Trinity County",2004-08-01,16,6,11,3,36
"15014","Trinity County",2004-09-01,16,5,14,2,37
"15015","Trinity County",2004-10-01,13,6,13,5,37
"15016","Trinity County",2004-11-01,14,4,12,6,36
"15017","Trinity County",2004-12-01,8,6,17,2,33
"15018","Trinity County",2005-01-01,10,3,15,1,29
"15019","Trinity County",2005-02-01,17,3,17,1,38
"15020","Trinity County",2005-03-01,15,3,15,1,34
"15021","Trinity County",2005-04-01,16,3,20,2,41
"15022","Trinity County",2005-05-01,17,4,15,4,40
"15023","Trinity County",2005-06-01,21,5,15,1,42
"15024","Trinity County",2005-07-01,22,7,16,3,48
"15025","Trinity County",2005-08-01,22,5,14,2,43
"15026","Trinity County",2005-09-01,21,5,16,5,47
"15027","Trinity County",2005-10-01,17,7,15,2,41
"15028","Trinity County",2005-11-01,16,6,20,4,46
"15029","Trinity County",2005-12-01,13,5,23,3,44
"15030","Trinity County",2006-01-01,12,5,23,2,42
"15031","Trinity County",2006-02-01,11,4,26,5,46
"15032","Trinity County",2006-03-01,9,5,25,5,44
"15033","Trinity County",2006-04-01,16,4,26,4,50
"15034","Trinity County",2006-05-01,15,7,24,1,47
"15035","Trinity County",2006-06-01,16,8,22,3,49
"15036","Trinity County",2006-07-01,15,7,21,2,45
"15037","Trinity County",2006-08-01,14,6,20,2,42
"15038","Trinity County",2006-09-01,12,5,22,1,40
"15039","Trinity County",2006-10-01,19,5,26,0,50
"15040","Trinity County",2006-11-01,17,6,25,1,49
"15041","Trinity County",2006-12-01,14,6,17,2,39
"15042","Trinity County",2007-01-01,17,6,19,2,44
"15043","Trinity County",2007-02-01,16,4,16,2,38
"15044","Trinity County",2007-03-01,15,5,18,1,39
"15045","Trinity County",2007-04-01,12,5,22,0,39
"15046","Trinity County",2007-05-01,12,3,24,0,39
"15047","Trinity County",2007-06-01,12,3,19,0,34
"15048","Trinity County",2007-07-01,13,1,16,1,31
"15049","Trinity County",2007-08-01,11,1,14,2,28
"15050","Trinity County",2007-09-01,14,3,15,4,36
"15051","Trinity County",2007-10-01,12,3,16,3,34
"15052","Trinity County",2007-11-01,12,3,28,5,48
"15053","Trinity County",2007-12-01,12,2,26,3,43
"15054","Trinity County",2008-01-01,13,6,22,1,42
"15055","Trinity County",2008-02-01,13,4,24,2,43
"15056","Trinity County",2008-03-01,15,4,24,2,45
"15057","Trinity County",2008-04-01,15,3,24,2,44
"15058","Trinity County",2008-05-01,13,4,25,3,45
"15059","Trinity County",2008-06-01,16,5,23,2,46
"15060","Trinity County",2008-07-01,22,4,16,2,44
"15061","Trinity County",2008-08-01,24,4,15,2,45
"15062","Trinity County",2008-09-01,18,3,17,3,41
"15063","Trinity County",2008-10-01,18,2,16,2,38
"15064","Trinity County",2008-11-01,17,3,19,1,40
"15065","Trinity County",2008-12-01,15,3,26,1,45
"15066","Trinity County",2009-01-01,17,1,22,2,42
"15067","Trinity County",2009-02-01,14,4,27,2,47
"15068","Trinity County",2009-03-01,16,1,14,1,32
"15069","Trinity County",2009-04-01,19,4,18,2,43
"15070","Trinity County",2009-05-01,24,5,10,0,39
"15071","Trinity County",2009-06-01,19,6,9,2,36
"15072","Trinity County",2009-07-01,13,4,14,2,33
"15073","Trinity County",2009-08-01,14,5,14,1,34
"15074","Trinity County",2009-09-01,13,5,18,1,37
"15075","Trinity County",2009-10-01,17,3,17,2,39
"15076","Trinity County",2009-11-01,15,4,16,4,39
"15077","Trinity County",2009-12-01,9,4,16,3,32
"15078","Trinity County",2010-01-01,12,4,18,3,37
"15079","Trinity County",2010-02-01,16,4,16,3,39
"15080","Trinity County",2010-03-01,14,2,15,4,35
"15081","Trinity County",2010-04-01,10,3,15,5,33
"15082","Trinity County",2010-05-01,12,3,16,4,35
"15083","Trinity County",2010-06-01,11,3,17,3,34
"15084","Trinity County",2010-07-01,12,4,18,3,37
"15085","Trinity County",2010-08-01,11,4,19,7,41
"15086","Trinity County",2010-09-01,15,2,19,5,41
"15087","Trinity County",2010-10-01,10,2,25,9,46
"15088","Trinity County",2010-11-01,14,4,24,6,48
"15089","Trinity County",2010-12-01,17,3,27,4,51
"15090","Trinity County",2011-01-01,13,3,24,4,44
"15091","Trinity County",2011-02-01,12,3,21,3,39
"15092","Trinity County",2011-03-01,14,2,25,2,43
"15093","Trinity County",2011-04-01,14,3,29,2,48
"15094","Trinity County",2011-05-01,12,3,27,3,45
"15095","Trinity County",2011-06-01,13,1,30,3,47
"15096","Trinity County",2011-07-01,17,3,45,5,70
"15097","Trinity County",2011-08-01,14,1,30,7,52
"15098","Trinity County",2011-09-01,15,2,25,9,51
"15099","Trinity County",2011-10-01,12,2,31,9,54
"15100","Trinity County",2011-11-01,10,2,38,8,58
"15101","Trinity County",2011-12-01,11,2,32,8,53
"15102","Trinity County",2012-01-01,13,1,35,7,56
"15103","Trinity County",2012-02-01,16,2,33,5,56
"15104","Trinity County",2012-03-01,16,3,32,6,57
"15105","Trinity County",2012-04-01,16,4,31,5,56
"15106","Trinity County",2012-05-01,14,3,30,5,52
"15107","Trinity County",2012-06-01,15,4,33,4,56
"15108","Trinity County",2012-07-01,21,4,30,4,59
"15109","Trinity County",2012-08-01,21,3,31,4,59
"15110","Trinity County",2012-09-01,18,5,29,2,54
"15111","Trinity County",2012-10-01,25,7,23,2,57
"15112","Trinity County",2012-11-01,28,7,21,3,59
"15113","Trinity County",2012-12-01,27,4,25,5,61
"15114","Trinity County",2013-01-01,18,7,15,3,43
"15115","Trinity County",2013-02-01,21,7,21,4,53
"15116","Trinity County",2013-03-01,23,6,22,3,54
"15117","Trinity County",2013-04-01,24,7,20,4,55
"15118","Trinity County",2013-05-01,25,7,25,1,58
"15119","Trinity County",2013-06-01,32,6,21,2,61
"15120","Trinity County",2013-07-01,25,5,28,0,58
"15121","Trinity County",2013-08-01,21,4,24,2,51
"15122","Trinity County",2013-09-01,25,5,18,0,48
"15123","Trinity County",2013-10-01,27,4,17,0,48
"15124","Trinity County",2013-11-01,28,5,16,2,51
"15125","Trinity County",2013-12-01,33,3,14,1,51
"15126","Trinity County",2014-01-01,24,2,22,2,50
"15127","Trinity County",2014-02-01,26,2,21,3,52
"15128","Trinity County",2014-03-01,27,2,17,2,48
"15129","Trinity County",2014-04-01,27,2,19,4,52
"15130","Trinity County",2014-05-01,32,3,18,3,56
"15131","Trinity County",2014-06-01,33,5,15,1,54
"15132","Trinity County",2014-07-01,31,3,15,0,49
"15133","Trinity County",2014-08-01,35,7,12,1,55
"15134","Trinity County",2014-09-01,35,4,16,1,56
"15135","Trinity County",2014-10-01,34,3,16,2,55
"15136","Trinity County",2014-11-01,28,4,17,1,50
"15137","Trinity County",2014-12-01,28,5,15,1,49
"15138","Trinity County",2015-01-01,25,4,13,1,43
"15139","Trinity County",2015-02-01,31,2,10,0,43
"15140","Trinity County",2015-03-01,35,2,7,0,44
"15141","Trinity County",2015-04-01,37,5,8,0,50
"15142","Trinity County",2015-05-01,33,4,12,0,49
"15143","Trinity County",2015-06-01,36,4,11,0,51
"15144","Trinity County",2015-07-01,35,3,11,0,49
"15145","Trinity County",2015-08-01,36,4,11,0,51
"15146","Trinity County",2015-09-01,41,5,9,0,55
"15147","Trinity County",2015-10-01,39,5,10,2,56
"15148","Trinity County",2015-11-01,34,6,12,3,55
"15149","Trinity County",2015-12-01,40,7,10,1,58
"15150","Trinity County",2016-01-01,40,8,8,0,56
"15151","Trinity County",2016-02-01,34,6,12,2,54
"15152","Trinity County",2016-03-01,31,6,10,2,49
"15153","Trinity County",2016-04-01,32,8,8,0,48
"15154","Trinity County",2016-05-01,35,6,6,0,47
"15155","Trinity County",2016-06-01,34,8,11,0,53
"15156","Trinity County",2016-07-01,34,7,10,0,51
"15157","Trinity County",2016-08-01,33,6,8,0,47
"15158","Trinity County",2016-09-01,39,6,9,0,54
"15159","Trinity County",2016-10-01,38,6,14,0,58
"15160","Trinity County",2016-11-01,35,4,13,0,52
"15161","Trinity County",2016-12-01,34,3,12,0,49
"15162","Trinity County",2017-01-01,32,2,9,2,45
"15163","Trinity County",2017-02-01,39,4,7,1,51
"15164","Trinity County",2017-03-01,23,3,21,4,51
"15165","Trinity County",2017-04-01,19,2,19,5,45
"15166","Trinity County",2017-05-01,19,2,17,4,42
"15167","Trinity County",2017-06-01,24,3,11,4,42
"15168","Trinity County",2017-07-01,30,3,11,5,49
"15169","Trinity County",2017-08-01,29,1,14,6,50
"15170","Trinity County",2017-09-01,34,1,10,6,51
"15171","Trinity County",2017-10-01,33,2,17,4,56
"15172","Trinity County",2017-11-01,32,4,18,6,60
"15173","Trinity County",2017-12-01,0,0,0,0,0
"15174","Trinity County",2018-01-01,45,4,6,6,61
"15175","Trinity County",2018-02-01,0,0,0,0,0
"15176","Trinity County",2018-03-01,0,0,0,0,0
"15177","Trinity County",2018-04-01,0,0,0,0,0
"15178","Trinity County",2018-05-01,0,0,0,0,0
"15179","Trinity County",2018-06-01,0,0,0,0,0
"15180","Trinity County",2018-07-01,45,5,9,2,61
"15181","Trinity County",2018-08-01,56,7,6,2,71
"15182","Trinity County",2018-09-01,49,6,7,2,64
"15183","Trinity County",2018-10-01,46,8,7,2,63
"15184","Trinity County",2018-11-01,51,9,5,2,67
"15185","Trinity County",2018-12-01,47,10,5,3,65
"15186","Trinity County",2019-01-01,46,9,5,3,63
"15187","Trinity County",2019-02-01,48,7,5,3,63
"15188","Trinity County",2019-03-01,49,10,4,2,65
"15189","Trinity County",2019-04-01,52,10,5,1,68
"15190","Trinity County",2019-05-01,53,11,4,1,69
"15191","Trinity County",2019-06-01,46,9,5,1,61
"15192","Trinity County",2019-07-01,NA,NA,NA,NA,NA
"15193","Trinity County",2019-08-01,NA,NA,NA,NA,NA
"15194","Trinity County",2019-09-01,NA,NA,NA,NA,NA
"15195","Trinity County",2019-10-01,42,9,5,1,57
"15196","Trinity County",2019-11-01,43,8,6,1,58
"15197","Trinity County",2019-12-01,40,8,4,2,54
"15198","Trinity County",2020-01-01,37,10,5,1,53
"15199","Trinity County",2020-02-01,43,10,4,1,58
"15200","Trinity County",2020-03-01,35,10,12,2,59
"15201","Tulare County",1995-10-01,477,67,619,98,1261
"15202","Tulare County",1995-11-01,411,62,643,94,1210
"15203","Tulare County",1995-12-01,406,53,649,92,1200
"15204","Tulare County",1996-01-01,424,67,647,86,1224
"15205","Tulare County",1996-02-01,475,78,614,74,1241
"15206","Tulare County",1996-03-01,524,75,591,86,1276
"15207","Tulare County",1996-04-01,499,73,622,80,1274
"15208","Tulare County",1996-05-01,476,63,656,82,1277
"15209","Tulare County",1996-06-01,471,62,647,87,1267
"15210","Tulare County",1996-07-01,458,95,659,50,1262
"15211","Tulare County",1996-08-01,462,59,633,88,1242
"15212","Tulare County",1996-09-01,459,63,628,93,1243
"15213","Tulare County",1996-10-01,470,76,627,77,1250
"15214","Tulare County",1996-11-01,450,69,640,82,1241
"15215","Tulare County",1996-12-01,315,62,760,86,1223
"15216","Tulare County",1997-01-01,485,79,634,70,1268
"15217","Tulare County",1997-02-01,469,70,641,88,1268
"15218","Tulare County",1997-03-01,462,72,649,91,1274
"15219","Tulare County",1997-04-01,464,72,656,87,1279
"15220","Tulare County",1997-05-01,479,85,634,78,1276
"15221","Tulare County",1997-06-01,485,77,624,68,1254
"15222","Tulare County",1997-07-01,488,89,614,69,1260
"15223","Tulare County",1997-08-01,465,72,638,87,1262
"15224","Tulare County",1997-09-01,519,90,615,74,1298
"15225","Tulare County",1997-10-01,519,90,615,74,1298
"15226","Tulare County",1997-11-01,579,84,582,64,1309
"15227","Tulare County",1997-12-01,562,81,574,61,1278
"15228","Tulare County",1998-01-01,543,84,565,62,1254
"15229","Tulare County",1998-02-01,583,76,563,64,1286
"15230","Tulare County",1998-03-01,573,90,568,61,1292
"15231","Tulare County",1998-04-01,554,82,559,74,1269
"15232","Tulare County",1998-05-01,557,79,544,83,1263
"15233","Tulare County",1998-06-01,566,69,542,80,1257
"15234","Tulare County",1998-07-01,517,75,508,76,1176
"15235","Tulare County",1998-08-01,298,68,714,77,1157
"15236","Tulare County",1998-09-01,504,63,516,77,1160
"15237","Tulare County",1998-10-01,494,62,508,81,1145
"15238","Tulare County",1998-11-01,505,60,494,85,1144
"15239","Tulare County",1998-12-01,470,58,488,86,1102
"15240","Tulare County",1999-01-01,489,61,509,82,1141
"15241","Tulare County",1999-02-01,490,62,507,82,1141
"15242","Tulare County",1999-03-01,506,67,492,84,1149
"15243","Tulare County",1999-04-01,504,77,486,73,1140
"15244","Tulare County",1999-05-01,494,81,475,71,1121
"15245","Tulare County",1999-06-01,498,73,447,78,1096
"15246","Tulare County",1999-07-01,520,58,433,88,1099
"15247","Tulare County",1999-08-01,531,70,418,81,1100
"15248","Tulare County",1999-09-01,563,78,394,69,1104
"15249","Tulare County",1999-10-01,564,76,404,68,1112
"15250","Tulare County",1999-11-01,554,66,402,64,1086
"15251","Tulare County",1999-12-01,559,61,373,57,1050
"15252","Tulare County",2000-01-01,580,68,391,62,1101
"15253","Tulare County",2000-02-01,583,69,391,68,1111
"15254","Tulare County",2000-03-01,569,56,433,68,1126
"15255","Tulare County",2000-04-01,558,64,448,65,1135
"15256","Tulare County",2000-05-01,374,251,470,65,1160
"15257","Tulare County",2000-06-01,552,66,480,96,1194
"15258","Tulare County",2000-07-01,444,169,497,67,1177
"15259","Tulare County",2000-08-01,600,62,495,68,1225
"15260","Tulare County",2000-09-01,599,49,498,85,1231
"15261","Tulare County",2000-10-01,546,61,528,62,1197
"15262","Tulare County",2000-11-01,529,59,525,69,1182
"15263","Tulare County",2000-12-01,424,60,475,70,1029
"15264","Tulare County",2001-01-01,568,60,470,75,1173
"15265","Tulare County",2001-02-01,758,65,285,78,1186
"15266","Tulare County",2001-03-01,552,64,500,79,1195
"15267","Tulare County",2001-04-01,571,63,489,83,1206
"15268","Tulare County",2001-05-01,578,63,473,73,1187
"15269","Tulare County",2001-06-01,585,73,463,75,1196
"15270","Tulare County",2001-07-01,615,71,424,75,1185
"15271","Tulare County",2001-08-01,610,69,441,68,1188
"15272","Tulare County",2001-09-01,576,77,460,55,1168
"15273","Tulare County",2001-10-01,585,82,442,67,1176
"15274","Tulare County",2001-11-01,593,63,474,54,1184
"15275","Tulare County",2001-12-01,549,73,461,51,1134
"15276","Tulare County",2002-01-01,581,47,437,88,1153
"15277","Tulare County",2002-02-01,598,72,470,60,1200
"15278","Tulare County",2002-03-01,587,75,497,66,1225
"15279","Tulare County",2002-04-01,598,78,479,63,1218
"15280","Tulare County",2002-05-01,591,67,497,74,1229
"15281","Tulare County",2002-06-01,616,83,487,67,1253
"15282","Tulare County",2002-07-01,621,76,476,68,1241
"15283","Tulare County",2002-08-01,615,78,494,72,1259
"15284","Tulare County",2002-09-01,619,62,502,74,1257
"15285","Tulare County",2002-10-01,647,77,471,71,1266
"15286","Tulare County",2002-11-01,656,74,487,64,1281
"15287","Tulare County",2002-12-01,630,83,474,57,1244
"15288","Tulare County",2003-01-01,671,87,426,55,1239
"15289","Tulare County",2003-02-01,643,86,414,54,1197
"15290","Tulare County",2003-03-01,643,52,418,93,1206
"15291","Tulare County",2003-04-01,646,83,409,59,1197
"15292","Tulare County",2003-05-01,638,80,413,68,1199
"15293","Tulare County",2003-06-01,632,87,419,66,1204
"15294","Tulare County",2003-07-01,664,92,404,66,1226
"15295","Tulare County",2003-08-01,662,91,418,72,1243
"15296","Tulare County",2003-09-01,707,90,373,65,1235
"15297","Tulare County",2003-10-01,677,81,395,67,1220
"15298","Tulare County",2003-11-01,676,87,415,55,1233
"15299","Tulare County",2003-12-01,656,79,423,61,1219
"15300","Tulare County",2004-01-01,653,59,422,77,1211
"15301","Tulare County",2004-02-01,660,74,430,64,1228
"15302","Tulare County",2004-03-01,657,73,419,67,1216
"15303","Tulare County",2004-04-01,660,77,407,65,1209
"15304","Tulare County",2004-05-01,675,76,386,64,1201
"15305","Tulare County",2004-06-01,657,87,407,60,1211
"15306","Tulare County",2004-07-01,674,82,410,57,1223
"15307","Tulare County",2004-08-01,676,84,404,60,1224
"15308","Tulare County",2004-09-01,657,87,425,55,1224
"15309","Tulare County",2004-10-01,674,85,414,67,1240
"15310","Tulare County",2004-11-01,669,91,476,59,1295
"15311","Tulare County",2004-12-01,628,86,526,64,1304
"15312","Tulare County",2005-01-01,624,91,555,60,1330
"15313","Tulare County",2005-02-01,610,94,614,58,1376
"15314","Tulare County",2005-03-01,656,97,556,57,1366
"15315","Tulare County",2005-04-01,678,92,497,62,1329
"15316","Tulare County",2005-05-01,649,92,545,63,1349
"15317","Tulare County",2005-06-01,663,105,553,61,1382
"15318","Tulare County",2005-07-01,781,94,427,72,1374
"15319","Tulare County",2005-08-01,736,119,465,62,1382
"15320","Tulare County",2005-09-01,769,139,424,53,1385
"15321","Tulare County",2005-10-01,765,141,417,49,1372
"15322","Tulare County",2005-11-01,789,141,378,49,1357
"15323","Tulare County",2005-12-01,681,113,509,58,1361
"15324","Tulare County",2006-01-01,682,94,500,71,1347
"15325","Tulare County",2006-02-01,690,100,504,64,1358
"15326","Tulare County",2006-03-01,683,105,522,62,1372
"15327","Tulare County",2006-04-01,673,110,602,54,1439
"15328","Tulare County",2006-05-01,788,135,541,45,1509
"15329","Tulare County",2006-06-01,820,144,532,39,1535
"15330","Tulare County",2006-07-01,749,107,593,72,1521
"15331","Tulare County",2006-08-01,787,106,529,74,1496
"15332","Tulare County",2006-09-01,702,113,558,69,1442
"15333","Tulare County",2006-10-01,693,101,607,77,1478
"15334","Tulare County",2006-11-01,684,109,593,69,1455
"15335","Tulare County",2006-12-01,653,111,606,69,1439
"15336","Tulare County",2007-01-01,595,126,597,58,1376
"15337","Tulare County",2007-02-01,703,128,598,57,1486
"15338","Tulare County",2007-03-01,705,123,588,95,1511
"15339","Tulare County",2007-04-01,653,110,639,108,1510
"15340","Tulare County",2007-05-01,642,99,686,111,1538
"15341","Tulare County",2007-06-01,653,95,728,108,1584
"15342","Tulare County",2007-07-01,645,110,732,95,1582
"15343","Tulare County",2007-08-01,750,132,619,74,1575
"15344","Tulare County",2007-09-01,723,127,621,100,1571
"15345","Tulare County",2007-10-01,690,106,673,103,1572
"15346","Tulare County",2007-11-01,664,104,683,74,1525
"15347","Tulare County",2007-12-01,632,101,703,99,1535
"15348","Tulare County",2008-01-01,680,114,655,100,1549
"15349","Tulare County",2008-02-01,667,116,665,88,1536
"15350","Tulare County",2008-03-01,653,109,678,105,1545
"15351","Tulare County",2008-04-01,673,103,656,104,1536
"15352","Tulare County",2008-05-01,640,98,665,112,1515
"15353","Tulare County",2008-06-01,642,104,700,108,1554
"15354","Tulare County",2008-07-01,657,106,661,104,1528
"15355","Tulare County",2008-08-01,682,105,652,106,1545
"15356","Tulare County",2008-09-01,682,108,641,101,1532
"15357","Tulare County",2008-10-01,641,90,665,123,1519
"15358","Tulare County",2008-11-01,617,76,683,137,1513
"15359","Tulare County",2008-12-01,602,82,657,133,1474
"15360","Tulare County",2009-01-01,641,84,666,132,1523
"15361","Tulare County",2009-02-01,619,74,634,138,1465
"15362","Tulare County",2009-03-01,836,72,431,139,1478
"15363","Tulare County",2009-04-01,696,84,641,129,1550
"15364","Tulare County",2009-05-01,693,81,630,137,1541
"15365","Tulare County",2009-06-01,684,86,656,133,1559
"15366","Tulare County",2009-07-01,686,90,666,132,1574
"15367","Tulare County",2009-08-01,684,80,662,136,1562
"15368","Tulare County",2009-09-01,629,75,686,142,1532
"15369","Tulare County",2009-10-01,661,75,698,144,1578
"15370","Tulare County",2009-11-01,626,57,681,150,1514
"15371","Tulare County",2009-12-01,636,65,631,149,1481
"15372","Tulare County",2010-01-01,680,74,592,135,1481
"15373","Tulare County",2010-02-01,669,77,520,109,1375
"15374","Tulare County",2010-03-01,625,76,530,116,1347
"15375","Tulare County",2010-04-01,639,82,496,103,1320
"15376","Tulare County",2010-05-01,632,91,480,109,1312
"15377","Tulare County",2010-06-01,668,88,465,92,1313
"15378","Tulare County",2010-07-01,672,89,462,98,1321
"15379","Tulare County",2010-08-01,700,91,486,112,1389
"15380","Tulare County",2010-09-01,707,103,484,114,1408
"15381","Tulare County",2010-10-01,607,70,536,137,1350
"15382","Tulare County",2010-11-01,656,64,465,123,1308
"15383","Tulare County",2010-12-01,667,57,389,108,1221
"15384","Tulare County",2011-01-01,623,71,442,106,1242
"15385","Tulare County",2011-02-01,649,69,467,111,1296
"15386","Tulare County",2011-03-01,603,73,507,91,1274
"15387","Tulare County",2011-04-01,653,85,511,100,1349
"15388","Tulare County",2011-05-01,668,84,528,102,1382
"15389","Tulare County",2011-06-01,697,100,523,85,1405
"15390","Tulare County",2011-07-01,703,105,502,66,1376
"15391","Tulare County",2011-08-01,730,112,497,54,1393
"15392","Tulare County",2011-09-01,691,94,522,72,1379
"15393","Tulare County",2011-10-01,689,106,545,69,1409
"15394","Tulare County",2011-11-01,727,104,519,76,1426
"15395","Tulare County",2011-12-01,704,89,592,109,1494
"15396","Tulare County",2012-01-01,695,92,615,119,1521
"15397","Tulare County",2012-02-01,711,86,624,129,1550
"15398","Tulare County",2012-03-01,695,87,617,125,1524
"15399","Tulare County",2012-04-01,722,97,619,114,1552
"15400","Tulare County",2012-05-01,785,100,609,113,1607
"15401","Tulare County",2012-06-01,812,118,571,106,1607
"15402","Tulare County",2012-07-01,898,114,535,98,1645
"15403","Tulare County",2012-08-01,886,114,520,111,1631
"15404","Tulare County",2012-09-01,892,116,540,93,1641
"15405","Tulare County",2012-10-01,898,110,545,109,1662
"15406","Tulare County",2012-11-01,794,124,655,91,1664
"15407","Tulare County",2012-12-01,866,92,583,122,1663
"15408","Tulare County",2013-01-01,862,90,573,126,1651
"15409","Tulare County",2013-02-01,809,87,605,126,1627
"15410","Tulare County",2013-03-01,782,86,613,129,1610
"15411","Tulare County",2013-04-01,833,88,611,133,1665
"15412","Tulare County",2013-05-01,834,77,604,136,1651
"15413","Tulare County",2013-06-01,826,81,582,132,1621
"15414","Tulare County",2013-07-01,859,98,566,125,1648
"15415","Tulare County",2013-08-01,885,89,549,123,1646
"15416","Tulare County",2013-09-01,892,113,534,110,1649
"15417","Tulare County",2013-10-01,919,123,499,106,1647
"15418","Tulare County",2013-11-01,921,112,505,115,1653
"15419","Tulare County",2013-12-01,915,110,476,119,1620
"15420","Tulare County",2014-01-01,922,106,496,124,1648
"15421","Tulare County",2014-02-01,900,105,529,128,1662
"15422","Tulare County",2014-03-01,920,112,544,129,1705
"15423","Tulare County",2014-04-01,913,124,530,118,1685
"15424","Tulare County",2014-05-01,924,126,559,122,1731
"15425","Tulare County",2014-06-01,927,124,523,120,1694
"15426","Tulare County",2014-07-01,947,121,536,121,1725
"15427","Tulare County",2014-08-01,999,124,523,113,1759
"15428","Tulare County",2014-09-01,1012,123,541,111,1787
"15429","Tulare County",2014-10-01,975,125,562,124,1786
"15430","Tulare County",2014-11-01,880,111,548,117,1656
"15431","Tulare County",2014-12-01,815,85,530,117,1547
"15432","Tulare County",2015-01-01,836,97,465,106,1504
"15433","Tulare County",2015-02-01,690,103,560,84,1437
"15434","Tulare County",2015-03-01,811,108,499,86,1504
"15435","Tulare County",2015-04-01,806,97,494,85,1482
"15436","Tulare County",2015-05-01,796,99,487,88,1470
"15437","Tulare County",2015-06-01,811,95,552,94,1552
"15438","Tulare County",2015-07-01,829,103,549,99,1580
"15439","Tulare County",2015-08-01,848,115,484,91,1538
"15440","Tulare County",2015-09-01,789,89,515,88,1481
"15441","Tulare County",2015-10-01,805,114,537,91,1547
"15442","Tulare County",2015-11-01,802,119,569,98,1588
"15443","Tulare County",2015-12-01,764,114,524,103,1505
"15444","Tulare County",2016-01-01,799,116,474,93,1482
"15445","Tulare County",2016-02-01,787,100,496,104,1487
"15446","Tulare County",2016-03-01,809,114,531,113,1567
"15447","Tulare County",2016-04-01,826,113,578,119,1636
"15448","Tulare County",2016-05-01,832,109,548,124,1613
"15449","Tulare County",2016-06-01,811,99,549,120,1579
"15450","Tulare County",2016-07-01,819,103,564,112,1598
"15451","Tulare County",2016-08-01,812,103,567,116,1598
"15452","Tulare County",2016-09-01,807,106,587,124,1624
"15453","Tulare County",2016-10-01,795,116,575,94,1580
"15454","Tulare County",2016-11-01,774,101,549,122,1546
"15455","Tulare County",2016-12-01,819,111,500,108,1538
"15456","Tulare County",2017-01-01,793,110,537,100,1540
"15457","Tulare County",2017-02-01,788,108,546,112,1554
"15458","Tulare County",2017-03-01,813,105,596,126,1640
"15459","Tulare County",2017-04-01,756,104,599,125,1584
"15460","Tulare County",2017-05-01,796,105,588,136,1625
"15461","Tulare County",2017-06-01,831,108,593,128,1660
"15462","Tulare County",2017-07-01,861,162,602,104,1729
"15463","Tulare County",2017-08-01,867,119,583,130,1699
"15464","Tulare County",2017-09-01,841,124,580,116,1661
"15465","Tulare County",2017-10-01,737,95,751,133,1716
"15466","Tulare County",2017-11-01,852,120,592,101,1665
"15467","Tulare County",2017-12-01,957,118,450,91,1616
"15468","Tulare County",2018-01-01,929,123,470,97,1619
"15469","Tulare County",2018-02-01,937,119,440,96,1592
"15470","Tulare County",2018-03-01,896,113,435,96,1540
"15471","Tulare County",2018-04-01,865,112,447,91,1515
"15472","Tulare County",2018-05-01,858,115,466,95,1534
"15473","Tulare County",2018-06-01,843,102,483,106,1534
"15474","Tulare County",2018-07-01,864,106,448,115,1533
"15475","Tulare County",2018-08-01,861,113,449,115,1538
"15476","Tulare County",2018-09-01,820,105,472,111,1508
"15477","Tulare County",2018-10-01,834,107,439,107,1487
"15478","Tulare County",2018-11-01,801,105,409,99,1414
"15479","Tulare County",2018-12-01,783,102,405,97,1387
"15480","Tulare County",2019-01-01,804,97,386,94,1381
"15481","Tulare County",2019-02-01,806,103,419,85,1413
"15482","Tulare County",2019-03-01,830,102,431,81,1444
"15483","Tulare County",2019-04-01,871,105,457,81,1514
"15484","Tulare County",2019-05-01,894,103,468,78,1543
"15485","Tulare County",2019-06-01,874,124,461,76,1535
"15486","Tulare County",2019-07-01,932,145,451,93,1621
"15487","Tulare County",2019-08-01,935,133,482,100,1650
"15488","Tulare County",2019-09-01,887,118,474,96,1575
"15489","Tulare County",2019-10-01,869,117,441,95,1522
"15490","Tulare County",2019-11-01,828,104,430,100,1462
"15491","Tulare County",2019-12-01,796,106,422,101,1425
"15492","Tulare County",2020-01-01,809,108,425,104,1446
"15493","Tulare County",2020-02-01,773,91,433,103,1400
"15494","Tulare County",2020-03-01,730,83,390,94,1297
"15495","Tuolumne County",1995-10-01,41,9,53,10,113
"15496","Tuolumne County",1995-11-01,43,8,54,12,117
"15497","Tuolumne County",1995-12-01,46,8,51,13,118
"15498","Tuolumne County",1996-01-01,52,7,50,11,120
"15499","Tuolumne County",1996-02-01,58,6,41,13,118
"15500","Tuolumne County",1996-03-01,45,7,50,15,117
"15501","Tuolumne County",1996-04-01,39,6,56,14,115
"15502","Tuolumne County",1996-05-01,42,6,60,8,116
"15503","Tuolumne County",1996-06-01,45,5,58,7,115
"15504","Tuolumne County",1996-07-01,42,4,57,8,111
"15505","Tuolumne County",1996-08-01,34,4,61,12,111
"15506","Tuolumne County",1996-09-01,35,7,61,11,114
"15507","Tuolumne County",1996-10-01,38,11,56,15,120
"15508","Tuolumne County",1996-11-01,38,8,50,14,110
"15509","Tuolumne County",1996-12-01,39,8,48,14,109
"15510","Tuolumne County",1997-01-01,47,6,47,10,110
"15511","Tuolumne County",1997-02-01,48,11,47,6,112
"15512","Tuolumne County",1997-03-01,52,10,46,9,117
"15513","Tuolumne County",1997-04-01,48,7,53,11,119
"15514","Tuolumne County",1997-05-01,34,6,61,9,110
"15515","Tuolumne County",1997-06-01,34,5,63,12,114
"15516","Tuolumne County",1997-07-01,40,9,56,12,117
"15517","Tuolumne County",1997-08-01,40,12,53,13,118
"15518","Tuolumne County",1997-09-01,39.3,8.5,55.66,9.9,113.36
"15519","Tuolumne County",1997-10-01,40,9,56,12,117
"15520","Tuolumne County",1997-11-01,42,6,54,9,111
"15521","Tuolumne County",1997-12-01,36,10,56,11,113
"15522","Tuolumne County",1998-01-01,36,9,60,12,117
"15523","Tuolumne County",1998-02-01,35,7,57,16,115
"15524","Tuolumne County",1998-03-01,44,9,45,17,115
"15525","Tuolumne County",1998-04-01,42,6,49,20,117
"15526","Tuolumne County",1998-05-01,46,7,47,20,120
"15527","Tuolumne County",1998-06-01,44,7,50,14,115
"15528","Tuolumne County",1998-07-01,45,10,53,10,118
"15529","Tuolumne County",1998-08-01,49,6,54,8,117
"15530","Tuolumne County",1998-09-01,42,6,64,6,118
"15531","Tuolumne County",1998-10-01,41,12,55,10,118
"15532","Tuolumne County",1998-11-01,37,9,53,8,107
"15533","Tuolumne County",1998-12-01,36,7,50,10,103
"15534","Tuolumne County",1999-01-01,40,9,49,10,108
"15535","Tuolumne County",1999-02-01,34,7,64,12,117
"15536","Tuolumne County",1999-03-01,30,7,70,13,120
"15537","Tuolumne County",1999-04-01,29,10,63,12,114
"15538","Tuolumne County",1999-05-01,31,10,59,14,114
"15539","Tuolumne County",1999-06-01,39,13,53,14,119
"15540","Tuolumne County",1999-07-01,47,9,49,10,115
"15541","Tuolumne County",1999-08-01,40,8,54,9,111
"15542","Tuolumne County",1999-09-01,36,6,49,10,101
"15543","Tuolumne County",1999-10-01,34,7,44,10,95
"15544","Tuolumne County",1999-11-01,30,6,51,10,97
"15545","Tuolumne County",1999-12-01,32,7,47,6,92
"15546","Tuolumne County",2000-01-01,30,6,53,9,98
"15547","Tuolumne County",2000-02-01,38,9,53,10,110
"15548","Tuolumne County",2000-03-01,37,6,59,10,112
"15549","Tuolumne County",2000-04-01,48,5,50,10,113
"15550","Tuolumne County",2000-05-01,47,7,54,8,116
"15551","Tuolumne County",2000-06-01,45,8,49,11,113
"15552","Tuolumne County",2000-07-01,49,4,51,13,117
"15553","Tuolumne County",2000-08-01,42,4,59,14,119
"15554","Tuolumne County",2000-09-01,42,4,56,10,112
"15555","Tuolumne County",2000-10-01,42,8,57,8,115
"15556","Tuolumne County",2000-11-01,43,9,59,10,121
"15557","Tuolumne County",2000-12-01,44,7,49,11,111
"15558","Tuolumne County",2001-01-01,52,8,49,9,118
"15559","Tuolumne County",2001-02-01,55,6,58,9,128
"15560","Tuolumne County",2001-03-01,51,6,59,8,124
"15561","Tuolumne County",2001-04-01,44,7,60,10,121
"15562","Tuolumne County",2001-05-01,45,6,59,14,124
"15563","Tuolumne County",2001-06-01,39,4,62,11,116
"15564","Tuolumne County",2001-07-01,44,6,58,12,120
"15565","Tuolumne County",2001-08-01,42,11,56,12,121
"15566","Tuolumne County",2001-09-01,50,9,51,15,125
"15567","Tuolumne County",2001-10-01,50,9,56,15,130
"15568","Tuolumne County",2001-11-01,60,7,52,12,131
"15569","Tuolumne County",2001-12-01,56,6,53,12,127
"15570","Tuolumne County",2002-01-01,58,9,51,14,132
"15571","Tuolumne County",2002-02-01,49,11,51,13,124
"15572","Tuolumne County",2002-03-01,50,12,52,14,128
"15573","Tuolumne County",2002-04-01,48,14,53,12,127
"15574","Tuolumne County",2002-05-01,45,16,52,11,124
"15575","Tuolumne County",2002-06-01,44,15,53,11,123
"15576","Tuolumne County",2002-07-01,45,10,55,13,123
"15577","Tuolumne County",2002-08-01,48,11,60,14,133
"15578","Tuolumne County",2002-09-01,56,8,58,15,137
"15579","Tuolumne County",2002-10-01,55,7,65,13,140
"15580","Tuolumne County",2002-11-01,46,8,67,11,132
"15581","Tuolumne County",2002-12-01,40,8,74,10,132
"15582","Tuolumne County",2003-01-01,36,6,34,11,87
"15583","Tuolumne County",2003-02-01,47,5,65,10,127
"15584","Tuolumne County",2003-03-01,51,9,66,9,135
"15585","Tuolumne County",2003-04-01,50,9,65,9,133
"15586","Tuolumne County",2003-05-01,58,12,62,9,141
"15587","Tuolumne County",2003-06-01,55,12,55,8,130
"15588","Tuolumne County",2003-07-01,56,18,53,10,137
"15589","Tuolumne County",2003-08-01,47,16,63,13,139
"15590","Tuolumne County",2003-09-01,52,19,52,12,135
"15591","Tuolumne County",2003-10-01,54,14,51,17,136
"15592","Tuolumne County",2003-11-01,57,14,45,18,134
"15593","Tuolumne County",2003-12-01,64,12,38,15,129
"15594","Tuolumne County",2004-01-01,61,12,50,20,143
"15595","Tuolumne County",2004-02-01,59,14,56,15,144
"15596","Tuolumne County",2004-03-01,53,15,51,10,129
"15597","Tuolumne County",2004-04-01,58,15,41,9,123
"15598","Tuolumne County",2004-05-01,58,13,47,10,128
"15599","Tuolumne County",2004-06-01,58,10,46,10,124
"15600","Tuolumne County",2004-07-01,55,6,47,12,120
"15601","Tuolumne County",2004-08-01,54,10,45,10,119
"15602","Tuolumne County",2004-09-01,52,12,58,10,132
"15603","Tuolumne County",2004-10-01,56,12,51,13,132
"15604","Tuolumne County",2004-11-01,53,14,53,12,132
"15605","Tuolumne County",2004-12-01,58,14,49,12,133
"15606","Tuolumne County",2005-01-01,61,13,49,9,132
"15607","Tuolumne County",2005-02-01,52,10,60,10,132
"15608","Tuolumne County",2005-03-01,46,16,61,12,135
"15609","Tuolumne County",2005-04-01,54,12,57,11,134
"15610","Tuolumne County",2005-05-01,59,9,53,14,135
"15611","Tuolumne County",2005-06-01,61,12,49,13,135
"15612","Tuolumne County",2005-07-01,59,10,52,15,136
"15613","Tuolumne County",2005-08-01,59,11,50,15,135
"15614","Tuolumne County",2005-09-01,64,9,49,13,135
"15615","Tuolumne County",2005-10-01,60,13,47,15,135
"15616","Tuolumne County",2005-11-01,55,12,31,5,103
"15617","Tuolumne County",2005-12-01,69,15,46,5,135
"15618","Tuolumne County",2006-01-01,72,15,43,8,138
"15619","Tuolumne County",2006-02-01,80,19,37,7,143
"15620","Tuolumne County",2006-03-01,89,24,25,3,141
"15621","Tuolumne County",2006-04-01,85,19,34,6,144
"15622","Tuolumne County",2006-05-01,91,16,36,8,151
"15623","Tuolumne County",2006-06-01,88,19,36,6,149
"15624","Tuolumne County",2006-07-01,84,19,37,7,147
"15625","Tuolumne County",2006-08-01,67,17,47,7,138
"15626","Tuolumne County",2006-09-01,70,17,48,9,144
"15627","Tuolumne County",2006-10-01,70,18,45,8,141
"15628","Tuolumne County",2006-11-01,68,18,50,9,145
"15629","Tuolumne County",2006-12-01,68,19,50,11,148
"15630","Tuolumne County",2007-01-01,70,21,42,13,146
"15631","Tuolumne County",2007-02-01,63,20,45,13,141
"15632","Tuolumne County",2007-03-01,63,20,46,12,141
"15633","Tuolumne County",2007-04-01,62,18,44,13,137
"15634","Tuolumne County",2007-05-01,61,18,45,15,139
"15635","Tuolumne County",2007-06-01,57,16,42,18,133
"15636","Tuolumne County",2007-07-01,62,17,43,16,138
"15637","Tuolumne County",2007-08-01,72,15,37,15,139
"15638","Tuolumne County",2007-09-01,72,20,32,14,138
"15639","Tuolumne County",2007-10-01,80,19,32,8,139
"15640","Tuolumne County",2007-11-01,64,15,50,11,140
"15641","Tuolumne County",2007-12-01,62,17,48,9,136
"15642","Tuolumne County",2008-01-01,66,10,49,11,136
"15643","Tuolumne County",2008-02-01,74,11,43,10,138
"15644","Tuolumne County",2008-03-01,80,15,38,7,140
"15645","Tuolumne County",2008-04-01,77,19,39,4,139
"15646","Tuolumne County",2008-05-01,69,16,43,9,137
"15647","Tuolumne County",2008-06-01,66,16,48,9,139
"15648","Tuolumne County",2008-07-01,67,16,44,11,138
"15649","Tuolumne County",2008-08-01,69,15,43,10,137
"15650","Tuolumne County",2008-09-01,64,17,48,9,138
"15651","Tuolumne County",2008-10-01,62,17,50,10,139
"15652","Tuolumne County",2008-11-01,64,13,44,12,133
"15653","Tuolumne County",2008-12-01,61,12,44,12,129
"15654","Tuolumne County",2009-01-01,47,13,37,16,113
"15655","Tuolumne County",2009-02-01,53,12,40,15,120
"15656","Tuolumne County",2009-03-01,45,12,44,13,114
"15657","Tuolumne County",2009-04-01,51,12,52,7,122
"15658","Tuolumne County",2009-05-01,55,11,46,9,121
"15659","Tuolumne County",2009-06-01,51,15,47,10,123
"15660","Tuolumne County",2009-07-01,50,19,41,11,121
"15661","Tuolumne County",2009-08-01,52,17,41,8,118
"15662","Tuolumne County",2009-09-01,57,16,41,9,123
"15663","Tuolumne County",2009-10-01,59,14,37,10,120
"15664","Tuolumne County",2009-11-01,55,14,38,14,121
"15665","Tuolumne County",2009-12-01,47,16,35,15,113
"15666","Tuolumne County",2010-01-01,46,11,33,18,108
"15667","Tuolumne County",2010-02-01,47,13,37,14,111
"15668","Tuolumne County",2010-03-01,50,15,39,15,119
"15669","Tuolumne County",2010-04-01,49,14,37,14,114
"15670","Tuolumne County",2010-05-01,48,14,36,12,110
"15671","Tuolumne County",2010-06-01,45,11,39,14,109
"15672","Tuolumne County",2010-07-01,42,16,37,12,107
"15673","Tuolumne County",2010-08-01,47,17,37,10,111
"15674","Tuolumne County",2010-09-01,47,16,36,14,113
"15675","Tuolumne County",2010-10-01,53,17,29,10,109
"15676","Tuolumne County",2010-11-01,63,11,30,16,120
"15677","Tuolumne County",2010-12-01,54,11,39,9,113
"15678","Tuolumne County",2011-01-01,52,15,45,8,120
"15679","Tuolumne County",2011-02-01,49,12,45,11,117
"15680","Tuolumne County",2011-03-01,51,12,40,13,116
"15681","Tuolumne County",2011-04-01,52,14,42,10,118
"15682","Tuolumne County",2011-05-01,51,16,39,10,116
"15683","Tuolumne County",2011-06-01,51,15,42,12,120
"15684","Tuolumne County",2011-07-01,55,16,33,14,118
"15685","Tuolumne County",2011-08-01,57,16,33,16,122
"15686","Tuolumne County",2011-09-01,58,17,36,10,121
"15687","Tuolumne County",2011-10-01,58,18,38,10,124
"15688","Tuolumne County",2011-11-01,55,17,42,13,127
"15689","Tuolumne County",2011-12-01,55,14,38,13,120
"15690","Tuolumne County",2012-01-01,48,13,42,16,119
"15691","Tuolumne County",2012-02-01,54,14,36,16,120
"15692","Tuolumne County",2012-03-01,63,17,40,13,133
"15693","Tuolumne County",2012-04-01,66,20,38,8,132
"15694","Tuolumne County",2012-05-01,72,18,33,13,136
"15695","Tuolumne County",2012-06-01,69,16,30,11,126
"15696","Tuolumne County",2012-07-01,71,15,33,12,131
"15697","Tuolumne County",2012-08-01,66,13,31,12,122
"15698","Tuolumne County",2012-09-01,70,13,39,13,135
"15699","Tuolumne County",2012-10-01,72,14,40,12,138
"15700","Tuolumne County",2012-11-01,69,18,40,10,137
"15701","Tuolumne County",2012-12-01,75,20,34,8,137
"15702","Tuolumne County",2013-01-01,75,19,36,8,138
"15703","Tuolumne County",2013-02-01,74,22,37,6,139
"15704","Tuolumne County",2013-03-01,74,18,33,12,137
"15705","Tuolumne County",2013-04-01,74,21,32,11,138
"15706","Tuolumne County",2013-05-01,67,24,38,10,139
"15707","Tuolumne County",2013-06-01,71,22,33,12,138
"15708","Tuolumne County",2013-07-01,83,25,23,8,139
"15709","Tuolumne County",2013-08-01,87,28,19,5,139
"15710","Tuolumne County",2013-09-01,84,26,20,6,136
"15711","Tuolumne County",2013-10-01,86,24,20,8,138
"15712","Tuolumne County",2013-11-01,84,26,21,8,139
"15713","Tuolumne County",2013-12-01,79,26,26,8,139
"15714","Tuolumne County",2014-01-01,77,22,29,10,138
"15715","Tuolumne County",2014-02-01,77,20,30,12,139
"15716","Tuolumne County",2014-03-01,80,23,27,10,140
"15717","Tuolumne County",2014-04-01,83,22,27,8,140
"15718","Tuolumne County",2014-05-01,75,19,35,9,138
"15719","Tuolumne County",2014-06-01,80,21,30,8,139
"15720","Tuolumne County",2014-07-01,85,22,27,6,140
"15721","Tuolumne County",2014-08-01,89,21,23,7,140
"15722","Tuolumne County",2014-09-01,92,21,20,7,140
"15723","Tuolumne County",2014-10-01,93,22,18,7,140
"15724","Tuolumne County",2014-11-01,92,23,19,7,141
"15725","Tuolumne County",2014-12-01,95,23,18,7,143
"15726","Tuolumne County",2015-01-01,96,22,20,7,145
"15727","Tuolumne County",2015-02-01,98,19,23,6,146
"15728","Tuolumne County",2015-03-01,92,25,26,2,145
"15729","Tuolumne County",2015-04-01,92,26,22,4,144
"15730","Tuolumne County",2015-05-01,87,24,29,5,145
"15731","Tuolumne County",2015-06-01,85,29,28,3,145
"15732","Tuolumne County",2015-07-01,87,28,24,5,144
"15733","Tuolumne County",2015-08-01,90,28,22,5,145
"15734","Tuolumne County",2015-09-01,83,26,30,6,145
"15735","Tuolumne County",2015-10-01,79,28,29,8,144
"15736","Tuolumne County",2015-11-01,82,28,28,7,145
"15737","Tuolumne County",2015-12-01,85,25,25,8,143
"15738","Tuolumne County",2016-01-01,85,28,22,9,144
"15739","Tuolumne County",2016-02-01,80,32,24,9,145
"15740","Tuolumne County",2016-03-01,78,28,28,9,143
"15741","Tuolumne County",2016-04-01,75,25,31,11,142
"15742","Tuolumne County",2016-05-01,77,30,28,10,145
"15743","Tuolumne County",2016-06-01,82,25,27,10,144
"15744","Tuolumne County",2016-07-01,90,22,24,9,145
"15745","Tuolumne County",2016-08-01,89,24,22,10,145
"15746","Tuolumne County",2016-09-01,89,25,21,10,145
"15747","Tuolumne County",2016-10-01,90,26,18,9,143
"15748","Tuolumne County",2016-11-01,84,27,21,8,140
"15749","Tuolumne County",2016-12-01,84,31,21,6,142
"15750","Tuolumne County",2017-01-01,83,32,23,5,143
"15751","Tuolumne County",2017-02-01,89,31,18,7,145
"15752","Tuolumne County",2017-03-01,91,28,17,9,145
"15753","Tuolumne County",2017-04-01,83,33,19,10,145
"15754","Tuolumne County",2017-05-01,86,33,17,8,144
"15755","Tuolumne County",2017-06-01,87,32,17,8,144
"15756","Tuolumne County",2017-07-01,88,32,18,7,145
"15757","Tuolumne County",2017-08-01,89,28,21,6,144
"15758","Tuolumne County",2017-09-01,93,21,23,8,145
"15759","Tuolumne County",2017-10-01,93,23,21,8,145
"15760","Tuolumne County",2017-11-01,94,23,21,8,146
"15761","Tuolumne County",2017-12-01,95,25,19,5,144
"15762","Tuolumne County",2018-01-01,90,27,23,4,144
"15763","Tuolumne County",2018-02-01,89,26,24,5,144
"15764","Tuolumne County",2018-03-01,89,26,24,6,145
"15765","Tuolumne County",2018-04-01,85,27,26,6,144
"15766","Tuolumne County",2018-05-01,87,28,25,5,145
"15767","Tuolumne County",2018-06-01,90,26,23,6,145
"15768","Tuolumne County",2018-07-01,87,29,22,6,144
"15769","Tuolumne County",2018-08-01,93,23,22,6,144
"15770","Tuolumne County",2018-09-01,94,23,20,6,143
"15771","Tuolumne County",2018-10-01,83,22,26,9,140
"15772","Tuolumne County",2018-11-01,84,22,24,8,138
"15773","Tuolumne County",2018-12-01,79,19,23,8,129
"15774","Tuolumne County",2019-01-01,85,17,25,9,136
"15775","Tuolumne County",2019-02-01,91,18,23,8,140
"15776","Tuolumne County",2019-03-01,96,18,22,7,143
"15777","Tuolumne County",2019-04-01,90,24,24,6,144
"15778","Tuolumne County",2019-05-01,92,22,22,8,144
"15779","Tuolumne County",2019-06-01,93,23,19,9,144
"15780","Tuolumne County",2019-07-01,90,20,24,10,144
"15781","Tuolumne County",2019-08-01,92,19,22,10,143
"15782","Tuolumne County",2019-09-01,87,20,27,9,143
"15783","Tuolumne County",2019-10-01,91,22,24,7,144
"15784","Tuolumne County",2019-11-01,89,25,24,6,144
"15785","Tuolumne County",2019-12-01,81,27,29,7,144
"15786","Tuolumne County",2020-01-01,88,25,24,8,145
"15787","Tuolumne County",2020-02-01,89,24,26,6,145
"15788","Tuolumne County",2020-03-01,77,22,31,7,137
"15789","Ventura County",1995-10-01,567,66,860,122,1615
"15790","Ventura County",1995-11-01,572,82,876,112,1642
"15791","Ventura County",1995-12-01,541,70,822,111,1544
"15792","Ventura County",1996-01-01,541,57,894,122,1614
"15793","Ventura County",1996-02-01,585,63,900,123,1671
"15794","Ventura County",1996-03-01,554,63,885,106,1608
"15795","Ventura County",1996-04-01,567,63,796,104,1530
"15796","Ventura County",1996-05-01,576,76,780,103,1535
"15797","Ventura County",1996-06-01,545,68,776,105,1494
"15798","Ventura County",1996-07-01,556,84,726,98,1464
"15799","Ventura County",1996-08-01,540,74,735,116,1465
"15800","Ventura County",1996-09-01,565,80,734,110,1489
"15801","Ventura County",1996-10-01,557,78,735,108,1478
"15802","Ventura County",1996-11-01,547,72,722,121,1462
"15803","Ventura County",1996-12-01,551,93,698,106,1448
"15804","Ventura County",1997-01-01,572,54,733,119,1478
"15805","Ventura County",1997-02-01,582,64,729,111,1486
"15806","Ventura County",1997-03-01,597,64,777,123,1561
"15807","Ventura County",1997-04-01,582,64,737,132,1515
"15808","Ventura County",1997-05-01,576,65,737,132,1510
"15809","Ventura County",1997-06-01,544,65,690,123,1422
"15810","Ventura County",1997-07-01,590,73,671,129,1463
"15811","Ventura County",1997-08-01,601,85,697,135,1518
"15812","Ventura County",1997-09-01,610,82,729,132,1553
"15813","Ventura County",1997-10-01,599,80,765,139,1583
"15814","Ventura County",1997-11-01,595,84,725,132,1536
"15815","Ventura County",1997-12-01,602,40,644,81,1367
"15816","Ventura County",1998-01-01,632,92,670,129,1523
"15817","Ventura County",1998-02-01,593,73,722,135,1523
"15818","Ventura County",1998-03-01,612,69,767,138,1586
"15819","Ventura County",1998-04-01,597,77,754,139,1567
"15820","Ventura County",1998-05-01,598,85,775,139,1597
"15821","Ventura County",1998-06-01,615,74,765,130,1584
"15822","Ventura County",1998-07-01,607,68,746,140,1561
"15823","Ventura County",1998-08-01,652,76,766,133,1627
"15824","Ventura County",1998-09-01,638,78,754,143,1613
"15825","Ventura County",1998-10-01,619,73,757,127,1576
"15826","Ventura County",1998-11-01,622,71,721,123,1537
"15827","Ventura County",1998-12-01,613,69,638,111,1431
"15828","Ventura County",1999-01-01,675,73,674,120,1542
"15829","Ventura County",1999-02-01,688,79,697,114,1578
"15830","Ventura County",1999-03-01,680,76,699,116,1571
"15831","Ventura County",1999-04-01,727,292,412,122,1553
"15832","Ventura County",1999-05-01,722,84,587,121,1514
"15833","Ventura County",1999-06-01,668,89,676,123,1556
"15834","Ventura County",1999-07-01,681,99,694,133,1607
"15835","Ventura County",1999-08-01,653,103,662,134,1552
"15836","Ventura County",1999-09-01,632,93,660,142,1527
"15837","Ventura County",1999-10-01,625,85,656,143,1509
"15838","Ventura County",1999-11-01,606,83,671,146,1506
"15839","Ventura County",1999-12-01,563,70,592,130,1355
"15840","Ventura County",2000-01-01,574,478,229,119,1400
"15841","Ventura County",2000-02-01,583,85,664,116,1448
"15842","Ventura County",2000-03-01,625,80,652,113,1470
"15843","Ventura County",2000-04-01,652,78,667,111,1508
"15844","Ventura County",2000-05-01,615,98,701,127,1541
"15845","Ventura County",2000-06-01,604,98,712,136,1550
"15846","Ventura County",2000-07-01,685,88,522,94,1389
"15847","Ventura County",2000-08-01,661,101,702,125,1589
"15848","Ventura County",2000-09-01,672,107,708,122,1609
"15849","Ventura County",2000-10-01,666,108,700,126,1600
"15850","Ventura County",2000-11-01,660,108,672,128,1568
"15851","Ventura County",2000-12-01,643,97,607,115,1462
"15852","Ventura County",2001-01-01,649,95,627,126,1497
"15853","Ventura County",2001-02-01,674,102,658,113,1547
"15854","Ventura County",2001-03-01,667,102,664,126,1559
"15855","Ventura County",2001-04-01,639,91,595,121,1446
"15856","Ventura County",2001-05-01,651,90,573,109,1423
"15857","Ventura County",2001-06-01,686,90,545,104,1425
"15858","Ventura County",2001-07-01,685,88,493,90,1356
"15859","Ventura County",2001-08-01,695,92,501,92,1380
"15860","Ventura County",2001-09-01,700,97,498,86,1381
"15861","Ventura County",2001-10-01,724,95,513,85,1417
"15862","Ventura County",2001-11-01,705,96,513,88,1402
"15863","Ventura County",2001-12-01,690,94,463,78,1325
"15864","Ventura County",2002-01-01,761,106,467,84,1418
"15865","Ventura County",2002-02-01,775,116,520,71,1482
"15866","Ventura County",2002-03-01,763,114,523,70,1470
"15867","Ventura County",2002-04-01,774,107,501,85,1467
"15868","Ventura County",2002-05-01,782,111,474,82,1449
"15869","Ventura County",2002-06-01,782,111,474,86,1453
"15870","Ventura County",2002-07-01,641,102,647,100,1490
"15871","Ventura County",2002-08-01,673,116,644,106,1539
"15872","Ventura County",2002-09-01,696,117,629,98,1540
"15873","Ventura County",2002-10-01,751,132,602,91,1576
"15874","Ventura County",2002-11-01,814,134,557,105,1610
"15875","Ventura County",2002-12-01,858,122,485,83,1548
"15876","Ventura County",2003-01-01,937,130,512,95,1674
"15877","Ventura County",2003-02-01,957,131,484,83,1655
"15878","Ventura County",2003-03-01,931,131,502,87,1651
"15879","Ventura County",2003-04-01,950,133,457,84,1624
"15880","Ventura County",2003-05-01,947,157,483,68,1655
"15881","Ventura County",2003-06-01,928,201,518,98,1745
"15882","Ventura County",2003-07-01,850,167,569,63,1649
"15883","Ventura County",2003-08-01,873,171,542,60,1646
"15884","Ventura County",2003-09-01,918,176,546,49,1689
"15885","Ventura County",2003-10-01,962,187,513,50,1712
"15886","Ventura County",2003-11-01,936,193,509,47,1685
"15887","Ventura County",2003-12-01,867,190,498,49,1604
"15888","Ventura County",2004-01-01,915,177,506,65,1663
"15889","Ventura County",2004-02-01,798,138,642,100,1678
"15890","Ventura County",2004-03-01,656,85,799,151,1691
"15891","Ventura County",2004-04-01,705,93,762,143,1703
"15892","Ventura County",2004-05-01,701,94,766,134,1695
"15893","Ventura County",2004-06-01,678,91,751,131,1651
"15894","Ventura County",2004-07-01,709,93,724,133,1659
"15895","Ventura County",2004-08-01,712,84,734,161,1691
"15896","Ventura County",2004-09-01,771,101,690,148,1710
"15897","Ventura County",2004-10-01,718,100,739,151,1708
"15898","Ventura County",2004-11-01,704,88,770,161,1723
"15899","Ventura County",2004-12-01,622,90,747,145,1604
"15900","Ventura County",2005-01-01,662,94,772,147,1675
"15901","Ventura County",2005-02-01,631,100,768,160,1659
"15902","Ventura County",2005-03-01,589,82,794,175,1640
"15903","Ventura County",2005-04-01,645,80,750,185,1660
"15904","Ventura County",2005-05-01,654,79,745,213,1691
"15905","Ventura County",2005-06-01,634,87,776,165,1662
"15906","Ventura County",2005-07-01,641,94,740,164,1639
"15907","Ventura County",2005-08-01,625,86,757,164,1632
"15908","Ventura County",2005-09-01,661,101,721,155,1638
"15909","Ventura County",2005-10-01,629,102,756,157,1644
"15910","Ventura County",2005-11-01,675,104,729,153,1661
"15911","Ventura County",2005-12-01,684,101,694,155,1634
"15912","Ventura County",2006-01-01,719,104,696,164,1683
"15913","Ventura County",2006-02-01,746,101,730,170,1747
"15914","Ventura County",2006-03-01,763,104,765,162,1794
"15915","Ventura County",2006-04-01,730,97,779,172,1778
"15916","Ventura County",2006-05-01,790,110,693,141,1734
"15917","Ventura County",2006-06-01,792,115,733,151,1791
"15918","Ventura County",2006-07-01,775,92,733,163,1763
"15919","Ventura County",2006-08-01,843,107,688,142,1780
"15920","Ventura County",2006-09-01,816,113,731,146,1806
"15921","Ventura County",2006-10-01,824,120,727,156,1827
"15922","Ventura County",2006-11-01,821,126,700,152,1799
"15923","Ventura County",2006-12-01,780,121,664,128,1693
"15924","Ventura County",2007-01-01,1092,184,418,91,1785
"15925","Ventura County",2007-02-01,1079,172,512,105,1868
"15926","Ventura County",2007-03-01,1054,164,546,114,1878
"15927","Ventura County",2007-04-01,1072,169,580,115,1936
"15928","Ventura County",2007-05-01,1061,160,587,119,1927
"15929","Ventura County",2007-06-01,1065,162,574,113,1914
"15930","Ventura County",2007-07-01,1011,156,608,116,1891
"15931","Ventura County",2007-08-01,1005,154,577,115,1851
"15932","Ventura County",2007-09-01,986,149,557,113,1805
"15933","Ventura County",2007-10-01,956,151,542,124,1773
"15934","Ventura County",2007-11-01,950,138,518,117,1723
"15935","Ventura County",2007-12-01,966,128,500,91,1685
"15936","Ventura County",2008-01-01,1000,135,499,91,1725
"15937","Ventura County",2008-02-01,992,156,502,97,1747
"15938","Ventura County",2008-03-01,1004,156,503,100,1763
"15939","Ventura County",2008-04-01,1023,164,511,105,1803
"15940","Ventura County",2008-05-01,1025,160,532,116,1833
"15941","Ventura County",2008-06-01,1018,164,517,100,1799
"15942","Ventura County",2008-07-01,1070,154,472,103,1799
"15943","Ventura County",2008-08-01,1027,144,488,110,1769
"15944","Ventura County",2008-09-01,1007,152,502,113,1774
"15945","Ventura County",2008-10-01,1002,153,507,106,1768
"15946","Ventura County",2008-11-01,1040,156,488,98,1782
"15947","Ventura County",2008-12-01,1022,161,477,105,1765
"15948","Ventura County",2009-01-01,1027,157,456,92,1732
"15949","Ventura County",2009-02-01,1009,161,496,109,1775
"15950","Ventura County",2009-03-01,951,159,540,139,1789
"15951","Ventura County",2009-04-01,986,152,520,152,1810
"15952","Ventura County",2009-05-01,991,140,477,117,1725
"15953","Ventura County",2009-06-01,952,136,478,134,1700
"15954","Ventura County",2009-07-01,908,121,527,142,1698
"15955","Ventura County",2009-08-01,959,132,511,118,1720
"15956","Ventura County",2009-09-01,965,135,489,123,1712
"15957","Ventura County",2009-10-01,909,126,524,131,1690
"15958","Ventura County",2009-11-01,895,115,512,123,1645
"15959","Ventura County",2009-12-01,866,116,433,112,1527
"15960","Ventura County",2010-01-01,906,119,420,105,1550
"15961","Ventura County",2010-02-01,863,129,388,90,1470
"15962","Ventura County",2010-03-01,885,121,371,97,1474
"15963","Ventura County",2010-04-01,861,119,416,97,1493
"15964","Ventura County",2010-05-01,885,116,407,95,1503
"15965","Ventura County",2010-06-01,868,118,447,98,1531
"15966","Ventura County",2010-07-01,878,118,484,89,1569
"15967","Ventura County",2010-08-01,866,125,474,99,1564
"15968","Ventura County",2010-09-01,889,135,431,92,1547
"15969","Ventura County",2010-10-01,913,134,414,79,1540
"15970","Ventura County",2010-11-01,935,142,394,81,1552
"15971","Ventura County",2010-12-01,891,129,382,86,1488
"15972","Ventura County",2011-01-01,903,126,368,95,1492
"15973","Ventura County",2011-02-01,937,146,341,93,1517
"15974","Ventura County",2011-03-01,914,136,342,92,1484
"15975","Ventura County",2011-04-01,904,126,360,87,1477
"15976","Ventura County",2011-05-01,881,128,394,86,1489
"15977","Ventura County",2011-06-01,880,121,398,85,1484
"15978","Ventura County",2011-07-01,858,128,376,86,1448
"15979","Ventura County",2011-08-01,843,120,346,84,1393
"15980","Ventura County",2011-09-01,880,131,353,82,1446
"15981","Ventura County",2011-10-01,868,132,388,87,1475
"15982","Ventura County",2011-11-01,854,123,428,94,1499
"15983","Ventura County",2011-12-01,794,106,422,86,1408
"15984","Ventura County",2012-01-01,821,108,402,82,1413
"15985","Ventura County",2012-02-01,845,112,439,90,1486
"15986","Ventura County",2012-03-01,825,112,478,92,1507
"15987","Ventura County",2012-04-01,859,125,439,97,1520
"15988","Ventura County",2012-05-01,859,124,521,108,1612
"15989","Ventura County",2012-06-01,831,110,551,127,1619
"15990","Ventura County",2012-07-01,939,111,524,125,1699
"15991","Ventura County",2012-08-01,918,116,551,126,1711
"15992","Ventura County",2012-09-01,923,111,526,118,1678
"15993","Ventura County",2012-10-01,914,98,532,127,1671
"15994","Ventura County",2012-11-01,906,101,520,123,1650
"15995","Ventura County",2012-12-01,857,112,503,107,1579
"15996","Ventura County",2013-01-01,881,115,506,113,1615
"15997","Ventura County",2013-02-01,885,125,522,109,1641
"15998","Ventura County",2013-03-01,869,120,547,113,1649
"15999","Ventura County",2013-04-01,845,129,558,119,1651
"16000","Ventura County",2013-05-01,846,127,573,131,1677
"16001","Ventura County",2013-06-01,885,124,559,140,1708
"16002","Ventura County",2013-07-01,873,138,601,144,1756
"16003","Ventura County",2013-08-01,850,139,623,145,1757
"16004","Ventura County",2013-09-01,833,132,623,158,1746
"16005","Ventura County",2013-10-01,837,133,599,164,1733
"16006","Ventura County",2013-11-01,848,117,582,161,1708
"16007","Ventura County",2013-12-01,821,113,569,141,1644
"16008","Ventura County",2014-01-01,871,121,584,144,1720
"16009","Ventura County",2014-02-01,854,126,612,132,1724
"16010","Ventura County",2014-03-01,855,122,628,124,1729
"16011","Ventura County",2014-04-01,864,117,620,143,1744
"16012","Ventura County",2014-05-01,906,122,588,127,1743
"16013","Ventura County",2014-06-01,887,126,603,128,1744
"16014","Ventura County",2014-07-01,904,133,595,131,1763
"16015","Ventura County",2014-08-01,887,128,602,140,1757
"16016","Ventura County",2014-09-01,892,143,597,140,1772
"16017","Ventura County",2014-10-01,932,146,580,144,1802
"16018","Ventura County",2014-11-01,848,119,631,151,1749
"16019","Ventura County",2014-12-01,798,97,588,117,1600
"16020","Ventura County",2015-01-01,813,103,545,102,1563
"16021","Ventura County",2015-02-01,847,115,590,96,1648
"16022","Ventura County",2015-03-01,818,123,619,93,1653
"16023","Ventura County",2015-04-01,828,121,595,100,1644
"16024","Ventura County",2015-05-01,839,112,581,107,1639
"16025","Ventura County",2015-06-01,853,121,590,108,1672
"16026","Ventura County",2015-07-01,868,117,587,115,1687
"16027","Ventura County",2015-08-01,880,126,568,103,1677
"16028","Ventura County",2015-09-01,890,129,557,103,1679
"16029","Ventura County",2015-10-01,916,136,516,104,1672
"16030","Ventura County",2015-11-01,906,130,532,110,1678
"16031","Ventura County",2015-12-01,881,128,533,98,1640
"16032","Ventura County",2016-01-01,878,129,517,105,1629
"16033","Ventura County",2016-02-01,905,118,517,109,1649
"16034","Ventura County",2016-03-01,884,104,548,106,1642
"16035","Ventura County",2016-04-01,885,112,550,101,1648
"16036","Ventura County",2016-05-01,875,113,556,105,1649
"16037","Ventura County",2016-06-01,875,120,553,97,1645
"16038","Ventura County",2016-07-01,841,124,579,108,1652
"16039","Ventura County",2016-08-01,839,131,586,97,1653
"16040","Ventura County",2016-09-01,862,133,559,105,1659
"16041","Ventura County",2016-10-01,866,128,557,116,1667
"16042","Ventura County",2016-11-01,865,126,518,108,1617
"16043","Ventura County",2016-12-01,860,125,491,101,1577
"16044","Ventura County",2017-01-01,856,134,508,101,1599
"16045","Ventura County",2017-02-01,846,137,518,91,1592
"16046","Ventura County",2017-03-01,834,123,514,92,1563
"16047","Ventura County",2017-04-01,837,134,530,96,1597
"16048","Ventura County",2017-05-01,801,132,559,103,1595
"16049","Ventura County",2017-06-01,811,127,536,108,1582
"16050","Ventura County",2017-07-01,834,136,509,100,1579
"16051","Ventura County",2017-08-01,837,133,511,101,1582
"16052","Ventura County",2017-09-01,854,142,505,95,1596
"16053","Ventura County",2017-10-01,832,140,515,94,1581
"16054","Ventura County",2017-11-01,813,133,536,104,1586
"16055","Ventura County",2017-12-01,782,131,502,85,1500
"16056","Ventura County",2018-01-01,807,132,487,94,1520
"16057","Ventura County",2018-02-01,785,126,513,95,1519
"16058","Ventura County",2018-03-01,722,119,535,97,1473
"16059","Ventura County",2018-04-01,732,117,541,100,1490
"16060","Ventura County",2018-05-01,730,106,500,99,1435
"16061","Ventura County",2018-06-01,735,115,486,89,1425
"16062","Ventura County",2018-07-01,760,125,486,99,1470
"16063","Ventura County",2018-08-01,784,125,529,111,1549
"16064","Ventura County",2018-09-01,800,141,542,94,1577
"16065","Ventura County",2018-10-01,0,0,0,0,0
"16066","Ventura County",2018-11-01,0,0,0,0,0
"16067","Ventura County",2018-12-01,0,0,0,0,0
"16068","Ventura County",2019-01-01,780,140,476,85,1481
"16069","Ventura County",2019-02-01,819,148,469,93,1529
"16070","Ventura County",2019-03-01,833,144,533,91,1601
"16071","Ventura County",2019-04-01,842,137,533,106,1618
"16072","Ventura County",2019-05-01,796,142,565,105,1608
"16073","Ventura County",2019-06-01,837,138,547,106,1628
"16074","Ventura County",2019-07-01,840,147,540,100,1627
"16075","Ventura County",2019-08-01,851,150,578,100,1679
"16076","Ventura County",2019-09-01,833,157,561,96,1647
"16077","Ventura County",2019-10-01,800,147,581,100,1628
"16078","Ventura County",2019-11-01,831,144,532,90,1597
"16079","Ventura County",2019-12-01,802,133,494,88,1517
"16080","Ventura County",2020-01-01,812,137,457,88,1494
"16081","Ventura County",2020-02-01,807,144,474,84,1509
"16082","Ventura County",2020-03-01,728,119,491,83,1421
"16083","Yolo County",1995-10-01,224.7,30.8,78.1,5.9,339.5
"16084","Yolo County",1995-11-01,284,29,74,4,391
"16085","Yolo County",1995-12-01,260,28,77,6,371
"16086","Yolo County",1996-01-01,259,28,85,6,378
"16087","Yolo County",1996-02-01,262.4,33.5,88.5,4.1,388.5
"16088","Yolo County",1996-03-01,254,55,91,9,409
"16089","Yolo County",1996-04-01,250,26,96,9,381
"16090","Yolo County",1996-05-01,254,55,91,9,409
"16091","Yolo County",1996-06-01,261,33,90,7,391
"16092","Yolo County",1996-07-01,204,41,119,28,392
"16093","Yolo County",1996-08-01,206,42,117,21,386
"16094","Yolo County",1996-09-01,195.7,32.6,108.7,6,343
"16095","Yolo County",1996-10-01,207,35,104,5,351
"16096","Yolo County",1996-11-01,207,39,98,6,350
"16097","Yolo County",1996-12-01,246,42,94,16,398
"16098","Yolo County",1997-01-01,73,163,100,21,357
"16099","Yolo County",1997-02-01,216,44,88,15,363
"16100","Yolo County",1997-03-01,197,39,100,21,357
"16101","Yolo County",1997-04-01,262,40,88,22,412
"16102","Yolo County",1997-05-01,273,40,78,20,411
"16103","Yolo County",1997-06-01,224,36,66,19,345
"16104","Yolo County",1997-07-01,222,46,69,14,351
"16105","Yolo County",1997-08-01,215,41,75,14,345
"16106","Yolo County",1997-09-01,215,47,80,13,355
"16107","Yolo County",1997-10-01,212,43,75,17,347
"16108","Yolo County",1997-11-01,225,44,72,16,357
"16109","Yolo County",1997-12-01,221,43,74,16,354
"16110","Yolo County",1998-01-01,236,44,68,16,364
"16111","Yolo County",1998-02-01,242,42,75,13,372
"16112","Yolo County",1998-03-01,248,44,77,13,382
"16113","Yolo County",1998-04-01,237,49,80,23,389
"16114","Yolo County",1998-05-01,250,50,76,24,400
"16115","Yolo County",1998-06-01,271,54,54,21,400
"16116","Yolo County",1998-07-01,273,60,50,13,396
"16117","Yolo County",1998-08-01,260,52,66,19,397
"16118","Yolo County",1998-09-01,257,49,67,19,392
"16119","Yolo County",1998-10-01,238,50,77,19,384
"16120","Yolo County",1998-11-01,246,38,78,20,382
"16121","Yolo County",1998-12-01,256,36,68,15,375
"16122","Yolo County",1999-01-01,254,54,69,15,392
"16123","Yolo County",1999-02-01,245,52,83,18,398
"16124","Yolo County",1999-03-01,228,55,102,19,404
"16125","Yolo County",1999-04-01,224,48,112,22,406
"16126","Yolo County",1999-05-01,214,53,116,23,406
"16127","Yolo County",1999-06-01,219,49,113,27,408
"16128","Yolo County",1999-07-01,229,52,104,22,407
"16129","Yolo County",1999-08-01,242,42,99,19,402
"16130","Yolo County",1999-09-01,223,37,111,17,388
"16131","Yolo County",1999-10-01,238,41,99,13,391
"16132","Yolo County",1999-11-01,223,33,99,18,373
"16133","Yolo County",1999-12-01,214,37,81,13,345
"16134","Yolo County",2000-01-01,222,36,76,12,346
"16135","Yolo County",2000-02-01,230,27,82,28,367
"16136","Yolo County",2000-03-01,235,33,88,41,397
"16137","Yolo County",2000-04-01,252,49,88,19,408
"16138","Yolo County",2000-05-01,233,47,80,14,374
"16139","Yolo County",2000-06-01,242,50,75,16,383
"16140","Yolo County",2000-07-01,238,46,81,13,378
"16141","Yolo County",2000-08-01,244,46,73,16,379
"16142","Yolo County",2000-09-01,248,38,74,18,378
"16143","Yolo County",2000-10-01,244,43,80,18,385
"16144","Yolo County",2000-11-01,232,36,74,18,360
"16145","Yolo County",2000-12-01,238,43,78,23,382
"16146","Yolo County",2001-01-01,254,42,65,15,376
"16147","Yolo County",2001-02-01,243,52,75,12,382
"16148","Yolo County",2001-03-01,240,48,84,13,385
"16149","Yolo County",2001-04-01,230,51,84,14,379
"16150","Yolo County",2001-05-01,239,57,67,20,383
"16151","Yolo County",2001-06-01,262,47,74,20,403
"16152","Yolo County",2001-07-01,248,44,76,16,384
"16153","Yolo County",2001-08-01,259,49,78,13,399
"16154","Yolo County",2001-09-01,264,93,78,14,449
"16155","Yolo County",2001-10-01,279,62,73,13,427
"16156","Yolo County",2001-11-01,265,40,73,17,395
"16157","Yolo County",2001-12-01,269,42,62,17,390
"16158","Yolo County",2002-01-01,276,48,65,13,402
"16159","Yolo County",2002-02-01,278,52,64,15,409
"16160","Yolo County",2002-03-01,278,52,64,15,409
"16161","Yolo County",2002-04-01,289,72,57,13,431
"16162","Yolo County",2002-05-01,300,54,57,17,428
"16163","Yolo County",2002-06-01,313,54,45,13,425
"16164","Yolo County",2002-07-01,318,50,40,12,420
"16165","Yolo County",2002-08-01,318,51,38,11,418
"16166","Yolo County",2002-09-01,321,52,42,16,431
"16167","Yolo County",2002-10-01,328,53,33,32,446
"16168","Yolo County",2002-11-01,316,59,36,12,423
"16169","Yolo County",2002-12-01,290,50,53,12,405
"16170","Yolo County",2003-01-01,304,54,49,8,415
"16171","Yolo County",2003-02-01,324,57,35,14,430
"16172","Yolo County",2003-03-01,323,53,37,17,430
"16173","Yolo County",2003-04-01,295,55,48,12,410
"16174","Yolo County",2003-05-01,299,59,51,11,420
"16175","Yolo County",2003-06-01,310,58,45,13,426
"16176","Yolo County",2003-07-01,319,47,36,13,415
"16177","Yolo County",2003-08-01,319,60,43,12,434
"16178","Yolo County",2003-09-01,320,60,36,12,428
"16179","Yolo County",2003-10-01,325,63,35,9,432
"16180","Yolo County",2003-11-01,336,63,23,9,431
"16181","Yolo County",2003-12-01,319,54,32,7,412
"16182","Yolo County",2004-01-01,315,53,37,11,416
"16183","Yolo County",2004-02-01,340,63,20,10,433
"16184","Yolo County",2004-03-01,333,65,24,8,430
"16185","Yolo County",2004-04-01,323,58,32,12,425
"16186","Yolo County",2004-05-01,307,50,47,14,418
"16187","Yolo County",2004-06-01,318,46,37,18,419
"16188","Yolo County",2004-07-01,313,51,38,17,419
"16189","Yolo County",2004-08-01,305,56,44,14,419
"16190","Yolo County",2004-09-01,297,57,46,15,415
"16191","Yolo County",2004-10-01,305,53,48,15,421
"16192","Yolo County",2004-11-01,297,49,49,10,405
"16193","Yolo County",2004-12-01,300,47,48,9,404
"16194","Yolo County",2005-01-01,323,44,34,11,412
"16195","Yolo County",2005-02-01,331,57,25,12,425
"16196","Yolo County",2005-03-01,323,60,32,15,430
"16197","Yolo County",2005-04-01,324,57,31,15,427
"16198","Yolo County",2005-05-01,324,52,36,15,427
"16199","Yolo County",2005-06-01,319,59,42,10,430
"16200","Yolo County",2005-07-01,317,63,40,10,430
"16201","Yolo County",2005-08-01,314,54,46,16,430
"16202","Yolo County",2005-09-01,305,60,49,12,426
"16203","Yolo County",2005-10-01,312,53,46,20,431
"16204","Yolo County",2005-11-01,313,52,45,19,429
"16205","Yolo County",2005-12-01,310,51,44,8,413
"16206","Yolo County",2006-01-01,305,40,51,11,407
"16207","Yolo County",2006-02-01,292,45,61,8,406
"16208","Yolo County",2006-03-01,289,46,70,8,413
"16209","Yolo County",2006-04-01,281,40,70,12,403
"16210","Yolo County",2006-05-01,276,44,65,16,401
"16211","Yolo County",2006-06-01,282,41,70,15,408
"16212","Yolo County",2006-07-01,283,51,73,16,423
"16213","Yolo County",2006-08-01,276,42,77,12,407
"16214","Yolo County",2006-09-01,285,43,66,13,407
"16215","Yolo County",2006-10-01,276,46,77,12,411
"16216","Yolo County",2006-11-01,282,48,73,9,412
"16217","Yolo County",2006-12-01,266,44,72,11,393
"16218","Yolo County",2007-01-01,305,40,51,11,407
"16219","Yolo County",2007-02-01,292,45,61,8,406
"16220","Yolo County",2007-03-01,295,48,66,12,421
"16221","Yolo County",2007-04-01,296,51,69,14,430
"16222","Yolo County",2007-05-01,286,51,70,14,421
"16223","Yolo County",2007-06-01,290,48,66,16,420
"16224","Yolo County",2007-07-01,303,50,58,17,428
"16225","Yolo County",2007-08-01,295,45,65,23,428
"16226","Yolo County",2007-09-01,300,49,64,17,430
"16227","Yolo County",2007-10-01,289,42,68,17,416
"16228","Yolo County",2007-11-01,294,40,63,16,413
"16229","Yolo County",2007-12-01,302,38,59,16,415
"16230","Yolo County",2008-01-01,298,46,66,13,423
"16231","Yolo County",2008-02-01,303,44,62,12,421
"16232","Yolo County",2008-03-01,309,46,55,11,421
"16233","Yolo County",2008-04-01,305,42,61,13,421
"16234","Yolo County",2008-05-01,296,42,70,17,425
"16235","Yolo County",2008-06-01,288,46,84,15,433
"16236","Yolo County",2008-07-01,292,47,75,13,427
"16237","Yolo County",2008-08-01,300,40,76,17,433
"16238","Yolo County",2008-09-01,295,40,80,14,429
"16239","Yolo County",2008-10-01,300,44,79,14,437
"16240","Yolo County",2008-11-01,290,40,78,16,424
"16241","Yolo County",2008-12-01,283,40,71,17,411
"16242","Yolo County",2009-01-01,265,41,76,19,401
"16243","Yolo County",2009-02-01,255,35,78,24,392
"16244","Yolo County",2009-03-01,255,37,75,21,388
"16245","Yolo County",2009-04-01,256,41,71,17,385
"16246","Yolo County",2009-05-01,256,36,72,16,380
"16247","Yolo County",2009-06-01,260,40,78,16,394
"16248","Yolo County",2009-07-01,281,37,92,21,431
"16249","Yolo County",2009-08-01,287,41,81,21,430
"16250","Yolo County",2009-09-01,293,39,71,19,422
"16251","Yolo County",2009-10-01,272,37,102,21,432
"16252","Yolo County",2009-11-01,283,35,70,20,408
"16253","Yolo County",2009-12-01,281,36,73,14,404
"16254","Yolo County",2010-01-01,283,44,71,10,408
"16255","Yolo County",2010-02-01,269,38,55,8,370
"16256","Yolo County",2010-03-01,292,43,55,11,401
"16257","Yolo County",2010-04-01,303,40,51,13,407
"16258","Yolo County",2010-05-01,290,42,47,11,390
"16259","Yolo County",2010-06-01,304,45,51,12,412
"16260","Yolo County",2010-07-01,309,42,66,14,431
"16261","Yolo County",2010-08-01,306,50,79,10,445
"16262","Yolo County",2010-09-01,308,51,70,10,439
"16263","Yolo County",2010-10-01,337,49,43,10,439
"16264","Yolo County",2010-11-01,326,49,32,7,414
"16265","Yolo County",2010-12-01,323,44,31,9,407
"16266","Yolo County",2011-01-01,255,46,101,11,413
"16267","Yolo County",2011-02-01,310,47,44,8,409
"16268","Yolo County",2011-03-01,310,48,45,8,411
"16269","Yolo County",2011-04-01,290,47,64,10,411
"16270","Yolo County",2011-05-01,265,35,55,17,372
"16271","Yolo County",2011-06-01,237,40,82,13,372
"16272","Yolo County",2011-07-01,256,35,55,16,362
"16273","Yolo County",2011-08-01,254,29,60,10,353
"16274","Yolo County",2011-09-01,270,28,58,7,363
"16275","Yolo County",2011-10-01,250,34,67,11,362
"16276","Yolo County",2011-11-01,257,36,83,19,395
"16277","Yolo County",2011-12-01,247,33,100,19,399
"16278","Yolo County",2012-01-01,236,17,125,33,411
"16279","Yolo County",2012-02-01,225,30,131,19,405
"16280","Yolo County",2012-03-01,233,33,143,21,430
"16281","Yolo County",2012-04-01,244,31,143,23,441
"16282","Yolo County",2012-05-01,250,22,143,23,438
"16283","Yolo County",2012-06-01,228,26,167,23,444
"16284","Yolo County",2012-07-01,214,24,174,27,439
"16285","Yolo County",2012-08-01,212,18,173,32,435
"16286","Yolo County",2012-09-01,203,24,174,28,429
"16287","Yolo County",2012-10-01,207,28,176,31,442
"16288","Yolo County",2012-11-01,223,32,160,26,441
"16289","Yolo County",2012-12-01,245,29,137,23,434
"16290","Yolo County",2013-01-01,248,34,139,26,447
"16291","Yolo County",2013-02-01,250,38,142,23,453
"16292","Yolo County",2013-03-01,234,28,158,30,450
"16293","Yolo County",2013-04-01,236,29,150,24,439
"16294","Yolo County",2013-05-01,236,30,150,22,438
"16295","Yolo County",2013-06-01,243,30,153,18,444
"16296","Yolo County",2013-07-01,263,32,135,16,446
"16297","Yolo County",2013-08-01,252,34,145,17,448
"16298","Yolo County",2013-09-01,264,37,139,16,456
"16299","Yolo County",2013-10-01,265,40,141,15,461
"16300","Yolo County",2013-11-01,260,35,145,17,457
"16301","Yolo County",2013-12-01,236,32,153,16,437
"16302","Yolo County",2014-01-01,240,39,164,14,457
"16303","Yolo County",2014-02-01,250,39,157,15,461
"16304","Yolo County",2014-03-01,256,37,163,15,471
"16305","Yolo County",2014-04-01,247,32,156,22,457
"16306","Yolo County",2014-05-01,239,38,153,23,453
"16307","Yolo County",2014-06-01,247,43,143,20,453
"16308","Yolo County",2014-07-01,256,46,138,20,460
"16309","Yolo County",2014-08-01,262,45,130,21,458
"16310","Yolo County",2014-09-01,270,44,117,22,453
"16311","Yolo County",2014-10-01,276,48,113,17,454
"16312","Yolo County",2014-11-01,252,46,108,17,423
"16313","Yolo County",2014-12-01,227,43,92,13,375
"16314","Yolo County",2015-01-01,210,49,84,13,356
"16315","Yolo County",2015-02-01,216,54,88,14,372
"16316","Yolo County",2015-03-01,228,56,97,17,398
"16317","Yolo County",2015-04-01,245,52,91,22,410
"16318","Yolo County",2015-05-01,230,44,105,18,397
"16319","Yolo County",2015-06-01,214,46,110,11,381
"16320","Yolo County",2015-07-01,214,38,108,15,375
"16321","Yolo County",2015-08-01,218,33,99,14,364
"16322","Yolo County",2015-09-01,231,33,93,15,372
"16323","Yolo County",2015-10-01,236,29,95,11,371
"16324","Yolo County",2015-11-01,234,34,98,16,382
"16325","Yolo County",2015-12-01,239,34,88,17,378
"16326","Yolo County",2016-01-01,237,43,99,14,393
"16327","Yolo County",2016-02-01,245,33,94,13,385
"16328","Yolo County",2016-03-01,241,31,91,15,378
"16329","Yolo County",2016-04-01,243,31,91,16,381
"16330","Yolo County",2016-05-01,235,28,90,13,366
"16331","Yolo County",2016-06-01,229,31,89,11,360
"16332","Yolo County",2016-07-01,242,34,84,13,373
"16333","Yolo County",2016-08-01,238,32,91,13,374
"16334","Yolo County",2016-09-01,254,32,102,12,400
"16335","Yolo County",2016-10-01,250,35,91,11,387
"16336","Yolo County",2016-11-01,248,44,80,13,385
"16337","Yolo County",2016-12-01,230,44,95,16,385
"16338","Yolo County",2017-01-01,234,39,98,14,385
"16339","Yolo County",2017-02-01,235,39,101,11,386
"16340","Yolo County",2017-03-01,252,38,103,12,405
"16341","Yolo County",2017-04-01,249,37,106,9,401
"16342","Yolo County",2017-05-01,255,35,95,10,395
"16343","Yolo County",2017-06-01,258,35,92,11,396
"16344","Yolo County",2017-07-01,257,31,92,9,389
"16345","Yolo County",2017-08-01,241,27,103,9,380
"16346","Yolo County",2017-09-01,230,28,105,11,374
"16347","Yolo County",2017-10-01,237,32,102,11,382
"16348","Yolo County",2017-11-01,237,31,95,7,370
"16349","Yolo County",2017-12-01,237,27,96,10,370
"16350","Yolo County",2018-01-01,245,34,85,10,374
"16351","Yolo County",2018-02-01,237,38,92,15,382
"16352","Yolo County",2018-03-01,230,37,99,27,393
"16353","Yolo County",2018-04-01,204,31,98,14,347
"16354","Yolo County",2018-05-01,183,27,93,12,315
"16355","Yolo County",2018-06-01,183,27,94,13,317
"16356","Yolo County",2018-07-01,192,33,88,13,326
"16357","Yolo County",2018-08-01,207,32,82,13,334
"16358","Yolo County",2018-09-01,198,26,97,11,332
"16359","Yolo County",2018-10-01,204,37,88,12,341
"16360","Yolo County",2018-11-01,202,37,89,17,345
"16361","Yolo County",2018-12-01,206,30,87,14,337
"16362","Yolo County",2019-01-01,195,21,88,14,318
"16363","Yolo County",2019-02-01,194,24,80,13,311
"16364","Yolo County",2019-03-01,204,26,82,12,324
"16365","Yolo County",2019-04-01,205,28,84,8,325
"16366","Yolo County",2019-05-01,194,34,81,8,317
"16367","Yolo County",2019-06-01,190,37,80,7,314
"16368","Yolo County",2019-07-01,191,38,83,14,326
"16369","Yolo County",2019-08-01,190,41,86,15,332
"16370","Yolo County",2019-09-01,197,47,84,15,343
"16371","Yolo County",2019-10-01,209,41,93,11,354
"16372","Yolo County",2019-11-01,210,35,80,9,334
"16373","Yolo County",2019-12-01,202,30,67,10,309
"16374","Yolo County",2020-01-01,201,29,73,10,313
"16375","Yolo County",2020-02-01,200,31,76,8,315
"16376","Yolo County",2020-03-01,176,22,56,6,260
"16377","Yuba County",1995-10-01,108,13,107,23,251
"16378","Yuba County",1995-11-01,82,8,108,35,233
"16379","Yuba County",1995-12-01,66,7,123,31,227
"16380","Yuba County",1996-01-01,131,19,79,23,252
"16381","Yuba County",1996-02-01,171,21,74,19,285
"16382","Yuba County",1996-03-01,185,28,87,19,319
"16383","Yuba County",1996-04-01,128,23,105,15,271
"16384","Yuba County",1996-05-01,121,37,103,14,275
"16385","Yuba County",1996-06-01,165,15,73,5,258
"16386","Yuba County",1996-07-01,160,23,74,3,260
"16387","Yuba County",1996-08-01,203,15,80,5,303
"16388","Yuba County",1996-09-01,220,16,50,24,310
"16389","Yuba County",1996-10-01,222,20,60,18,320
"16390","Yuba County",1996-11-01,213,25,68,11,317
"16391","Yuba County",1996-12-01,189,19,68,11,287
"16392","Yuba County",1997-01-01,150,10,49,4,213
"16393","Yuba County",1997-02-01,199,28,52,12,291
"16394","Yuba County",1997-03-01,210,23,69,8,310
"16395","Yuba County",1997-04-01,208,21,72,7,308
"16396","Yuba County",1997-05-01,245,24,117,12,398
"16397","Yuba County",1997-06-01,202,22,157,17,398
"16398","Yuba County",1997-07-01,198,22,163,18,401
"16399","Yuba County",1997-08-01,195,27,164,22,408
"16400","Yuba County",1997-09-01,181,25,166,23,395
"16401","Yuba County",1997-10-01,187,26,152,21,386
"16402","Yuba County",1997-11-01,188,23,154,19,384
"16403","Yuba County",1997-12-01,217,23,67,9,316
"16404","Yuba County",1998-01-01,224,30,70,12,336
"16405","Yuba County",1998-02-01,229,23,72,9,333
"16406","Yuba County",1998-03-01,230,28,61,12,331
"16407","Yuba County",1998-04-01,230,31,62,10,333
"16408","Yuba County",1998-05-01,233,32,77,10,352
"16409","Yuba County",1998-06-01,224,30,69,9,332
"16410","Yuba County",1998-07-01,203,33,72,12,320
"16411","Yuba County",1998-08-01,191,31,65,11,298
"16412","Yuba County",1998-09-01,168,25,57,9,259
"16413","Yuba County",1998-10-01,158,21,62,8,249
"16414","Yuba County",1998-11-01,160,17,52,7,236
"16415","Yuba County",1998-12-01,148,18,48,6,220
"16416","Yuba County",1999-01-01,190,20,46,5,261
"16417","Yuba County",1999-02-01,241,33,37,6,317
"16418","Yuba County",1999-03-01,245,21,33,3,302
"16419","Yuba County",1999-04-01,243,17,46,6,312
"16420","Yuba County",1999-05-01,246,17,58,6,327
"16421","Yuba County",1999-06-01,251,10,58,3,322
"16422","Yuba County",1999-07-01,250,17,48,4,319
"16423","Yuba County",1999-08-01,242,18,47,5,312
"16424","Yuba County",1999-09-01,243,17,40,3,303
"16425","Yuba County",1999-10-01,259,13,31,2,305
"16426","Yuba County",1999-11-01,271,16,23,2,312
"16427","Yuba County",1999-12-01,252,18,14,3,287
"16428","Yuba County",2000-01-01,224,16,13,5,258
"16429","Yuba County",2000-02-01,211,18,49,5,283
"16430","Yuba County",2000-03-01,239,25,42,6,312
"16431","Yuba County",2000-04-01,258,26,42,6,332
"16432","Yuba County",2000-05-01,220,27,53,6,306
"16433","Yuba County",2000-06-01,267,23,48,6,344
"16434","Yuba County",2000-07-01,316,28,45,9,398
"16435","Yuba County",2000-08-01,286,32,47,8,373
"16436","Yuba County",2000-09-01,297,26,44,11,378
"16437","Yuba County",2000-10-01,282,47,44,7,380
"16438","Yuba County",2000-11-01,288,51,42,7,388
"16439","Yuba County",2000-12-01,276,49,38,7,370
"16440","Yuba County",2001-01-01,280,47,43,6,376
"16441","Yuba County",2001-02-01,282,62,45,9,398
"16442","Yuba County",2001-03-01,295,69,45,10,419
"16443","Yuba County",2001-04-01,287,72,45,10,414
"16444","Yuba County",2001-05-01,294,73,39,9,415
"16445","Yuba County",2001-06-01,282,67,38,9,396
"16446","Yuba County",2001-07-01,287,81,36,10,414
"16447","Yuba County",2001-08-01,276,82,39,11,408
"16448","Yuba County",2001-09-01,263,78,30,8,379
"16449","Yuba County",2001-10-01,275,65,20,18,378
"16450","Yuba County",2001-11-01,254,71,32,9,366
"16451","Yuba County",2001-12-01,257,68,32,4,361
"16452","Yuba County",2002-01-01,286,62,40,8,396
"16453","Yuba County",2002-02-01,286,57,50,11,404
"16454","Yuba County",2002-03-01,290,50,50,14,404
"16455","Yuba County",2002-04-01,303,51,49,11,414
"16456","Yuba County",2002-05-01,312,47,56,8,423
"16457","Yuba County",2002-06-01,322,56,54,7,439
"16458","Yuba County",2002-07-01,308,57,55,6,426
"16459","Yuba County",2002-08-01,323,59,44,4,430
"16460","Yuba County",2002-09-01,323,62,40,7,432
"16461","Yuba County",2002-10-01,321,61,39,8,429
"16462","Yuba County",2002-11-01,238,73,99,19,429
"16463","Yuba County",2002-12-01,310,72,29,12,423
"16464","Yuba County",2003-01-01,307,78,45,8,438
"16465","Yuba County",2003-02-01,299,75,43,9,426
"16466","Yuba County",2003-03-01,292,79,46,8,425
"16467","Yuba County",2003-04-01,295,70,38,18,421
"16468","Yuba County",2003-05-01,285,72,42,17,416
"16469","Yuba County",2003-06-01,303,54,29,33,419
"16470","Yuba County",2003-07-01,264,68,56,26,414
"16471","Yuba County",2003-08-01,268,81,41,14,404
"16472","Yuba County",2003-09-01,266,74,43,15,398
"16473","Yuba County",2003-10-01,285,77,43,19,424
"16474","Yuba County",2003-11-01,265,91,58,8,422
"16475","Yuba County",2003-12-01,279,82,40,11,412
"16476","Yuba County",2004-01-01,266,87,64,11,428
"16477","Yuba County",2004-02-01,283,81,43,13,420
"16478","Yuba County",2004-03-01,275,82,58,11,426
"16479","Yuba County",2004-04-01,286,80,47,13,426
"16480","Yuba County",2004-05-01,268,83,50,8,409
"16481","Yuba County",2004-06-01,292,65,31,9,397
"16482","Yuba County",2004-07-01,262,77,47,12,398
"16483","Yuba County",2004-08-01,270,81,41,7,399
"16484","Yuba County",2004-09-01,285,76,33,8,402
"16485","Yuba County",2004-10-01,276,74,37,12,399
"16486","Yuba County",2004-11-01,272,75,43,11,401
"16487","Yuba County",2004-12-01,290,83,16,4,393
"16488","Yuba County",2005-01-01,308,75,11,11,405
"16489","Yuba County",2005-02-01,307,75,19,9,410
"16490","Yuba County",2005-03-01,300,72,27,11,410
"16491","Yuba County",2005-04-01,314,74,22,12,422
"16492","Yuba County",2005-05-01,287,67,53,10,417
"16493","Yuba County",2005-06-01,281,68,41,13,403
"16494","Yuba County",2005-07-01,279,71,54,11,415
"16495","Yuba County",2005-08-01,273,74,58,10,415
"16496","Yuba County",2005-09-01,277,61,51,11,400
"16497","Yuba County",2005-10-01,279,69,57,9,414
"16498","Yuba County",2005-11-01,273,64,50,12,399
"16499","Yuba County",2005-12-01,258,69,53,11,391
"16500","Yuba County",2006-01-01,260,62,63,9,394
"16501","Yuba County",2006-02-01,278,57,60,15,410
"16502","Yuba County",2006-03-01,278,69,57,18,422
"16503","Yuba County",2006-04-01,276,61,62,15,414
"16504","Yuba County",2006-05-01,274,58,65,12,409
"16505","Yuba County",2006-06-01,271,59,72,9,411
"16506","Yuba County",2006-07-01,287,58,64,14,423
"16507","Yuba County",2006-08-01,281,57,76,16,430
"16508","Yuba County",2006-09-01,286,59,65,13,423
"16509","Yuba County",2006-10-01,276,57,69,20,422
"16510","Yuba County",2006-11-01,296,50,57,22,425
"16511","Yuba County",2006-12-01,283,55,55,18,411
"16512","Yuba County",2007-01-01,273,56,60,13,402
"16513","Yuba County",2007-02-01,287,51,54,22,414
"16514","Yuba County",2007-03-01,285,55,62,17,419
"16515","Yuba County",2007-04-01,285,60,64,14,423
"16516","Yuba County",2007-05-01,279,59,67,20,425
"16517","Yuba County",2007-06-01,300,52,54,20,426
"16518","Yuba County",2007-07-01,294,57,61,18,430
"16519","Yuba County",2007-08-01,282,58,65,18,423
"16520","Yuba County",2007-09-01,273,53,67,18,411
"16521","Yuba County",2007-10-01,269,59,69,19,416
"16522","Yuba County",2007-11-01,271,41,62,22,396
"16523","Yuba County",2007-12-01,290,46,45,28,409
"16524","Yuba County",2008-01-01,295,53,69,18,435
"16525","Yuba County",2008-02-01,297,49,66,18,430
"16526","Yuba County",2008-03-01,301,53,69,18,441
"16527","Yuba County",2008-04-01,295,56,56,12,419
"16528","Yuba County",2008-05-01,293,49,52,10,404
"16529","Yuba County",2008-06-01,296,51,50,10,407
"16530","Yuba County",2008-07-01,293,54,46,13,406
"16531","Yuba County",2008-08-01,299,55,51,17,422
"16532","Yuba County",2008-09-01,309,61,56,13,439
"16533","Yuba County",2008-10-01,292,60,63,5,420
"16534","Yuba County",2008-11-01,293,51,59,5,408
"16535","Yuba County",2008-12-01,317,47,39,8,411
"16536","Yuba County",2009-01-01,306,42,47,10,405
"16537","Yuba County",2009-02-01,301,40,50,10,401
"16538","Yuba County",2009-03-01,308,40,39,15,402
"16539","Yuba County",2009-04-01,298,44,44,15,401
"16540","Yuba County",2009-05-01,286,52,43,11,392
"16541","Yuba County",2009-06-01,293,49,49,12,403
"16542","Yuba County",2009-07-01,319,51,51,9,430
"16543","Yuba County",2009-08-01,310,62,49,13,434
"16544","Yuba County",2009-09-01,325,55,53,5,438
"16545","Yuba County",2009-10-01,318,48,61,7,434
"16546","Yuba County",2009-11-01,300,64,62,5,431
"16547","Yuba County",2009-12-01,307,58,46,6,417
"16548","Yuba County",2010-01-01,325,54,49,6,434
"16549","Yuba County",2010-02-01,311,48,42,6,407
"16550","Yuba County",2010-03-01,326,59,33,5,423
"16551","Yuba County",2010-04-01,340,52,36,6,434
"16552","Yuba County",2010-05-01,324,52,36,6,418
"16553","Yuba County",2010-06-01,359,34,28,9,430
"16554","Yuba County",2010-07-01,325,57,34,9,425
"16555","Yuba County",2010-08-01,321,56,30,10,417
"16556","Yuba County",2010-09-01,334,50,39,8,431
"16557","Yuba County",2010-10-01,349,28,47,8,432
"16558","Yuba County",2010-11-01,340,36,32,9,417
"16559","Yuba County",2010-12-01,321,41,31,9,402
"16560","Yuba County",2011-01-01,329,40,40,9,418
"16561","Yuba County",2011-02-01,320,47,37,8,412
"16562","Yuba County",2011-03-01,301,46,39,8,394
"16563","Yuba County",2011-04-01,281,46,36,14,377
"16564","Yuba County",2011-05-01,287,55,46,2,390
"16565","Yuba County",2011-06-01,277,45,40,7,369
"16566","Yuba County",2011-07-01,309,32,35,9,385
"16567","Yuba County",2011-08-01,299,43,36,8,386
"16568","Yuba County",2011-09-01,292,41,30,8,371
"16569","Yuba County",2011-10-01,295,24,33,8,360
"16570","Yuba County",2011-11-01,308,46,52,11,417
"16571","Yuba County",2011-12-01,303,41,56,14,414
"16572","Yuba County",2012-01-01,275,57,73,9,414
"16573","Yuba County",2012-02-01,285,53,73,6,417
"16574","Yuba County",2012-03-01,273,53,86,6,418
"16575","Yuba County",2012-04-01,255,57,86,10,408
"16576","Yuba County",2012-05-01,303,37,69,13,422
"16577","Yuba County",2012-06-01,293,39,77,10,419
"16578","Yuba County",2012-07-01,288,34,71,10,403
"16579","Yuba County",2012-08-01,298,36,72,10,416
"16580","Yuba County",2012-09-01,309,34,66,15,424
"16581","Yuba County",2012-10-01,310,32,49,17,408
"16582","Yuba County",2012-11-01,293,36,58,13,400
"16583","Yuba County",2012-12-01,285,38,77,9,409
"16584","Yuba County",2013-01-01,305,30,55,10,400
"16585","Yuba County",2013-02-01,297,29,81,14,421
"16586","Yuba County",2013-03-01,296,36,84,10,426
"16587","Yuba County",2013-04-01,296,31,73,18,418
"16588","Yuba County",2013-05-01,286,36,81,13,416
"16589","Yuba County",2013-06-01,290,35,75,15,415
"16590","Yuba County",2013-07-01,297,37,50,20,404
"16591","Yuba County",2013-08-01,307,43,51,16,417
"16592","Yuba County",2013-09-01,308,44,52,10,414
"16593","Yuba County",2013-10-01,336,37,28,15,416
"16594","Yuba County",2013-11-01,313,37,39,11,400
"16595","Yuba County",2013-12-01,286,36,52,13,387
"16596","Yuba County",2014-01-01,303,42,45,11,401
"16597","Yuba County",2014-02-01,285,44,70,11,410
"16598","Yuba County",2014-03-01,299,34,56,10,399
"16599","Yuba County",2014-04-01,290,41,62,7,400
"16600","Yuba County",2014-05-01,312,38,47,16,413
"16601","Yuba County",2014-06-01,302,37,51,15,405
"16602","Yuba County",2014-07-01,298,38,61,17,414
"16603","Yuba County",2014-08-01,301,37,54,16,408
"16604","Yuba County",2014-09-01,318,37,41,17,413
"16605","Yuba County",2014-10-01,288,38,64,13,403
"16606","Yuba County",2014-11-01,270,33,72,12,387
"16607","Yuba County",2014-12-01,274,32,49,11,366
"16608","Yuba County",2015-01-01,276,30,47,10,363
"16609","Yuba County",2015-02-01,306,33,42,11,392
"16610","Yuba County",2015-03-01,292,40,52,11,395
"16611","Yuba County",2015-04-01,266,40,62,11,379
"16612","Yuba County",2015-05-01,282,41,61,10,394
"16613","Yuba County",2015-06-01,287,41,56,11,395
"16614","Yuba County",2015-07-01,300,36,55,13,404
"16615","Yuba County",2015-08-01,307,30,48,19,404
"16616","Yuba County",2015-09-01,299,29,58,20,406
"16617","Yuba County",2015-10-01,300,34,59,17,410
"16618","Yuba County",2015-11-01,298,31,61,16,406
"16619","Yuba County",2015-12-01,299,28,52,12,391
"16620","Yuba County",2016-01-01,299,24,50,18,391
"16621","Yuba County",2016-02-01,312,22,45,20,399
"16622","Yuba County",2016-03-01,286,27,64,18,395
"16623","Yuba County",2016-04-01,289,31,55,18,393
"16624","Yuba County",2016-05-01,285,27,52,19,383
"16625","Yuba County",2016-06-01,287,34,50,12,383
"16626","Yuba County",2016-07-01,294,31,50,12,387
"16627","Yuba County",2016-08-01,300,28,42,11,381
"16628","Yuba County",2016-09-01,310,24,38,12,384
"16629","Yuba County",2016-10-01,292,30,46,11,379
"16630","Yuba County",2016-11-01,274,27,56,6,363
"16631","Yuba County",2016-12-01,290,26,40,7,363
"16632","Yuba County",2017-01-01,295,29,35,7,366
"16633","Yuba County",2017-02-01,205,24,32,4,265
"16634","Yuba County",2017-03-01,261,29,44,5,339
"16635","Yuba County",2017-04-01,278,28,56,13,375
"16636","Yuba County",2017-05-01,284,28,50,13,375
"16637","Yuba County",2017-06-01,299,33,37,12,381
"16638","Yuba County",2017-07-01,297,37,41,9,384
"16639","Yuba County",2017-08-01,274,32,39,8,353
"16640","Yuba County",2017-09-01,282,27,33,9,351
"16641","Yuba County",2017-10-01,311,26,20,12,369
"16642","Yuba County",2017-11-01,307,26,29,11,373
"16643","Yuba County",2017-12-01,292,30,34,10,366
"16644","Yuba County",2018-01-01,282,34,53,12,381
"16645","Yuba County",2018-02-01,172,26,86,27,311
"16646","Yuba County",2018-03-01,175,33,92,25,325
"16647","Yuba County",2018-04-01,256,30,48,7,341
"16648","Yuba County",2018-05-01,265,27,43,10,345
"16649","Yuba County",2018-06-01,268,31,47,9,355
"16650","Yuba County",2018-07-01,268,29,46,11,354
"16651","Yuba County",2018-08-01,266,36,58,7,367
"16652","Yuba County",2018-09-01,246,32,59,5,342
"16653","Yuba County",2018-10-01,259,31,49,8,347
"16654","Yuba County",2018-11-01,256,36,45,3,340
"16655","Yuba County",2018-12-01,261,28,44,6,339
"16656","Yuba County",2019-01-01,269,26,38,13,346
"16657","Yuba County",2019-02-01,288,31,46,9,374
"16658","Yuba County",2019-03-01,271,34,52,5,362
"16659","Yuba County",2019-04-01,302,33,49,7,391
"16660","Yuba County",2019-05-01,286,37,48,6,377
"16661","Yuba County",2019-06-01,284,29,44,14,371
"16662","Yuba County",2019-07-01,285,37,49,7,378
"16663","Yuba County",2019-08-01,282,32,49,6,369
"16664","Yuba County",2019-09-01,297,29,39,11,376
"16665","Yuba County",2019-10-01,285,28,49,4,366
"16666","Yuba County",2019-11-01,288,14,42,9,353
"16667","Yuba County",2019-12-01,291,24,48,9,372
"16668","Yuba County",2020-01-01,281,33,51,10,375
"16669","Yuba County",2020-02-01,279,36,56,7,378
"16670","Yuba County",2020-03-01,267,32,59,5,363
"16671","State Wide",1995-10-01,38026.86,4573.75,25230.14,3942.23,71772.98
"16672","State Wide",1995-11-01,37821.97,4528.06,25402.43,3793,71545.46
"16673","State Wide",1995-12-01,37288.53,4318.58,24267.51,3639.37,69513.99
"16674","State Wide",1996-01-01,37931.1,4473.32,24164.15,3589.57,70158.14
"16675","State Wide",1996-02-01,38446.74,4638.96,24466.14,3535.87,71087.71
"16676","State Wide",1996-03-01,38445.63,4519.34,25312.54,3751.85,72029.36
"16677","State Wide",1996-04-01,38035.13,4663.91,25114.79,3731.23,71545.06
"16678","State Wide",1996-05-01,38089.57,4712.19,24953.85,3722.52,71478.13
"16679","State Wide",1996-06-01,37908.84,4759.17,25345.13,3662.7,71675.84
"16680","State Wide",1996-07-01,37101.39,4707.31,26566.02,3981.82,72356.54
"16681","State Wide",1996-08-01,37293.33,4644.99,26230.25,3766.27,71934.84
"16682","State Wide",1996-09-01,37679.8,4909.46,26834.5,3650.3,73074.06
"16683","State Wide",1996-10-01,37725.12,4797.75,26723.84,4239.76,73486.47
"16684","State Wide",1996-11-01,37946.85,4793.84,26108.86,4145.08,72994.63
"16685","State Wide",1996-12-01,37672.24,4630.56,25941.41,4005.96,72250.17
"16686","State Wide",1997-01-01,38889.76,4769.61,26607.35,3858.78,74125.5
"16687","State Wide",1997-02-01,39266.68,4913.25,27390.37,4003.78,75574.08
"16688","State Wide",1997-03-01,39806,5118.96,28139.89,4259,77323.85
"16689","State Wide",1997-04-01,38928.88,6094.67,26958.7,4122.52,76104.77
"16690","State Wide",1997-05-01,38490.98,5018.76,28685.23,4494.91,76689.88
"16691","State Wide",1997-06-01,38461.41,5241.28,29441.16,4354.03,77465.88
"16692","State Wide",1997-07-01,38912.47,5189.17,28885.31,4508.41,77495.36
"16693","State Wide",1997-08-01,38993.16,5853.38,27133.25,5045.51,77025.3
"16694","State Wide",1997-09-01,39918.42,6176.29,27267.9,4644.29,78006.9
"16695","State Wide",1997-10-01,39716.54,5173.72,28765.59,4677.32,78333.17
"16696","State Wide",1997-11-01,39668.56,5943.71,27689.33,4787.15,78088.75
"16697","State Wide",1997-12-01,39370.72,5229.18,27734.9,4613.56,76948.36
"16698","State Wide",1998-01-01,38448.44,5838.54,29227.67,4836.5,78351.15
"16699","State Wide",1998-02-01,39850.94,6452.96,28430.28,4939.34,79673.52
"16700","State Wide",1998-03-01,39934.51,5422.8,30333.33,5150.67,80841.31
"16701","State Wide",1998-04-01,39748.01,5374.29,29992.33,5263.93,80378.56
"16702","State Wide",1998-05-01,39759,5364.05,29759.44,5476.28,80358.77
"16703","State Wide",1998-06-01,39986.85,6507.46,28633.64,5307.62,80435.57
"16704","State Wide",1998-07-01,40515.88,5406.61,28890.28,5016.7,79829.47
"16705","State Wide",1998-08-01,40787.71,5330.09,28869.2,4963.16,79950.16
"16706","State Wide",1998-09-01,40869.74,5300.94,27989.11,4960.77,79120.56
"16707","State Wide",1998-10-01,39639.48,5128.12,28790.06,5004.18,78561.84
"16708","State Wide",1998-11-01,39298.15,4990.98,27945.42,4958.62,77193.17
"16709","State Wide",1998-12-01,38451.72,5348.81,26624.17,4672,75096.7
"16710","State Wide",1999-01-01,38819.74,5027.1,27219.85,4657.66,75724.35
"16711","State Wide",1999-02-01,39240.78,5108.4,27604.8,4829.02,76783
"16712","State Wide",1999-03-01,38952.3,5140.51,28155.34,4967.5,77215.65
"16713","State Wide",1999-04-01,38635.45,5396.86,27478.85,4852.24,76363.4
"16714","State Wide",1999-05-01,38680.07,5162.14,27450.89,4964.74,76257.84
"16715","State Wide",1999-06-01,39311.49,5157.18,26756.19,4748.38,75973.24
"16716","State Wide",1999-07-01,39543.79,5188,27073.34,4746.92,76552.05
"16717","State Wide",1999-08-01,39489.2,5394.97,27202.33,4734.71,76821.21
"16718","State Wide",1999-09-01,40187.28,5358.26,27192.21,4709.31,77447.06
"16719","State Wide",1999-10-01,40416.2,5515.65,27270.94,4583.88,77786.67
"16720","State Wide",1999-11-01,39250.8,5333.59,26799.04,4503.3,75886.73
"16721","State Wide",1999-12-01,38663.53,5144.17,24915.64,4259.29,72982.63
"16722","State Wide",2000-01-01,39490.36,5618.72,24749.82,4278.06,74073.96
"16723","State Wide",2000-02-01,40828.15,5396.95,24858.14,4335.2,75418.44
"16724","State Wide",2000-03-01,40143.43,5376.3,25816.58,4402.53,75738.84
"16725","State Wide",2000-04-01,39653.64,5394.71,26275.24,4476.76,75800.35
"16726","State Wide",2000-05-01,39089.93,5598.53,25944.89,4497.19,75130.54
"16727","State Wide",2000-06-01,39073.03,5588.17,25976.82,4380,75018.02
"16728","State Wide",2000-07-01,39174.2,5514.06,25661,4408.49,74757.75
"16729","State Wide",2000-08-01,39133.96,5356.39,25967.95,4402.09,74860.39
"16730","State Wide",2000-09-01,39843.41,5334.37,25827.92,4457.77,75463.47
"16731","State Wide",2000-10-01,39885.6,5445.75,26431.86,4475,76238.21
"16732","State Wide",2000-11-01,39400.18,5257.96,26118.57,4471.25,75247.96
"16733","State Wide",2000-12-01,38639.27,5118.35,24770.9,4319.63,72848.15
"16734","State Wide",2001-01-01,39377,4989,24741,4181,73291
"16735","State Wide",2001-02-01,39971,5200,24742,4355,74266
"16736","State Wide",2001-03-01,39759,5278,25715,4359,75111
"16737","State Wide",2001-04-01,39776,5247,25395,4264,74681
"16738","State Wide",2001-05-01,39779,5307,25209,4250,74544
"16739","State Wide",2001-06-01,39824,5206,25285,4152,74469
"16740","State Wide",2001-07-01,40001,5262,24422,4000,73684
"16741","State Wide",2001-08-01,39861,5521,24419,3851,73653
"16742","State Wide",2001-09-01,40678,5431,24273,3818,74200
"16743","State Wide",2001-10-01,40440,5283,24132,4001,73856
"16744","State Wide",2001-11-01,40158,5301,24059,3604,73122
"16745","State Wide",2001-12-01,39381,5239,23033,3436,71089
"16746","State Wide",2002-01-01,40594,5423,22988,3567,72572
"16747","State Wide",2002-02-01,40937,5463,23746,3733,73879
"16748","State Wide",2002-03-01,41124,5558,24669,3879,75230
"16749","State Wide",2002-04-01,41649,5637,24203,3889,75378
"16750","State Wide",2002-05-01,41478,5540,24758,3880,75656
"16751","State Wide",2002-06-01,41311,5473,24917,3800,75501
"16752","State Wide",2002-07-01,41783,5515,24311,3824,75433
"16753","State Wide",2002-08-01,41726,5564,24108,3833,75231
"16754","State Wide",2002-09-01,42148,5637,24074,3860,75719
"16755","State Wide",2002-10-01,41939,5661,24684,3930,76214
"16756","State Wide",2002-11-01,41521,5675,24593,4026,75815
"16757","State Wide",2002-12-01,41569,5678,23556,3667,74470
"16758","State Wide",2003-01-01,42472,5774,23844,3818,75908
"16759","State Wide",2003-02-01,43032,5927,23368,3799,76126
"16760","State Wide",2003-03-01,42466,5772,22542,3668,74448
"16761","State Wide",2003-04-01,42992,5684,22886,3766,75328
"16762","State Wide",2003-05-01,43195,5942,22279,3583,74999
"16763","State Wide",2003-06-01,43678,6151,21875,3519,75223
"16764","State Wide",2003-07-01,43298,6026,22050,3512,74886
"16765","State Wide",2003-08-01,43434,5976,22150,3573,75133
"16766","State Wide",2003-09-01,43495,6194,22304,3595,75588
"16767","State Wide",2003-10-01,43722,6151,22527,3587,75987
"16768","State Wide",2003-11-01,43449,6114,22470,3562,75595
"16769","State Wide",2003-12-01,42591,5948,21782,3483,73804
"16770","State Wide",2004-01-01,42953,6108,21954,3428,74443
"16771","State Wide",2004-02-01,44047,6296,22378,3500,76221
"16772","State Wide",2004-03-01,43960,6231,23061,3751,77003
"16773","State Wide",2004-04-01,43954,6209,23431,3822,77416
"16774","State Wide",2004-05-01,43982,6087,23211,3824,77104
"16775","State Wide",2004-06-01,44208,6122,23310,3845,77485
"16776","State Wide",2004-07-01,44804,6239,22742,3783,77568
"16777","State Wide",2004-08-01,45132,6552,22429,3686,77799
"16778","State Wide",2004-09-01,45566,6500,22469,3701,78236
"16779","State Wide",2004-10-01,45180,6237,22205,3831,77453
"16780","State Wide",2004-11-01,45242,6271,21805,3626,76944
"16781","State Wide",2004-12-01,44636,6084,20804,3484,75008
"16782","State Wide",2005-01-01,45115,6122,21390,3568,76195
"16783","State Wide",2005-02-01,46623,6327,21589,3552,78091
"16784","State Wide",2005-03-01,46040,6402,21955,3707,78104
"16785","State Wide",2005-04-01,46116,6394,22339,3792,78641
"16786","State Wide",2005-05-01,46119,6477,22519,3916,79031
"16787","State Wide",2005-06-01,46698,6701,22732,3793,79924
"16788","State Wide",2005-07-01,47235,6662,22933,3931,80761
"16789","State Wide",2005-08-01,47510,6617,23180,3898,81205
"16790","State Wide",2005-09-01,48228,6824,23363,3861,82276
"16791","State Wide",2005-10-01,47926,6770,23269,3948,81913
"16792","State Wide",2005-11-01,47778,6674,22928,3965,81345
"16793","State Wide",2005-12-01,46558,6398,22136,3830,78922
"16794","State Wide",2006-01-01,47214,6438,22166,3942,79760
"16795","State Wide",2006-02-01,47425,6760,22221,3988,80394
"16796","State Wide",2006-03-01,47492,6507,22597,3772,80368
"16797","State Wide",2006-04-01,47169,6558,22543,4161,80431
"16798","State Wide",2006-05-01,47671,6833,22716,4098,81318
"16799","State Wide",2006-06-01,47256,6585,22300,4231,80372
"16800","State Wide",2006-07-01,47772,6437,22866,4300,81375
"16801","State Wide",2006-08-01,48537,6580,22703,4270,82090
"16802","State Wide",2006-09-01,48148,6591,22438,4270,81447
"16803","State Wide",2006-10-01,49055,6736,22483,4318,82592
"16804","State Wide",2006-11-01,49139,6770,21954,4189,82052
"16805","State Wide",2006-12-01,48810,6495,21590,4077,80972
"16806","State Wide",2007-01-01,49072,6876,21722,3999,81669
"16807","State Wide",2007-02-01,49606,6761,22109,4134,82610
"16808","State Wide",2007-03-01,50112,6703,22068,4205,83088
"16809","State Wide",2007-04-01,50128,6770,22233,4238,83369
"16810","State Wide",2007-05-01,49934,6786,22633,4095,83448
"16811","State Wide",2007-06-01,50137,6677,22992,4074,83880
"16812","State Wide",2007-07-01,50515,6722,22676,4087,84000
"16813","State Wide",2007-08-01,49976,6853,22956,4088,83873
"16814","State Wide",2007-09-01,50226,6945,22968,4136,84275
"16815","State Wide",2007-10-01,49561,6781,23500,4179,84021
"16816","State Wide",2007-11-01,49711,6516,22623,3970,82820
"16817","State Wide",2007-12-01,49119,6367,21781,3883,81150
"16818","State Wide",2008-01-01,49580,6533,21735,3906,81754
"16819","State Wide",2008-02-01,49853,6670,21808,3822,82153
"16820","State Wide",2008-03-01,50405,6516,22321,4083,83325
"16821","State Wide",2008-04-01,49770,6673,22592,4041,83076
"16822","State Wide",2008-05-01,49542,6654,22161,4030,82387
"16823","State Wide",2008-06-01,49243,6707,22579,3991,82520
"16824","State Wide",2008-07-01,49658,6758,22527,4027,82970
"16825","State Wide",2008-08-01,49939,6637,22578,4107,83261
"16826","State Wide",2008-09-01,49151,6787,21987,4061,81986
"16827","State Wide",2008-10-01,50376,6688,22210,4048,83322
"16828","State Wide",2008-11-01,49554,6348,22112,3968,81982
"16829","State Wide",2008-12-01,48562,6177,21533,3739,80011
"16830","State Wide",2009-01-01,49187,6278,21181,3760,80406
"16831","State Wide",2009-02-01,48985,6388,21921,3791,81085
"16832","State Wide",2009-03-01,48958,6238,22765,3955,81916
"16833","State Wide",2009-04-01,48553,6268,23808,3977,82606
"16834","State Wide",2009-05-01,48634,6217,23627,3933,82411
"16835","State Wide",2009-06-01,48110,6225,23934,3889,82158
"16836","State Wide",2009-07-01,47729,6215,23754,3901,81599
"16837","State Wide",2009-08-01,48108,6271,23408,3792,81579
"16838","State Wide",2009-09-01,49280,6399,21957,3799,81435
"16839","State Wide",2009-10-01,48167,6247,21835,3992,80241
"16840","State Wide",2009-11-01,48022,6193,20917,3760,78892
"16841","State Wide",2009-12-01,46660,5829,20030,3609,76128
"16842","State Wide",2010-01-01,46396,6059,19390,3506,75351
"16843","State Wide",2010-02-01,46066,5938,17981,3141,73126
"16844","State Wide",2010-03-01,45378,5966,18791,3283,73418
"16845","State Wide",2010-04-01,46524,5837,18196,3306,73863
"16846","State Wide",2010-05-01,46378,6395,17800,2968,73541
"16847","State Wide",2010-06-01,46718,6001,17550,3435,73704
"16848","State Wide",2010-07-01,46529,5989,17534,3294,73346
"16849","State Wide",2010-08-01,46998,6187,17338,3222,73745
"16850","State Wide",2010-09-01,44743,6175,20042,3342,74302
"16851","State Wide",2010-10-01,46106,5882,18246,3328,73562
"16852","State Wide",2010-11-01,46119,5832,17556,3215,72722
"16853","State Wide",2010-12-01,44999,5482,17014,3154,70649
"16854","State Wide",2011-01-01,45597,5465,17051,3138,71251
"16855","State Wide",2011-02-01,45918,5424,17241,3240,71823
"16856","State Wide",2011-03-01,44444,5390,17274,3159,70267
"16857","State Wide",2011-04-01,44003,5500,16794,3149,69446
"16858","State Wide",2011-05-01,42081,7040,17064,3219,69404
"16859","State Wide",2011-06-01,43715,5473,17272,3237,69697
"16860","State Wide",2011-07-01,44364,5639,17647,3177,70827
"16861","State Wide",2011-08-01,44926,5502,17595,3267,71290
"16862","State Wide",2011-09-01,45184,5570,17423,3585,71762
"16863","State Wide",2011-10-01,44820,5363,18741,3361,72285
"16864","State Wide",2011-11-01,42934,5204,20354,3548,72040
"16865","State Wide",2011-12-01,41910,5113,21361,3747,72131
"16866","State Wide",2012-01-01,42492,5123,22382,3953,73950
"16867","State Wide",2012-02-01,42580,5343,23171,4115,75209
"16868","State Wide",2012-03-01,42379,5123,22885,4080,74467
"16869","State Wide",2012-04-01,43042,5285,23707,4405,76439
"16870","State Wide",2012-05-01,42210,5330,25226,4554,77320
"16871","State Wide",2012-06-01,43204,5517,24950,4592,78263
"16872","State Wide",2012-07-01,43612,5644,24080,4535,77871
"16873","State Wide",2012-08-01,43691,5638,24992,4683,79004
"16874","State Wide",2012-09-01,44821,5731,25667,4645,80864
"16875","State Wide",2012-10-01,44557,5583,26099,4702,80941
"16876","State Wide",2012-11-01,45408,5981,25020,4194,80603
"16877","State Wide",2012-12-01,43969,5464,24977,4468,78878
"16878","State Wide",2013-01-01,44552,5658,25156,4540,79906
"16879","State Wide",2013-02-01,44908,5725,25832,4606,81071
"16880","State Wide",2013-03-01,45076,5809,26135,4550,81570
"16881","State Wide",2013-04-01,45317,5977,25910,4475,81679
"16882","State Wide",2013-05-01,45227,6004,26361,4547,82139
"16883","State Wide",2013-06-01,45657,6025,25893,4660,82235
"16884","State Wide",2013-07-01,45491,6153,25508,4594,81746
"16885","State Wide",2013-08-01,45531,6075,25700,4698,82004
"16886","State Wide",2013-09-01,45752,6199,26042,4711,82704
"16887","State Wide",2013-10-01,45842,6139,26177,4713,82871
"16888","State Wide",2013-11-01,45347,6065,26387,4826,82625
"16889","State Wide",2013-12-01,45108,5891,25565,4698,81262
"16890","State Wide",2014-01-01,45420,6031,25786,4677,81914
"16891","State Wide",2014-02-01,45512,6058,26357,4833,82760
"16892","State Wide",2014-03-01,45463,5987,26560,4920,82930
"16893","State Wide",2014-04-01,45445,6265,26412,4901,83023
"16894","State Wide",2014-05-01,45463,6190,26475,4928,83056
"16895","State Wide",2014-06-01,45710,6219,26510,4847,83286
"16896","State Wide",2014-07-01,45454,6240,26488,4916,83099
"16897","State Wide",2014-08-01,45621,6326,26186,4847,82981
"16898","State Wide",2014-09-01,45468,6488,25880,4846,82681
"16899","State Wide",2014-10-01,44935,6529,25744,4797,82005
"16900","State Wide",2014-11-01,42519,5907,25441,4651,78518
"16901","State Wide",2014-12-01,39301,5215,23844,4164,72523
"16902","State Wide",2015-01-01,39325,5436,23307,4140,72207
"16903","State Wide",2015-02-01,40245,5495,23429,4084,73253
"16904","State Wide",2015-03-01,40313,5475,23318,4121,73227
"16905","State Wide",2015-04-01,40353,5503,23326,4021,73203
"16906","State Wide",2015-05-01,40272,5510,23473,4047,73301
"16907","State Wide",2015-06-01,40940,5563,23282,4185,73970
"16908","State Wide",2015-07-01,41229,5595,23268,4152,74245
"16909","State Wide",2015-08-01,41543,5669,23080,4220,74512
"16910","State Wide",2015-09-01,41896,5428,23288,4362,74974
"16911","State Wide",2015-10-01,42323,5898,22804,4028,75053
"16912","State Wide",2015-11-01,40616,5614,23754,4141,74126
"16913","State Wide",2015-12-01,40730,5517,22337,3916,72501
"16914","State Wide",2016-01-01,41693,5640,21636,3885,72855
"16915","State Wide",2016-02-01,42724,5734,21908,3822,74189
"16916","State Wide",2016-03-01,41731,5717,22720,4021,74189
"16917","State Wide",2016-04-01,41955,5839,22600,4018,74414
"16918","State Wide",2016-05-01,42617,5811,22590,3999,75019
"16919","State Wide",2016-06-01,42744,5922,22567,3975,75211
"16920","State Wide",2016-07-01,42961,5932,22616,3976,75485
"16921","State Wide",2016-08-01,43234,5927,22303,3933,75398
"16922","State Wide",2016-09-01,43383,5982,22700,3958,76023
"16923","State Wide",2016-10-01,43348,5981,22524,3839,75692
"16924","State Wide",2016-11-01,43065,5810,22216,3910,75004
"16925","State Wide",2016-12-01,42545,5806,21333,3779,73461
"16926","State Wide",2017-01-01,42408,5802,21648,3855,73713
"16927","State Wide",2017-02-01,43188,5948,21784,3784,74704
"16928","State Wide",2017-03-01,42287,5884,22884,3922,74977
"16929","State Wide",2017-04-01,42571,5943,22840,3954,75308
"16930","State Wide",2017-05-01,42360,6056,23020,4074,75510
"16931","State Wide",2017-06-01,42463,5997,22522,4230,75212
"16932","State Wide",2017-07-01,43106,6212,22430,3988,75736
"16933","State Wide",2017-08-01,42844,6024,22837,4112,75817
"16934","State Wide",2017-09-01,42895,6261,22723,4107,75986
"16935","State Wide",2017-10-01,42551,NA,22705,4169,75421
"16936","State Wide",2017-11-01,42358,6072,22470,3953,74853
"16937","State Wide",2017-12-01,41933,5864,21831,3920,73548
"16938","State Wide",2018-01-01,42260,6015,21592,3951,73818
"16939","State Wide",2018-02-01,42299,5964,22299,4122,74684
"16940","State Wide",2018-03-01,41423,5805,22503,4045,73776
"16941","State Wide",2018-04-01,41294,5891,22230,3977,73391
"16942","State Wide",2018-05-01,41483,5775,22435,3985,73677
"16943","State Wide",2018-06-01,41884,5871,22417,4005,74177
"16944","State Wide",2018-07-01,NA,NA,NA,NA,NA
"16945","State Wide",2018-08-01,43256,6129,21978,3869,75232
"16946","State Wide",2018-09-01,NA,NA,NA,NA,NA
"16947","State Wide",2018-10-01,39712,5603,20486,3697,69498
"16948","State Wide",2018-11-01,39462,5492,20025,3545,68524
"16949","State Wide",2018-12-01,41709,5760,20237,3650,71356
"16950","State Wide",2019-01-01,42805,5749,20521,3630,72705
"16951","State Wide",2019-02-01,43175,5837,20809,3597,73418
"16952","State Wide",2019-03-01,42936,5768,21351,3725,73780
"16953","State Wide",2019-04-01,43398,5883,20987,3709,73977
"16954","State Wide",2019-05-01,43159,5680,21228,3784,73851
"16955","State Wide",2019-06-01,43323,5844,21220,3685,74072
"16956","State Wide",2019-07-01,NA,NA,NA,NA,NA
"16957","State Wide",2019-08-01,NA,NA,NA,NA,NA
"16958","State Wide",2019-09-01,NA,NA,NA,NA,NA
"16959","State Wide",2019-10-01,44114,5994,20242,3556,73906
"16960","State Wide",2019-11-01,43431,5771,20245,3535,72982
"16961","State Wide",2019-12-01,42581,5701,19541,3377,71200
"16962","State Wide",2020-01-01,43019,5720,19411,3342,71492
"16963","State Wide",2020-02-01,43323,5863,19776,3425,72387
"16964","State Wide",2020-03-01,41822,5268,18173,3162,68425
